State,Year,Month,labor force,employment,unemployment,Data
AL,1976,1,1476714,1381839,94875,6.4
AL,1976,2,1475165,1383321,91844,6.2
AL,1976,3,1474943,1385037,89906,6.1
AL,1976,4,1476688,1387079,89609,6.1
AL,1976,5,1478737,1389460,89277,6
AL,1976,6,1486638,1392241,94397,6.3
AL,1976,7,1488020,1395457,92563,6.2
AL,1976,8,1494742,1399036,95706,6.4
AL,1976,9,1502422,1403038,99384,6.6
AL,1976,10,1507274,1407484,99790,6.6
AL,1976,11,1514225,1412422,101803,6.7
AL,1976,12,1520841,1417905,102936,6.8
AL,1977,1,1529401,1423952,105449,6.9
AL,1977,2,1548467,1430239,118228,7.6
AL,1977,3,1550236,1436804,113432,7.3
AL,1977,4,1557589,1443491,114098,7.3
AL,1977,5,1563367,1450194,113173,7.2
AL,1977,6,1566758,1456831,109927,7
AL,1977,7,1571372,1463287,108085,6.9
AL,1977,8,1573287,1469523,103764,6.6
AL,1977,9,1575870,1475511,100359,6.4
AL,1977,10,1578602,1481274,97328,6.2
AL,1977,11,1584728,1486872,97856,6.2
AL,1977,12,1589481,1492328,97153,6.1
AL,1978,1,1596743,1497750,98993,6.2
AL,1978,2,1599063,1503242,95821,6
AL,1978,3,1604494,1508788,95706,6
AL,1978,4,1605940,1514320,91620,5.7
AL,1978,5,1608818,1519662,89156,5.5
AL,1978,6,1617882,1524709,93173,5.8
AL,1978,7,1622210,1529284,92926,5.7
AL,1978,8,1629851,1533317,96534,5.9
AL,1978,9,1636570,1536810,99760,6.1
AL,1978,10,1639379,1539888,99491,6.1
AL,1978,11,1643876,1542624,101252,6.2
AL,1978,12,1648031,1545028,103003,6.3
AL,1979,1,1652459,1547111,105348,6.4
AL,1979,2,1660384,1548855,111529,6.7
AL,1979,3,1663260,1550326,112934,6.8
AL,1979,4,1665938,1551535,114403,6.9
AL,1979,5,1666040,1552513,113527,6.8
AL,1979,6,1669289,1553245,116044,7
AL,1979,7,1670019,1553752,116267,7
AL,1979,8,1666051,1554080,111971,6.7
AL,1979,9,1666143,1554178,111965,6.7
AL,1979,10,1668442,1553985,114457,6.9
AL,1979,11,1669786,1553436,116350,7
AL,1979,12,1669976,1552548,117428,7
AL,1980,1,1670288,1551271,119017,7.1
AL,1980,2,1671987,1549592,122395,7.3
AL,1980,3,1673034,1547512,125522,7.5
AL,1980,4,1675686,1545117,130569,7.8
AL,1980,5,1683675,1542512,141163,8.4
AL,1980,6,1685907,1539805,146102,8.7
AL,1980,7,1698901,1537208,161693,9.5
AL,1980,8,1691642,1534899,156743,9.3
AL,1980,9,1685046,1532784,152262,9
AL,1980,10,1681547,1530783,150764,9
AL,1980,11,1677279,1528776,148503,8.9
AL,1980,12,1674372,1526663,147709,8.8
AL,1981,1,1671235,1524336,146899,8.8
AL,1981,2,1670855,1521744,149111,8.9
AL,1981,3,1669120,1518910,150210,9
AL,1981,4,1668455,1515832,152623,9.1
AL,1981,5,1667835,1512712,155123,9.3
AL,1981,6,1667711,1509615,158096,9.5
AL,1981,7,1661348,1506549,154799,9.3
AL,1981,8,1666331,1503379,162952,9.8
AL,1981,9,1668228,1500167,168061,10.1
AL,1981,10,1674175,1496882,177293,10.6
AL,1981,11,1677356,1493632,183724,11
AL,1981,12,1681336,1490468,190868,11.4
AL,1982,1,1692104,1487388,204716,12.1
AL,1982,2,1684853,1484648,200205,11.9
AL,1982,3,1691228,1482159,209069,12.4
AL,1982,4,1691459,1479952,211507,12.5
AL,1982,5,1693296,1478019,215277,12.7
AL,1982,6,1694042,1476385,217657,12.8
AL,1982,7,1700366,1475117,225249,13.2
AL,1982,8,1706944,1474351,232593,13.6
AL,1982,9,1710917,1474106,236811,13.8
AL,1982,10,1719853,1474453,245400,14.3
AL,1982,11,1723309,1475442,247867,14.4
AL,1982,12,1726179,1477104,249075,14.4
AL,1983,1,1725941,1479470,246471,14.3
AL,1983,2,1726656,1482535,244121,14.1
AL,1983,3,1720899,1486287,234612,13.6
AL,1983,4,1723508,1490661,232847,13.5
AL,1983,5,1721376,1495596,225780,13.1
AL,1983,6,1722301,1501002,221299,12.8
AL,1983,7,1726254,1506703,219551,12.7
AL,1983,8,1726458,1512595,213863,12.4
AL,1983,9,1729064,1518719,210345,12.2
AL,1983,10,1732332,1525044,207288,12
AL,1983,11,1733570,1531556,202014,11.7
AL,1983,12,1734791,1538241,196550,11.3
AL,1984,1,1738621,1545057,193564,11.1
AL,1984,2,1740585,1551699,188886,10.9
AL,1984,3,1742877,1558130,184747,10.6
AL,1984,4,1746393,1564344,182049,10.4
AL,1984,5,1746489,1570320,176169,10.1
AL,1984,6,1752530,1576021,176509,10.1
AL,1984,7,1758586,1581337,177249,10.1
AL,1984,8,1761176,1586312,174864,9.9
AL,1984,9,1767640,1590938,176702,10
AL,1984,10,1765654,1595303,170351,9.6
AL,1984,11,1770475,1599433,171042,9.7
AL,1984,12,1776886,1603337,173549,9.8
AL,1985,1,1773390,1607075,166315,9.4
AL,1985,2,1776613,1610813,165800,9.3
AL,1985,3,1777828,1614600,163228,9.2
AL,1985,4,1772397,1618415,153982,8.7
AL,1985,5,1772675,1622220,150455,8.5
AL,1985,6,1773798,1626039,147759,8.3
AL,1985,7,1775081,1629914,145167,8.2
AL,1985,8,1780074,1633773,146301,8.2
AL,1985,9,1786087,1637614,148473,8.3
AL,1985,10,1790902,1641507,149395,8.3
AL,1985,11,1796058,1645435,150623,8.4
AL,1985,12,1802639,1649392,153247,8.5
AL,1986,1,1809872,1653329,156543,8.6
AL,1986,2,1818916,1657029,161887,8.9
AL,1986,3,1830486,1660493,169993,9.3
AL,1986,4,1834311,1663794,170517,9.3
AL,1986,5,1838618,1666965,171653,9.3
AL,1986,6,1841599,1670044,171555,9.3
AL,1986,7,1840665,1673093,167572,9.1
AL,1986,8,1844372,1676099,168273,9.1
AL,1986,9,1847166,1679123,168043,9.1
AL,1986,10,1849752,1682247,167505,9.1
AL,1986,11,1851610,1685461,166149,9
AL,1986,12,1852959,1688818,164141,8.9
AL,1987,1,1850226,1692291,157935,8.5
AL,1987,2,1850177,1695793,154384,8.3
AL,1987,3,1852240,1699336,152904,8.3
AL,1987,4,1847649,1702942,144707,7.8
AL,1987,5,1850243,1706492,143751,7.8
AL,1987,6,1846414,1709952,136462,7.4
AL,1987,7,1847905,1713358,134547,7.3
AL,1987,8,1852165,1716620,135545,7.3
AL,1987,9,1855971,1719677,136294,7.3
AL,1987,10,1856612,1722497,134115,7.2
AL,1987,11,1856075,1725108,130967,7.1
AL,1987,12,1859161,1727574,131587,7.1
AL,1988,1,1861643,1729875,131768,7.1
AL,1988,2,1861375,1732153,129222,6.9
AL,1988,3,1861019,1734384,126635,6.8
AL,1988,4,1867530,1736581,130949,7
AL,1988,5,1867609,1738834,128775,6.9
AL,1988,6,1866931,1741157,125774,6.7
AL,1988,7,1867846,1743407,124439,6.7
AL,1988,8,1875463,1745631,129832,6.9
AL,1988,9,1877238,1748037,129201,6.9
AL,1988,10,1880426,1750589,129837,6.9
AL,1988,11,1885106,1753253,131853,7
AL,1988,12,1887997,1755860,132137,7
AL,1989,1,1890294,1758530,131764,7
AL,1989,2,1887903,1761108,126795,6.7
AL,1989,3,1891434,1763524,127910,6.8
AL,1989,4,1895216,1765754,129462,6.8
AL,1989,5,1894933,1767863,127070,6.7
AL,1989,6,1898680,1769848,128832,6.8
AL,1989,7,1899164,1771771,127393,6.7
AL,1989,8,1898015,1773648,124367,6.6
AL,1989,9,1898308,1775310,122998,6.5
AL,1989,10,1896970,1776769,120201,6.3
AL,1989,11,1897619,1778096,119523,6.3
AL,1989,12,1897846,1779321,118525,6.2
AL,1990,1,1898790,1780433,118357,6.2
AL,1990,2,1903672,1781386,122286,6.4
AL,1990,3,1906203,1782228,123975,6.5
AL,1990,4,1901121,1782962,118159,6.2
AL,1990,5,1901480,1783481,117999,6.2
AL,1990,6,1901088,1783732,117356,6.2
AL,1990,7,1901507,1783765,117742,6.2
AL,1990,8,1903529,1783640,119889,6.3
AL,1990,9,1904939,1783407,121532,6.4
AL,1990,10,1904405,1783015,121390,6.4
AL,1990,11,1905665,1782494,123171,6.5
AL,1990,12,1906581,1781858,124723,6.5
AL,1991,1,1911115,1781123,129992,6.8
AL,1991,2,1916558,1780581,135977,7.1
AL,1991,3,1916149,1780310,135839,7.1
AL,1991,4,1916203,1780306,135897,7.1
AL,1991,5,1914538,1780632,133906,7
AL,1991,6,1913016,1781265,131751,6.9
AL,1991,7,1911840,1782215,129625,6.8
AL,1991,8,1911271,1783446,127825,6.7
AL,1991,9,1911635,1784976,126659,6.6
AL,1991,10,1914267,1786732,127535,6.7
AL,1991,11,1918076,1788700,129376,6.7
AL,1991,12,1926377,1790924,135453,7
AL,1992,1,1928522,1793416,135106,7
AL,1992,2,1933843,1796001,137842,7.1
AL,1992,3,1936585,1798690,137895,7.1
AL,1992,4,1938882,1801482,137400,7.1
AL,1992,5,1942936,1804394,138542,7.1
AL,1992,6,1945066,1807383,137683,7.1
AL,1992,7,1944110,1810495,133615,6.9
AL,1992,8,1945145,1813665,131480,6.8
AL,1992,9,1945428,1816826,128602,6.6
AL,1992,10,1947377,1820053,127324,6.5
AL,1992,11,1951485,1823234,128251,6.6
AL,1992,12,1957025,1826410,130615,6.7
AL,1993,1,1961386,1829566,131820,6.7
AL,1993,2,1963394,1832864,130530,6.6
AL,1993,3,1968872,1836260,132612,6.7
AL,1993,4,1975105,1839816,135289,6.8
AL,1993,5,1978605,1843500,135105,6.8
AL,1993,6,1983477,1847352,136125,6.9
AL,1993,7,1989106,1851413,137693,6.9
AL,1993,8,1987599,1855690,131909,6.6
AL,1993,9,1988976,1860245,128731,6.5
AL,1993,10,1990411,1865078,125333,6.3
AL,1993,11,1995137,1870123,125014,6.3
AL,1993,12,1997622,1875413,122209,6.1
AL,1994,1,2001911,1880938,120973,6
AL,1994,2,2002535,1886440,116095,5.8
AL,1994,3,2003396,1891932,111464,5.6
AL,1994,4,2006119,1897390,108729,5.4
AL,1994,5,2011376,1902787,108589,5.4
AL,1994,6,2015899,1908114,107785,5.3
AL,1994,7,2019650,1913304,106346,5.3
AL,1994,8,2025514,1918379,107135,5.3
AL,1994,9,2026321,1923272,103049,5.1
AL,1994,10,2033457,1927861,105596,5.2
AL,1994,11,2036222,1932159,104063,5.1
AL,1994,12,2039893,1935995,103898,5.1
AL,1995,1,2046286,1939449,106837,5.2
AL,1995,2,2051550,1942720,108830,5.3
AL,1995,3,2052596,1945843,106753,5.2
AL,1995,4,2058768,1948842,109926,5.3
AL,1995,5,2063279,1951744,111535,5.4
AL,1995,6,2067124,1954598,112526,5.4
AL,1995,7,2072109,1957387,114722,5.5
AL,1995,8,2070533,1960206,110327,5.3
AL,1995,9,2070502,1963058,107444,5.2
AL,1995,10,2071216,1965915,105301,5.1
AL,1995,11,2070928,1968776,102152,4.9
AL,1995,12,2071548,1971614,99934,4.8
AL,1996,1,2071035,1974402,96633,4.7
AL,1996,2,2072303,1977243,95060,4.6
AL,1996,3,2076329,1980191,96138,4.6
AL,1996,4,2080883,1983268,97615,4.7
AL,1996,5,2082978,1986522,96456,4.6
AL,1996,6,2084112,1989964,94148,4.5
AL,1996,7,2087260,1993623,93637,4.5
AL,1996,8,2088888,1997416,91472,4.4
AL,1996,9,2092797,2001298,91499,4.4
AL,1996,10,2098197,2005286,92911,4.4
AL,1996,11,2100633,2009307,91326,4.3
AL,1996,12,2102510,2013307,89203,4.2
AL,1997,1,2109977,2017283,92694,4.4
AL,1997,2,2115669,2021083,94586,4.5
AL,1997,3,2117507,2024708,92799,4.4
AL,1997,4,2124090,2028125,95965,4.5
AL,1997,5,2129281,2031369,97912,4.6
AL,1997,6,2133594,2034456,99138,4.6
AL,1997,7,2137948,2037443,100505,4.7
AL,1997,8,2137472,2040296,97176,4.5
AL,1997,9,2139594,2043049,96545,4.5
AL,1997,10,2138698,2045671,93027,4.3
AL,1997,11,2137721,2048087,89634,4.2
AL,1997,12,2136006,2050296,85710,4
AL,1998,1,2133900,2052273,81627,3.8
AL,1998,2,2133269,2054098,79171,3.7
AL,1998,3,2136119,2055780,80339,3.8
AL,1998,4,2136563,2057320,79243,3.7
AL,1998,5,2141507,2058607,82900,3.9
AL,1998,6,2143565,2059659,83906,3.9
AL,1998,7,2143304,2060476,82828,3.9
AL,1998,8,2144880,2061244,83636,3.9
AL,1998,9,2148118,2061981,86137,4
AL,1998,10,2149949,2062694,87255,4.1
AL,1998,11,2149767,2063410,86357,4
AL,1998,12,2149206,2064176,85030,4
AL,1999,1,2149316,2064965,84351,3.9
AL,1999,2,2151973,2065828,86145,4
AL,1999,3,2156211,2066729,89482,4.1
AL,1999,4,2161339,2067637,93702,4.3
AL,1999,5,2163855,2068579,95276,4.4
AL,1999,6,2165534,2069589,95945,4.4
AL,1999,7,2164177,2070642,93535,4.3
AL,1999,8,2167853,2071654,96199,4.4
AL,1999,9,2168644,2072686,95958,4.4
AL,1999,10,2166825,2073703,93122,4.3
AL,1999,11,2167065,2074733,92332,4.3
AL,1999,12,2168439,2075773,92666,4.3
AL,2000,1,2160813,2071441,89372,4.1
AL,2000,2,2157920,2071575,86345,4
AL,2000,3,2154218,2071482,82736,3.8
AL,2000,4,2156101,2071100,85001,3.9
AL,2000,5,2156354,2070491,85863,4
AL,2000,6,2154196,2069544,84652,3.9
AL,2000,7,2154390,2068274,86116,4
AL,2000,8,2156458,2066735,89723,4.2
AL,2000,9,2154273,2064881,89392,4.1
AL,2000,10,2152862,2062673,90189,4.2
AL,2000,11,2149863,2060174,89689,4.2
AL,2000,12,2147089,2057392,89697,4.2
AL,2001,1,2148358,2054327,94031,4.4
AL,2001,2,2144118,2051146,92972,4.3
AL,2001,3,2141727,2047818,93909,4.4
AL,2001,4,2138186,2044358,93828,4.4
AL,2001,5,2134471,2040764,93707,4.4
AL,2001,6,2133663,2037074,96589,4.5
AL,2001,7,2131675,2033317,98358,4.6
AL,2001,8,2130547,2029560,100987,4.7
AL,2001,9,2129580,2025745,103835,4.9
AL,2001,10,2129804,2021930,107874,5.1
AL,2001,11,2129508,2018219,111289,5.2
AL,2001,12,2126498,2014647,111851,5.3
AL,2002,1,2111673,2003054,108619,5.1
AL,2002,2,2109270,1999903,109367,5.2
AL,2002,3,2110043,1997286,112757,5.3
AL,2002,4,2107468,1995177,112291,5.3
AL,2002,5,2107502,1993563,113939,5.4
AL,2002,6,2105507,1992441,113066,5.4
AL,2002,7,2106128,1991834,114294,5.4
AL,2002,8,2105362,1991687,113675,5.4
AL,2002,9,2106368,1991919,114449,5.4
AL,2002,10,2107014,1992472,114542,5.4
AL,2002,11,2109565,1993290,116275,5.5
AL,2002,12,2108398,1994353,114045,5.4
AL,2003,1,2097442,1987282,110160,5.3
AL,2003,2,2097973,1988033,109940,5.2
AL,2003,3,2100349,1988577,111772,5.3
AL,2003,4,2104381,1988967,115414,5.5
AL,2003,5,2104054,1989267,114787,5.5
AL,2003,6,2104952,1989525,115427,5.5
AL,2003,7,2105170,1989845,115325,5.5
AL,2003,8,2106202,1990235,115967,5.5
AL,2003,9,2105678,1990691,114987,5.5
AL,2003,10,2108049,1991190,116859,5.5
AL,2003,11,2109499,1991658,117841,5.6
AL,2003,12,2106749,1992131,114618,5.4
AL,2004,1,2111225,1998894,112331,5.3
AL,2004,2,2109625,1999764,109861,5.2
AL,2004,3,2112248,2000847,111401,5.3
AL,2004,4,2113247,2002148,111099,5.3
AL,2004,5,2114538,2003615,110923,5.2
AL,2004,6,2112745,2005271,107474,5.1
AL,2004,7,2114459,2007071,107388,5.1
AL,2004,8,2116510,2008961,107549,5.1
AL,2004,9,2116277,2011037,105240,5
AL,2004,10,2116544,2013393,103151,4.9
AL,2004,11,2114630,2016007,98623,4.7
AL,2004,12,2113325,2018830,94495,4.5
AL,2005,1,2110651,2021823,88828,4.2
AL,2005,2,2111184,2025040,86144,4.1
AL,2005,3,2111403,2028493,82910,3.9
AL,2005,4,2112119,2032180,79939,3.8
AL,2005,5,2116486,2035996,80490,3.8
AL,2005,6,2121255,2039952,81303,3.8
AL,2005,7,2123226,2044086,79140,3.7
AL,2005,8,2127285,2048365,78920,3.7
AL,2005,9,2137084,2052790,84294,3.9
AL,2005,10,2140021,2057365,82656,3.9
AL,2005,11,2137364,2062093,75271,3.5
AL,2005,12,2141699,2066909,74790,3.5
AL,2006,1,2148142,2071784,76358,3.6
AL,2006,2,2150097,2076332,73765,3.4
AL,2006,3,2153429,2080535,72894,3.4
AL,2006,4,2159294,2084361,74933,3.5
AL,2006,5,2163600,2087849,75751,3.5
AL,2006,6,2167267,2090999,76268,3.5
AL,2006,7,2169835,2093748,76087,3.5
AL,2006,8,2172753,2096171,76582,3.5
AL,2006,9,2175776,2098261,77515,3.6
AL,2006,10,2177172,2100030,77142,3.5
AL,2006,11,2176298,2101613,74685,3.4
AL,2006,12,2179190,2102958,76232,3.5
AL,2007,1,2176039,2103980,72059,3.3
AL,2007,2,2175420,2104583,70837,3.3
AL,2007,3,2177883,2104727,73156,3.4
AL,2007,4,2177950,2104394,73556,3.4
AL,2007,5,2179680,2103715,75965,3.5
AL,2007,6,2178538,2102676,75862,3.5
AL,2007,7,2178012,2101221,76791,3.5
AL,2007,8,2177632,2099408,78224,3.6
AL,2007,9,2174221,2097181,77040,3.5
AL,2007,10,2170878,2094490,76388,3.5
AL,2007,11,2171937,2091346,80591,3.7
AL,2007,12,2170390,2087652,82738,3.8
AL,2008,1,2168677,2083323,85354,3.9
AL,2008,2,2166519,2078741,87778,4.1
AL,2008,3,2166366,2073911,92455,4.3
AL,2008,4,2165799,2068870,96929,4.5
AL,2008,5,2165770,2063570,102200,4.7
AL,2008,6,2163204,2057986,105218,4.9
AL,2008,7,2161527,2052133,109394,5.1
AL,2008,8,2158550,2045992,112558,5.2
AL,2008,9,2156451,2039583,116868,5.4
AL,2008,10,2156708,2032932,123776,5.7
AL,2008,11,2159990,2025981,134009,6.2
AL,2008,12,2160184,2018997,141187,6.5
AL,2009,1,2147397,1979623,167774,7.8
AK,1976,1,159224,148086,11138,7
AK,1976,2,159921,148756,11165,7
AK,1976,3,160685,149429,11256,7
AK,1976,4,161170,150081,11089,6.9
AK,1976,5,162053,150702,11351,7
AK,1976,6,163048,151286,11762,7.2
AK,1976,7,163797,151829,11968,7.3
AK,1976,8,165060,152333,12727,7.7
AK,1976,9,166335,152788,13547,8.1
AK,1976,10,166931,153207,13724,8.2
AK,1976,11,168258,153612,14646,8.7
AK,1976,12,168614,154022,14592,8.7
AK,1977,1,168639,154451,14188,8.4
AK,1977,2,169839,154865,14974,8.8
AK,1977,3,170712,155258,15454,9.1
AK,1977,4,171821,155637,16184,9.4
AK,1977,5,172913,156007,16906,9.8
AK,1977,6,173055,156382,16673,9.6
AK,1977,7,174040,156778,17262,9.9
AK,1977,8,174278,157191,17087,9.8
AK,1977,9,174766,157627,17139,9.8
AK,1977,10,175823,158072,17751,10.1
AK,1977,11,176540,158528,18012,10.2
AK,1977,12,177436,158988,18448,10.4
AK,1978,1,179097,159430,19667,11
AK,1978,2,178566,159843,18723,10.5
AK,1978,3,179943,160234,19709,11
AK,1978,4,180272,160611,19661,10.9
AK,1978,5,181016,160987,20029,11.1
AK,1978,6,181138,161363,19775,10.9
AK,1978,7,180889,161739,19150,10.6
AK,1978,8,181505,162136,19369,10.7
AK,1978,9,181827,162540,19287,10.6
AK,1978,10,181683,162954,18729,10.3
AK,1978,11,181812,163370,18442,10.1
AK,1978,12,181758,163766,17992,9.9
AK,1979,1,180752,164129,16623,9.2
AK,1979,2,181336,164465,16871,9.3
AK,1979,3,181126,164782,16344,9
AK,1979,4,181179,165089,16090,8.9
AK,1979,5,181685,165389,16296,9
AK,1979,6,181854,165682,16172,8.9
AK,1979,7,182335,165974,16361,9
AK,1979,8,182151,166282,15869,8.7
AK,1979,9,183273,166612,16661,9.1
AK,1979,10,183675,166961,16714,9.1
AK,1979,11,184117,167308,16809,9.1
AK,1979,12,184225,167648,16577,9
AK,1980,1,183130,167983,15147,8.3
AK,1980,2,184457,168345,16112,8.7
AK,1980,3,185458,168741,16717,9
AK,1980,4,187444,169176,18268,9.7
AK,1980,5,187477,169651,17826,9.5
AK,1980,6,188813,170172,18641,9.9
AK,1980,7,189509,170757,18752,9.9
AK,1980,8,190041,171405,18636,9.8
AK,1980,9,190505,172116,18389,9.7
AK,1980,10,191120,172895,18225,9.5
AK,1980,11,191299,173727,17572,9.2
AK,1980,12,191896,174610,17286,9
AK,1981,1,192394,175547,16847,8.8
AK,1981,2,193016,176498,16518,8.6
AK,1981,3,193840,177471,16369,8.4
AK,1981,4,194207,178460,15747,8.1
AK,1981,5,196224,179467,16757,8.5
AK,1981,6,198553,180496,18057,9.1
AK,1981,7,200548,181556,18992,9.5
AK,1981,8,202072,182626,19446,9.6
AK,1981,9,203188,183710,19478,9.6
AK,1981,10,204412,184796,19616,9.6
AK,1981,11,205156,185866,19290,9.4
AK,1981,12,206622,186920,19702,9.5
AK,1982,1,207851,187961,19890,9.6
AK,1982,2,209077,189021,20056,9.6
AK,1982,3,210280,190099,20181,9.6
AK,1982,4,211593,191206,20387,9.6
AK,1982,5,213148,192333,20815,9.8
AK,1982,6,214816,193486,21330,9.9
AK,1982,7,215880,194655,21225,9.8
AK,1982,8,217230,195828,21402,9.9
AK,1982,9,218329,197004,21325,9.8
AK,1982,10,219675,198179,21496,9.8
AK,1982,11,221304,199363,21941,9.9
AK,1982,12,222842,200563,22279,10
AK,1983,1,225182,201775,23407,10.4
AK,1983,2,226403,203001,23402,10.3
AK,1983,3,227397,204235,23162,10.2
AK,1983,4,228318,205477,22841,10
AK,1983,5,229545,206718,22827,9.9
AK,1983,6,230501,207952,22549,9.8
AK,1983,7,232171,209157,23014,9.9
AK,1983,8,233773,210343,23430,10
AK,1983,9,234852,211504,23348,9.9
AK,1983,10,235843,212631,23212,9.8
AK,1983,11,237340,213731,23609,9.9
AK,1983,12,238791,214807,23984,10
AK,1984,1,240826,215871,24955,10.4
AK,1984,2,241595,216900,24695,10.2
AK,1984,3,242439,217893,24546,10.1
AK,1984,4,243763,218847,24916,10.2
AK,1984,5,244721,219766,24955,10.2
AK,1984,6,245129,220636,24493,10
AK,1984,7,245755,221453,24302,9.9
AK,1984,8,246212,222203,24009,9.8
AK,1984,9,246733,222882,23851,9.7
AK,1984,10,247004,223500,23504,9.5
AK,1984,11,247253,224044,23209,9.4
AK,1984,12,246761,224514,22247,9
AK,1985,1,247741,224917,22824,9.2
AK,1985,2,248552,225286,23266,9.4
AK,1985,3,249560,225628,23932,9.6
AK,1985,4,250616,225943,24673,9.8
AK,1985,5,250327,226234,24093,9.6
AK,1985,6,250929,226504,24425,9.7
AK,1985,7,251458,226751,24707,9.8
AK,1985,8,251103,226966,24137,9.6
AK,1985,9,250843,227132,23711,9.5
AK,1985,10,251197,227236,23961,9.5
AK,1985,11,251850,227292,24558,9.8
AK,1985,12,252538,227314,25224,10
AK,1986,1,253020,227296,25724,10.2
AK,1986,2,254055,227223,26832,10.6
AK,1986,3,254899,227102,27797,10.9
AK,1986,4,256127,226944,29183,11.4
AK,1986,5,255540,226764,28776,11.3
AK,1986,6,255653,226565,29088,11.4
AK,1986,7,255759,226362,29397,11.5
AK,1986,8,255138,226153,28985,11.4
AK,1986,9,254126,225942,28184,11.1
AK,1986,10,253539,225739,27800,11
AK,1986,11,252690,225548,27142,10.7
AK,1986,12,252600,225362,27238,10.8
AK,1987,1,252045,225188,26857,10.7
AK,1987,2,251917,225042,26875,10.7
AK,1987,3,252158,224932,27226,10.8
AK,1987,4,251519,224868,26651,10.6
AK,1987,5,251376,224852,26524,10.6
AK,1987,6,251205,224885,26320,10.5
AK,1987,7,250091,224975,25116,10
AK,1987,8,249732,225135,24597,9.8
AK,1987,9,250020,225362,24658,9.9
AK,1987,10,250003,225658,24345,9.7
AK,1987,11,249727,225998,23729,9.5
AK,1987,12,249486,226378,23108,9.3
AK,1988,1,249345,226787,22558,9
AK,1988,2,249777,227208,22569,9
AK,1988,3,250309,227646,22663,9.1
AK,1988,4,250559,228102,22457,9
AK,1988,5,251367,228586,22781,9.1
AK,1988,6,251193,229112,22081,8.8
AK,1988,7,251481,229674,21807,8.7
AK,1988,8,252336,230265,22071,8.7
AK,1988,9,252715,230894,21821,8.6
AK,1988,10,253162,231542,21620,8.5
AK,1988,11,253175,232209,20966,8.3
AK,1988,12,252826,232888,19938,7.9
AK,1989,1,252512,233570,18942,7.5
AK,1989,2,252961,234328,18633,7.4
AK,1989,3,252731,235161,17570,7
AK,1989,4,253119,236067,17052,6.7
AK,1989,5,253738,237031,16707,6.6
AK,1989,6,254737,238037,16700,6.6
AK,1989,7,256141,239076,17065,6.7
AK,1989,8,257642,240143,17499,6.8
AK,1989,9,259340,241232,18108,7
AK,1989,10,260378,242357,18021,6.9
AK,1989,11,261615,243534,18081,6.9
AK,1989,12,263114,244771,18343,7
AK,1990,1,265188,246072,19116,7.2
AK,1990,2,266305,247301,19004,7.1
AK,1990,3,267278,248446,18832,7
AK,1990,4,268551,249495,19056,7.1
AK,1990,5,269660,250442,19218,7.1
AK,1990,6,269744,251281,18463,6.8
AK,1990,7,270564,252001,18563,6.9
AK,1990,8,271895,252615,19280,7.1
AK,1990,9,272195,253128,19067,7
AK,1990,10,272795,253551,19244,7.1
AK,1990,11,272962,253880,19082,7
AK,1990,12,273340,254103,19237,7
AK,1991,1,273719,254216,19503,7.1
AK,1991,2,274499,254361,20138,7.3
AK,1991,3,275395,254544,20851,7.6
AK,1991,4,276271,254764,21507,7.8
AK,1991,5,277077,255017,22060,8
AK,1991,6,278014,255310,22704,8.2
AK,1991,7,278945,255654,23291,8.3
AK,1991,8,279812,256056,23756,8.5
AK,1991,9,281041,256529,24512,8.7
AK,1991,10,282477,257079,25398,9
AK,1991,11,283651,257692,25959,9.2
AK,1991,12,284688,258366,26322,9.2
AK,1992,1,285902,259108,26794,9.4
AK,1992,2,286548,259845,26703,9.3
AK,1992,3,287036,260569,26467,9.2
AK,1992,4,287528,261279,26249,9.1
AK,1992,5,288355,261974,26381,9.1
AK,1992,6,288926,262658,26268,9.1
AK,1992,7,289142,263344,25798,8.9
AK,1992,8,289610,264024,25586,8.8
AK,1992,9,290089,264705,25384,8.8
AK,1992,10,290791,265387,25404,8.7
AK,1992,11,290826,266082,24744,8.5
AK,1992,12,290570,266786,23784,8.2
AK,1993,1,290664,267487,23177,8
AK,1993,2,291054,268187,22867,7.9
AK,1993,3,291650,268883,22767,7.8
AK,1993,4,292265,269572,22693,7.8
AK,1993,5,293435,270256,23179,7.9
AK,1993,6,293477,270940,22537,7.7
AK,1993,7,293532,271623,21909,7.5
AK,1993,8,294131,272300,21831,7.4
AK,1993,9,294907,272975,21932,7.4
AK,1993,10,296086,273647,22439,7.6
AK,1993,11,296684,274298,22386,7.5
AK,1993,12,297209,274929,22280,7.5
AK,1994,1,298395,275542,22853,7.7
AK,1994,2,299109,276125,22984,7.7
AK,1994,3,299767,276671,23096,7.7
AK,1994,4,300563,277177,23386,7.8
AK,1994,5,301257,277661,23596,7.8
AK,1994,6,300545,278129,22416,7.5
AK,1994,7,301268,278573,22695,7.5
AK,1994,8,301146,278994,22152,7.4
AK,1994,9,301095,279381,21714,7.2
AK,1994,10,301578,279727,21851,7.2
AK,1994,11,301833,280049,21784,7.2
AK,1994,12,302351,280346,22005,7.3
AK,1995,1,302613,280623,21990,7.3
AK,1995,2,302442,280895,21547,7.1
AK,1995,3,302359,281163,21196,7
AK,1995,4,301885,281434,20451,6.8
AK,1995,5,302104,281713,20391,6.7
AK,1995,6,302764,281991,20773,6.9
AK,1995,7,303254,282258,20996,6.9
AK,1995,8,303579,282521,21058,6.9
AK,1995,9,304636,282772,21864,7.2
AK,1995,10,305241,283018,22223,7.3
AK,1995,11,306109,283265,22844,7.5
AK,1995,12,307000,283519,23481,7.6
AK,1996,1,307488,283786,23702,7.7
AK,1996,2,307409,284073,23336,7.6
AK,1996,3,307878,284380,23498,7.6
AK,1996,4,307808,284700,23108,7.5
AK,1996,5,307461,285028,22433,7.3
AK,1996,6,308102,285358,22744,7.4
AK,1996,7,308452,285692,22760,7.4
AK,1996,8,308612,286026,22586,7.3
AK,1996,9,308981,286362,22619,7.3
AK,1996,10,309473,286710,22763,7.4
AK,1996,11,310229,287068,23161,7.5
AK,1996,12,310987,287440,23547,7.6
AK,1997,1,311337,287831,23506,7.6
AK,1997,2,311710,288226,23484,7.5
AK,1997,3,312098,288626,23472,7.5
AK,1997,4,312181,289030,23151,7.4
AK,1997,5,311239,289430,21809,7
AK,1997,6,311462,289820,21642,6.9
AK,1997,7,312087,290198,21889,7
AK,1997,8,312276,290565,21711,7
AK,1997,9,312354,290928,21426,6.9
AK,1997,10,312415,291287,21128,6.8
AK,1997,11,312208,291637,20571,6.6
AK,1997,12,312166,291982,20184,6.5
AK,1998,1,311860,292320,19540,6.3
AK,1998,2,311932,292648,19284,6.2
AK,1998,3,311759,292962,18797,6
AK,1998,4,311627,293261,18366,5.9
AK,1998,5,312234,293547,18687,6
AK,1998,6,313160,293819,19341,6.2
AK,1998,7,313067,294088,18979,6.1
AK,1998,8,313268,294359,18909,6
AK,1998,9,313767,294638,19129,6.1
AK,1998,10,314301,294923,19378,6.2
AK,1998,11,314668,295208,19460,6.2
AK,1998,12,315302,295490,19812,6.3
AK,1999,1,315729,295769,19960,6.3
AK,1999,2,316696,296029,20667,6.5
AK,1999,3,316286,296279,20007,6.3
AK,1999,4,315828,296518,19310,6.1
AK,1999,5,316395,296742,19653,6.2
AK,1999,6,316096,296956,19140,6.1
AK,1999,7,316440,297165,19275,6.1
AK,1999,8,316527,297374,19153,6.1
AK,1999,9,316269,297578,18691,5.9
AK,1999,10,316877,297766,19111,6
AK,1999,11,317335,297944,19391,6.1
AK,1999,12,317600,298107,19493,6.1
AK,2000,1,318195,298410,19785,6.2
AK,2000,2,318116,298559,19557,6.1
AK,2000,3,318331,298719,19612,6.2
AK,2000,4,318777,298886,19891,6.2
AK,2000,5,318820,299058,19762,6.2
AK,2000,6,318842,299228,19614,6.2
AK,2000,7,318595,299394,19201,6
AK,2000,8,319050,299558,19492,6.1
AK,2000,9,319620,299726,19894,6.2
AK,2000,10,319564,299910,19654,6.2
AK,2000,11,319894,300111,19783,6.2
AK,2000,12,320226,300329,19897,6.2
AK,2001,1,320498,300557,19941,6.2
AK,2001,2,320046,300795,19251,6
AK,2001,3,320145,301029,19116,6
AK,2001,4,320595,301259,19336,6
AK,2001,5,321214,301477,19737,6.1
AK,2001,6,321358,301684,19674,6.1
AK,2001,7,321756,301878,19878,6.2
AK,2001,8,322047,302051,19996,6.2
AK,2001,9,322083,302201,19882,6.2
AK,2001,10,322160,302335,19825,6.2
AK,2001,11,322727,302464,20263,6.3
AK,2001,12,323180,302598,20582,6.4
AK,2002,1,325007,303819,21188,6.5
AK,2002,2,325462,304023,21439,6.6
AK,2002,3,326779,304232,22547,6.9
AK,2002,4,327354,304446,22908,7
AK,2002,5,327240,304670,22570,6.9
AK,2002,6,328350,304909,23441,7.1
AK,2002,7,328831,305165,23666,7.2
AK,2002,8,329511,305438,24073,7.3
AK,2002,9,330066,305722,24344,7.4
AK,2002,10,330057,306013,24044,7.3
AK,2002,11,330562,306304,24258,7.3
AK,2002,12,331400,306596,24804,7.5
AK,2003,1,334212,308860,25352,7.6
AK,2003,2,334928,309190,25738,7.7
AK,2003,3,335108,309520,25588,7.6
AK,2003,4,335747,309853,25894,7.7
AK,2003,5,335868,310197,25671,7.6
AK,2003,6,336412,310541,25871,7.7
AK,2003,7,336856,310890,25966,7.7
AK,2003,8,337057,311252,25805,7.7
AK,2003,9,337209,311626,25583,7.6
AK,2003,10,337620,312008,25612,7.6
AK,2003,11,338526,312399,26127,7.7
AK,2003,12,339042,312806,26236,7.7
AK,2004,1,338195,312259,25936,7.7
AK,2004,2,338497,312666,25831,7.6
AK,2004,3,338361,313094,25267,7.5
AK,2004,4,338483,313538,24945,7.4
AK,2004,5,338743,313996,24747,7.3
AK,2004,6,339717,314472,25245,7.4
AK,2004,7,339598,314961,24637,7.3
AK,2004,8,340370,315448,24922,7.3
AK,2004,9,340960,315937,25023,7.3
AK,2004,10,341428,316419,25009,7.3
AK,2004,11,341856,316890,24966,7.3
AK,2004,12,342099,317358,24741,7.2
AK,2005,1,342405,317816,24589,7.2
AK,2005,2,342522,318286,24236,7.1
AK,2005,3,342293,318774,23519,6.9
AK,2005,4,342339,319279,23060,6.7
AK,2005,5,342812,319794,23018,6.7
AK,2005,6,343404,320319,23085,6.7
AK,2005,7,344179,320861,23318,6.8
AK,2005,8,344794,321404,23390,6.8
AK,2005,9,345781,321950,23831,6.9
AK,2005,10,346705,322504,24201,7
AK,2005,11,347374,323074,24300,7
AK,2005,12,347931,323663,24268,7
AK,2006,1,348547,324277,24270,7
AK,2006,2,348790,324873,23917,6.9
AK,2006,3,349003,325445,23558,6.8
AK,2006,4,349341,325983,23358,6.7
AK,2006,5,349568,326483,23085,6.6
AK,2006,6,349231,326937,22294,6.4
AK,2006,7,349877,327321,22556,6.4
AK,2006,8,350126,327657,22469,6.4
AK,2006,9,350464,327950,22514,6.4
AK,2006,10,350597,328205,22392,6.4
AK,2006,11,350433,328442,21991,6.3
AK,2006,12,350821,328654,22167,6.3
AK,2007,1,350195,328842,21353,6.1
AK,2007,2,349937,329040,20897,6
AK,2007,3,350313,329245,21068,6
AK,2007,4,350427,329457,20970,6
AK,2007,5,350885,329676,21209,6
AK,2007,6,351330,329904,21426,6.1
AK,2007,7,351839,330135,21704,6.2
AK,2007,8,352355,330374,21981,6.2
AK,2007,9,352906,330621,22285,6.3
AK,2007,10,352912,330882,22030,6.2
AK,2007,11,353443,331158,22285,6.3
AK,2007,12,353875,331451,22424,6.3
AK,2008,1,354345,331761,22584,6.4
AK,2008,2,355101,332079,23022,6.5
AK,2008,3,355551,332399,23152,6.5
AK,2008,4,356247,332721,23526,6.6
AK,2008,5,356621,333037,23584,6.6
AK,2008,6,356982,333330,23652,6.6
AK,2008,7,357440,333605,23835,6.7
AK,2008,8,357906,333858,24048,6.7
AK,2008,9,358231,334093,24138,6.7
AK,2008,10,358776,334320,24456,6.8
AK,2008,11,359103,334542,24561,6.8
AK,2008,12,359328,334761,24567,6.8
AK,2009,1,359186,330752,28434,7.9
AZ,1976,1,958876,860270,98606,10.3
AZ,1976,2,962769,864046,98723,10.3
AZ,1976,3,966625,867891,98734,10.2
AZ,1976,4,966676,870299,96377,10
AZ,1976,5,968296,875899,92397,9.5
AZ,1976,6,977767,883689,94078,9.6
AZ,1976,7,987528,891029,96499,9.8
AZ,1976,8,986386,891720,94666,9.6
AZ,1976,9,989610,894268,95342,9.6
AZ,1976,10,999808,901908,97900,9.8
AZ,1976,11,1004264,908502,95762,9.5
AZ,1976,12,1012497,916229,96268,9.5
AZ,1977,1,1015943,920686,95257,9.4
AZ,1977,2,1021571,927104,94467,9.2
AZ,1977,3,1026122,932368,93754,9.1
AZ,1977,4,1031626,937278,94348,9.1
AZ,1977,5,1036751,947255,89496,8.6
AZ,1977,6,1042852,955559,87293,8.4
AZ,1977,7,1043733,962772,80961,7.8
AZ,1977,8,1054997,968658,86339,8.2
AZ,1977,9,1058343,972330,86013,8.1
AZ,1977,10,1058199,973981,84218,8
AZ,1977,11,1057856,976880,80976,7.7
AZ,1977,12,1056812,979498,77314,7.3
AZ,1978,1,1059166,985770,73396,6.9
AZ,1978,2,1060052,986824,73228,6.9
AZ,1978,3,1058958,991035,67923,6.4
AZ,1978,4,1068341,1001165,67176,6.3
AZ,1978,5,1071578,1007583,63995,6
AZ,1978,6,1077607,1015308,62299,5.8
AZ,1978,7,1085737,1024496,61241,5.6
AZ,1978,8,1085711,1031117,54594,5
AZ,1978,9,1096020,1033777,62243,5.7
AZ,1978,10,1106305,1040581,65724,5.9
AZ,1978,11,1112699,1044973,67726,6.1
AZ,1978,12,1118230,1050777,67453,6
AZ,1979,1,1127806,1061102,66704,5.9
AZ,1979,2,1138207,1074077,64130,5.6
AZ,1979,3,1141435,1081068,60367,5.3
AZ,1979,4,1139853,1082469,57384,5
AZ,1979,5,1144063,1086541,57522,5
AZ,1979,6,1145272,1091135,54137,4.7
AZ,1979,7,1150656,1097765,52891,4.6
AZ,1979,8,1157183,1102204,54979,4.8
AZ,1979,9,1165800,1108933,56867,4.9
AZ,1979,10,1175620,1116501,59119,5
AZ,1979,11,1184246,1122119,62127,5.2
AZ,1979,12,1190584,1124664,65920,5.5
AZ,1980,1,1199714,1128775,70939,5.9
AZ,1980,2,1204798,1132452,72346,6
AZ,1980,3,1213789,1137640,76149,6.3
AZ,1980,4,1222492,1142933,79559,6.5
AZ,1980,5,1231501,1141997,89504,7.3
AZ,1980,6,1235343,1143189,92154,7.5
AZ,1980,7,1236882,1144184,92698,7.5
AZ,1980,8,1234040,1145492,88548,7.2
AZ,1980,9,1237616,1151752,85864,6.9
AZ,1980,10,1239589,1156001,83588,6.7
AZ,1980,11,1247681,1164991,82690,6.6
AZ,1980,12,1245978,1170257,75721,6.1
AZ,1981,1,1248278,1175046,73232,5.9
AZ,1981,2,1251440,1174456,76984,6.2
AZ,1981,3,1259352,1180374,78978,6.3
AZ,1981,4,1259655,1185174,74481,5.9
AZ,1981,5,1261712,1190264,71448,5.7
AZ,1981,6,1267094,1193926,73168,5.8
AZ,1981,7,1277028,1201976,75052,5.9
AZ,1981,8,1278875,1202905,75970,5.9
AZ,1981,9,1283565,1204643,78922,6.1
AZ,1981,10,1287521,1204116,83405,6.5
AZ,1981,11,1293849,1205724,88125,6.8
AZ,1981,12,1302318,1207511,94807,7.3
AZ,1982,1,1312901,1206661,106240,8.1
AZ,1982,2,1319740,1210280,109460,8.3
AZ,1982,3,1322989,1206605,116384,8.8
AZ,1982,4,1328243,1208580,119663,9
AZ,1982,5,1339749,1211785,127964,9.6
AZ,1982,6,1346869,1212607,134262,10
AZ,1982,7,1350027,1208775,141252,10.5
AZ,1982,8,1353697,1209495,144202,10.7
AZ,1982,9,1357393,1209234,148159,10.9
AZ,1982,10,1361030,1209628,151402,11.1
AZ,1982,11,1365595,1211333,154262,11.3
AZ,1982,12,1372464,1214900,157564,11.5
AZ,1983,1,1376170,1219381,156789,11.4
AZ,1983,2,1383935,1225076,158859,11.5
AZ,1983,3,1386540,1232192,154348,11.1
AZ,1983,4,1389436,1240935,148501,10.7
AZ,1983,5,1388680,1244832,143848,10.4
AZ,1983,6,1395850,1253857,141993,10.2
AZ,1983,7,1411754,1269071,142683,10.1
AZ,1983,8,1415237,1276384,138853,9.8
AZ,1983,9,1377439,1290437,87002,6.3
AZ,1983,10,1387763,1297869,89894,6.5
AZ,1983,11,1392156,1308374,83782,6
AZ,1983,12,1404056,1321046,83010,5.9
AZ,1984,1,1411698,1330686,81012,5.7
AZ,1984,2,1415569,1339751,75818,5.4
AZ,1984,3,1420292,1346238,74054,5.2
AZ,1984,4,1426147,1352638,73509,5.2
AZ,1984,5,1432425,1363374,69051,4.8
AZ,1984,6,1435357,1371390,63967,4.5
AZ,1984,7,1436404,1375817,60587,4.2
AZ,1984,8,1442245,1377376,64869,4.5
AZ,1984,9,1447620,1380843,66777,4.6
AZ,1984,10,1457911,1384666,73245,5
AZ,1984,11,1462043,1386335,75708,5.2
AZ,1984,12,1466241,1384815,81426,5.6
AZ,1985,1,1471395,1385507,85888,5.8
AZ,1985,2,1477406,1388974,88432,6
AZ,1985,3,1479838,1390774,89064,6
AZ,1985,4,1484865,1393678,91187,6.1
AZ,1985,5,1488906,1393489,95417,6.4
AZ,1985,6,1493165,1395252,97913,6.6
AZ,1985,7,1496443,1397269,99174,6.6
AZ,1985,8,1505673,1408218,97455,6.5
AZ,1985,9,1510846,1413217,97629,6.5
AZ,1985,10,1511572,1412903,98669,6.5
AZ,1985,11,1517769,1420135,97634,6.4
AZ,1985,12,1523597,1424954,98643,6.5
AZ,1986,1,1532515,1434761,97754,6.4
AZ,1986,2,1542853,1442439,100414,6.5
AZ,1986,3,1552269,1449238,103031,6.6
AZ,1986,4,1558991,1452192,106799,6.9
AZ,1986,5,1562875,1456839,106036,6.8
AZ,1986,6,1571889,1463049,108840,6.9
AZ,1986,7,1574969,1466099,108870,6.9
AZ,1986,8,1580996,1470612,110384,7
AZ,1986,9,1580962,1468693,112269,7.1
AZ,1986,10,1586554,1474053,112501,7.1
AZ,1986,11,1591911,1478462,113449,7.1
AZ,1986,12,1593226,1480880,112346,7.1
AZ,1987,1,1598489,1484875,113614,7.1
AZ,1987,2,1601283,1489622,111661,7
AZ,1987,3,1603673,1494128,109545,6.8
AZ,1987,4,1606007,1498845,107162,6.7
AZ,1987,5,1607038,1502738,104300,6.5
AZ,1987,6,1611776,1508565,103211,6.4
AZ,1987,7,1613863,1512520,101343,6.3
AZ,1987,8,1615934,1517562,98372,6.1
AZ,1987,9,1616396,1517088,99308,6.1
AZ,1987,10,1628184,1529194,98990,6.1
AZ,1987,11,1633820,1534248,99572,6.1
AZ,1987,12,1641815,1540153,101662,6.2
AZ,1988,1,1641734,1538847,102887,6.3
AZ,1988,2,1644514,1541394,103120,6.3
AZ,1988,3,1648239,1543698,104541,6.3
AZ,1988,4,1654382,1547698,106684,6.4
AZ,1988,5,1660652,1551094,109558,6.6
AZ,1988,6,1664688,1558093,106595,6.4
AZ,1988,7,1665607,1559042,106565,6.4
AZ,1988,8,1670578,1565962,104616,6.3
AZ,1988,9,1680832,1575616,105216,6.3
AZ,1988,10,1689853,1582150,107703,6.4
AZ,1988,11,1691694,1586727,104967,6.2
AZ,1988,12,1698571,1593514,105057,6.2
AZ,1989,1,1697435,1599508,97927,5.8
AZ,1989,2,1700488,1604960,95528,5.6
AZ,1989,3,1703173,1610737,92436,5.4
AZ,1989,4,1706666,1612915,93751,5.5
AZ,1989,5,1708126,1618238,89888,5.3
AZ,1989,6,1709678,1617887,91791,5.4
AZ,1989,7,1715976,1623206,92770,5.4
AZ,1989,8,1718504,1626257,92247,5.4
AZ,1989,9,1722907,1635138,87769,5.1
AZ,1989,10,1722260,1641959,80301,4.7
AZ,1989,11,1731091,1648042,83049,4.8
AZ,1989,12,1737629,1653735,83894,4.8
AZ,1990,1,1752362,1663144,89218,5.1
AZ,1990,2,1766721,1672337,94384,5.3
AZ,1990,3,1773691,1676899,96792,5.5
AZ,1990,4,1782195,1684689,97506,5.5
AZ,1990,5,1790550,1692573,97977,5.5
AZ,1990,6,1793553,1697531,96022,5.4
AZ,1990,7,1795429,1698378,97051,5.4
AZ,1990,8,1798792,1703461,95331,5.3
AZ,1990,9,1800173,1707898,92275,5.1
AZ,1990,10,1802268,1711868,90400,5
AZ,1990,11,1802632,1710229,92403,5.1
AZ,1990,12,1800553,1709954,90599,5
AZ,1991,1,1800592,1714607,85985,4.8
AZ,1991,2,1799561,1711513,88048,4.9
AZ,1991,3,1799821,1713229,86592,4.8
AZ,1991,4,1797459,1709504,87955,4.9
AZ,1991,5,1806304,1710598,95706,5.3
AZ,1991,6,1814792,1713329,101463,5.6
AZ,1991,7,1814236,1712386,101850,5.6
AZ,1991,8,1823959,1713545,110414,6.1
AZ,1991,9,1830503,1715013,115490,6.3
AZ,1991,10,1841297,1719984,121313,6.6
AZ,1991,11,1850299,1723414,126885,6.9
AZ,1991,12,1858064,1725603,132461,7.1
AZ,1992,1,1866717,1728419,138298,7.4
AZ,1992,2,1869915,1730046,139869,7.5
AZ,1992,3,1878647,1733900,144747,7.7
AZ,1992,4,1884122,1742034,142088,7.5
AZ,1992,5,1888141,1747509,140632,7.4
AZ,1992,6,1893727,1751642,142085,7.5
AZ,1992,7,1900194,1758421,141773,7.5
AZ,1992,8,1901227,1762381,138846,7.3
AZ,1992,9,1913771,1772587,141184,7.4
AZ,1992,10,1908388,1769752,138636,7.3
AZ,1992,11,1908593,1770727,137866,7.2
AZ,1992,12,1914450,1777753,136697,7.1
AZ,1993,1,1921125,1784343,136782,7.1
AZ,1993,2,1920253,1790161,130092,6.8
AZ,1993,3,1928266,1799494,128772,6.7
AZ,1993,4,1940973,1812149,128824,6.6
AZ,1993,5,1945037,1824049,120988,6.2
AZ,1993,6,1950179,1831537,118642,6.1
AZ,1993,7,1958862,1840047,118815,6.1
AZ,1993,8,1966987,1847696,119291,6.1
AZ,1993,9,1981482,1860965,120517,6.1
AZ,1993,10,1997324,1873654,123670,6.2
AZ,1993,11,2007311,1882073,125238,6.2
AZ,1993,12,2024093,1896255,127838,6.3
AZ,1994,1,2036490,1911722,124768,6.1
AZ,1994,2,2050787,1924056,126731,6.2
AZ,1994,3,2066061,1938307,127754,6.2
AZ,1994,4,2078861,1951044,127817,6.1
AZ,1994,5,2088707,1958651,130056,6.2
AZ,1994,6,2101445,1968837,132608,6.3
AZ,1994,7,2113944,1981993,131951,6.2
AZ,1994,8,2131300,1996855,134445,6.3
AZ,1994,9,2138475,2005233,133242,6.2
AZ,1994,10,2145580,2015239,130341,6.1
AZ,1994,11,2155050,2028059,126991,5.9
AZ,1994,12,2163732,2040666,123066,5.7
AZ,1995,1,2169915,2051731,118184,5.4
AZ,1995,2,2180857,2065582,115275,5.3
AZ,1995,3,2191349,2073507,117842,5.4
AZ,1995,4,2200340,2080019,120321,5.5
AZ,1995,5,2210817,2089610,121207,5.5
AZ,1995,6,2219669,2100451,119218,5.4
AZ,1995,7,2225562,2105879,119683,5.4
AZ,1995,8,2229569,2108652,120917,5.4
AZ,1995,9,2232887,2113138,119749,5.4
AZ,1995,10,2235635,2118602,117033,5.2
AZ,1995,11,2235704,2119717,115987,5.2
AZ,1995,12,2237479,2122102,115377,5.2
AZ,1996,1,2246429,2128993,117436,5.2
AZ,1996,2,2253188,2132802,120386,5.3
AZ,1996,3,2256461,2133518,122943,5.4
AZ,1996,4,2258461,2135747,122714,5.4
AZ,1996,5,2268420,2139430,128990,5.7
AZ,1996,6,2273605,2142754,130851,5.8
AZ,1996,7,2277172,2145689,131483,5.8
AZ,1996,8,2283979,2152112,131867,5.8
AZ,1996,9,2283776,2151705,132071,5.8
AZ,1996,10,2281275,2152769,128506,5.6
AZ,1996,11,2288974,2164631,124343,5.4
AZ,1996,12,2285951,2166731,119220,5.2
AZ,1997,1,2289253,2168863,120390,5.3
AZ,1997,2,2288778,2172441,116337,5.1
AZ,1997,3,2285239,2177306,107933,4.7
AZ,1997,4,2286314,2179637,106677,4.7
AZ,1997,5,2290746,2185920,104826,4.6
AZ,1997,6,2292302,2188835,103467,4.5
AZ,1997,7,2298797,2195307,103490,4.5
AZ,1997,8,2303106,2199889,103217,4.5
AZ,1997,9,2310573,2208791,101782,4.4
AZ,1997,10,2320553,2220864,99689,4.3
AZ,1997,11,2330604,2228145,102459,4.4
AZ,1997,12,2336541,2236809,99732,4.3
AZ,1998,1,2337913,2240930,96983,4.1
AZ,1998,2,2344025,2244825,99200,4.2
AZ,1998,3,2356753,2253944,102809,4.4
AZ,1998,4,2362502,2259460,103042,4.4
AZ,1998,5,2368841,2266946,101895,4.3
AZ,1998,6,2374343,2272255,102088,4.3
AZ,1998,7,2383211,2279180,104031,4.4
AZ,1998,8,2396487,2289648,106839,4.5
AZ,1998,9,2408270,2300757,107513,4.5
AZ,1998,10,2409559,2306130,103429,4.3
AZ,1998,11,2418635,2312691,105944,4.4
AZ,1998,12,2427794,2319607,108187,4.5
AZ,1999,1,2435782,2326344,109438,4.5
AZ,1999,2,2442283,2332384,109899,4.5
AZ,1999,3,2447507,2335337,112170,4.6
AZ,1999,4,2463057,2347081,115976,4.7
AZ,1999,5,2463306,2346577,116729,4.7
AZ,1999,6,2467478,2355169,112309,4.6
AZ,1999,7,2477786,2362451,115335,4.7
AZ,1999,8,2477192,2363420,113772,4.6
AZ,1999,9,2475712,2367656,108056,4.4
AZ,1999,10,2479044,2372188,106856,4.3
AZ,1999,11,2481326,2375834,105492,4.3
AZ,1999,12,2484904,2379846,105058,4.2
AZ,2000,1,2486337,2383370,102967,4.1
AZ,2000,2,2487806,2387900,99906,4
AZ,2000,3,2490684,2392164,98520,4
AZ,2000,4,2490483,2391805,98678,4
AZ,2000,5,2501095,2400759,100336,4
AZ,2000,6,2501979,2400827,101152,4
AZ,2000,7,2503908,2402022,101886,4.1
AZ,2000,8,2508771,2406097,102674,4.1
AZ,2000,9,2515536,2416502,99034,3.9
AZ,2000,10,2520463,2419865,100598,4
AZ,2000,11,2523857,2424782,99075,3.9
AZ,2000,12,2532749,2432897,99852,3.9
AZ,2001,1,2538112,2437653,100459,4
AZ,2001,2,2549925,2446962,102963,4
AZ,2001,3,2560549,2452600,107949,4.2
AZ,2001,4,2561037,2450981,110056,4.3
AZ,2001,5,2563839,2450837,113002,4.4
AZ,2001,6,2571752,2453557,118195,4.6
AZ,2001,7,2575475,2456805,118670,4.6
AZ,2001,8,2584786,2460614,124172,4.8
AZ,2001,9,2592538,2461260,131278,5.1
AZ,2001,10,2594237,2457310,136927,5.3
AZ,2001,11,2599652,2455338,144314,5.6
AZ,2001,12,2607815,2457519,150296,5.8
AZ,2002,1,2644951,2490058,154893,5.9
AZ,2002,2,2649960,2491152,158808,6
AZ,2002,3,2656410,2497046,159364,6
AZ,2002,4,2663709,2505237,158472,5.9
AZ,2002,5,2670886,2508443,162443,6.1
AZ,2002,6,2678184,2513026,165158,6.2
AZ,2002,7,2677223,2512445,164778,6.2
AZ,2002,8,2685709,2520834,164875,6.1
AZ,2002,9,2684247,2520204,164043,6.1
AZ,2002,10,2687333,2523082,164251,6.1
AZ,2002,11,2698802,2535136,163666,6.1
AZ,2002,12,2694866,2535902,158964,5.9
AZ,2003,1,2703474,2545404,158070,5.8
AZ,2003,2,2705843,2546869,158974,5.9
AZ,2003,3,2711256,2551062,160194,5.9
AZ,2003,4,2715667,2555675,159992,5.9
AZ,2003,5,2725157,2562803,162354,6
AZ,2003,6,2726882,2566644,160238,5.9
AZ,2003,7,2731538,2571673,159865,5.9
AZ,2003,8,2740513,2582429,158084,5.8
AZ,2003,9,2739655,2586357,153298,5.6
AZ,2003,10,2744786,2597290,147496,5.4
AZ,2003,11,2746408,2601808,144600,5.3
AZ,2003,12,2756251,2609633,146618,5.3
AZ,2004,1,2762183,2615401,146782,5.3
AZ,2004,2,2766002,2619254,146748,5.3
AZ,2004,3,2770037,2627025,143012,5.2
AZ,2004,4,2780037,2634647,145390,5.2
AZ,2004,5,2779973,2639685,140288,5
AZ,2004,6,2785066,2645768,139298,5
AZ,2004,7,2792558,2654146,138412,5
AZ,2004,8,2794892,2657431,137461,4.9
AZ,2004,9,2797187,2661752,135435,4.8
AZ,2004,10,2810845,2677481,133364,4.7
AZ,2004,11,2813348,2681881,131467,4.7
AZ,2004,12,2815435,2688847,126588,4.5
AZ,2005,1,2816860,2689135,127725,4.5
AZ,2005,2,2822367,2694472,127895,4.5
AZ,2005,3,2831903,2700055,131848,4.7
AZ,2005,4,2852450,2717399,135051,4.7
AZ,2005,5,2854994,2720631,134363,4.7
AZ,2005,6,2861600,2727864,133736,4.7
AZ,2005,7,2873981,2738262,135719,4.7
AZ,2005,8,2881853,2746222,135631,4.7
AZ,2005,9,2893188,2756630,136558,4.7
AZ,2005,10,2895129,2759391,135738,4.7
AZ,2005,11,2903387,2770680,132707,4.6
AZ,2005,12,2912932,2781872,131060,4.5
AZ,2006,1,2928464,2798455,130009,4.4
AZ,2006,2,2937941,2812814,125127,4.3
AZ,2006,3,2946552,2822706,123846,4.2
AZ,2006,4,2954506,2829620,124886,4.2
AZ,2006,5,2962913,2839665,123248,4.2
AZ,2006,6,2972022,2847820,124202,4.2
AZ,2006,7,2974630,2852270,122360,4.1
AZ,2006,8,2978605,2862387,116218,3.9
AZ,2006,9,2990213,2871176,119037,4
AZ,2006,10,2996884,2876322,120562,4
AZ,2006,11,3002747,2884122,118625,4
AZ,2006,12,3009059,2891329,117730,3.9
AZ,2007,1,3008636,2892509,116127,3.9
AZ,2007,2,3014597,2900716,113881,3.8
AZ,2007,3,3018481,2905942,112539,3.7
AZ,2007,4,3016165,2904924,111241,3.7
AZ,2007,5,3020728,2912226,108502,3.6
AZ,2007,6,3026045,2917343,108702,3.6
AZ,2007,7,3033847,2922388,111459,3.7
AZ,2007,8,3040750,2929640,111110,3.7
AZ,2007,9,3047749,2932968,114781,3.8
AZ,2007,10,3057839,2936807,121032,4
AZ,2007,11,3070937,2942729,128208,4.2
AZ,2007,12,3076355,2944715,131640,4.3
AZ,2008,1,3081403,2945782,135621,4.4
AZ,2008,2,3085076,2944876,140200,4.5
AZ,2008,3,3090448,2945931,144517,4.7
AZ,2008,4,3098178,2947730,150448,4.9
AZ,2008,5,3113180,2951468,161712,5.2
AZ,2008,6,3127865,2955664,172201,5.5
AZ,2008,7,3146036,2966373,179663,5.7
AZ,2008,8,3158696,2971019,187677,5.9
AZ,2008,9,3166594,2975200,191394,6
AZ,2008,10,3172773,2977490,195283,6.2
AZ,2008,11,3172433,2970905,201528,6.4
AZ,2008,12,3179315,2969944,209371,6.6
AZ,2009,1,3157180,2936455,220725,7
AR,1976,1,885780,820709,65071,7.3
AR,1976,2,883063,819966,63097,7.1
AR,1976,3,883035,819675,63360,7.2
AR,1976,4,883619,820999,62620,7.1
AR,1976,5,885068,824192,60876,6.9
AR,1976,6,889279,828398,60881,6.8
AR,1976,7,895501,834688,60813,6.8
AR,1976,8,897225,835753,61472,6.9
AR,1976,9,896187,837414,58773,6.6
AR,1976,10,899331,840698,58633,6.5
AR,1976,11,904403,845159,59244,6.6
AR,1976,12,909432,849781,59651,6.6
AR,1977,1,916570,854727,61843,6.7
AR,1977,2,917773,857643,60130,6.6
AR,1977,3,917873,859085,58788,6.4
AR,1977,4,919634,861215,58419,6.4
AR,1977,5,921969,864411,57558,6.2
AR,1977,6,927313,868997,58316,6.3
AR,1977,7,931992,872711,59281,6.4
AR,1977,8,931970,873051,58919,6.3
AR,1977,9,937481,878628,58853,6.3
AR,1977,10,938567,879700,58867,6.3
AR,1977,11,940648,881074,59574,6.3
AR,1977,12,940101,880075,60026,6.4
AR,1978,1,934232,877761,56471,6
AR,1978,2,938860,880014,58846,6.3
AR,1978,3,943938,886580,57358,6.1
AR,1978,4,941773,886221,55552,5.9
AR,1978,5,941530,885582,55948,5.9
AR,1978,6,945245,888382,56863,6
AR,1978,7,949086,891140,57946,6.1
AR,1978,8,952577,894220,58357,6.1
AR,1978,9,952626,892917,59709,6.3
AR,1978,10,956073,895596,60477,6.3
AR,1978,11,957846,897595,60251,6.3
AR,1978,12,963841,903058,60783,6.3
AR,1979,1,969440,905979,63461,6.5
AR,1979,2,972137,910468,61669,6.3
AR,1979,3,975721,916038,59683,6.1
AR,1979,4,977410,918592,58818,6
AR,1979,5,976938,920210,56728,5.8
AR,1979,6,978316,920760,57556,5.9
AR,1979,7,978249,920779,57470,5.9
AR,1979,8,979550,921464,58086,5.9
AR,1979,9,975492,916959,58533,6
AR,1979,10,979332,921241,58091,5.9
AR,1979,11,979939,921276,58663,6
AR,1979,12,980969,921343,59626,6.1
AR,1980,1,980765,920239,60526,6.2
AR,1980,2,986569,922192,64377,6.5
AR,1980,3,986522,921083,65439,6.6
AR,1980,4,987699,917718,69981,7.1
AR,1980,5,991633,916084,75549,7.6
AR,1980,6,995950,919454,76496,7.7
AR,1980,7,997944,918751,79193,7.9
AR,1980,8,998415,919410,79005,7.9
AR,1980,9,998860,919639,79221,7.9
AR,1980,10,998256,918120,80136,8
AR,1980,11,999935,918966,80969,8.1
AR,1980,12,1003348,920588,82760,8.2
AR,1981,1,1008511,925628,82883,8.2
AR,1981,2,1012654,927480,85174,8.4
AR,1981,3,1015382,929274,86108,8.5
AR,1981,4,1018654,933193,85461,8.4
AR,1981,5,1022558,936587,85971,8.4
AR,1981,6,1022765,935431,87334,8.5
AR,1981,7,1022808,936185,86623,8.5
AR,1981,8,1024917,938103,86814,8.5
AR,1981,9,1026524,939331,87193,8.5
AR,1981,10,1025879,937182,88697,8.6
AR,1981,11,1022268,932142,90126,8.8
AR,1981,12,1021732,930731,91001,8.9
AR,1982,1,1022087,927358,94729,9.3
AR,1982,2,1020095,926452,93643,9.2
AR,1982,3,1019245,924649,94596,9.3
AR,1982,4,1019021,924924,94097,9.2
AR,1982,5,1020856,927038,93818,9.2
AR,1982,6,1021715,927415,94300,9.2
AR,1982,7,1018455,923130,95325,9.4
AR,1982,8,1019010,921552,97458,9.6
AR,1982,9,1026253,928358,97895,9.5
AR,1982,10,1031830,932148,99682,9.7
AR,1982,11,1029642,927902,101740,9.9
AR,1982,12,1027232,923360,103872,10.1
AR,1983,1,1028661,924117,104544,10.2
AR,1983,2,1028418,923102,105316,10.2
AR,1983,3,1027112,922402,104710,10.2
AR,1983,4,1025997,922775,103222,10.1
AR,1983,5,1026465,923769,102696,10
AR,1983,6,1025033,924622,100411,9.8
AR,1983,7,1026428,926880,99548,9.7
AR,1983,8,1026566,927477,99089,9.7
AR,1983,9,1028220,929476,98744,9.6
AR,1983,10,1031691,934499,97192,9.4
AR,1983,11,1037627,943093,94534,9.1
AR,1983,12,1043040,948821,94219,9
AR,1984,1,1045684,953183,92501,8.8
AR,1984,2,1045900,955342,90558,8.7
AR,1984,3,1043840,954238,89602,8.6
AR,1984,4,1043934,955064,88870,8.5
AR,1984,5,1044288,956828,87460,8.4
AR,1984,6,1041486,955992,85494,8.2
AR,1984,7,1041698,957927,83771,8
AR,1984,8,1041546,958373,83173,8
AR,1984,9,1039174,956238,82936,8
AR,1984,10,1037726,953181,84545,8.1
AR,1984,11,1037308,952001,85307,8.2
AR,1984,12,1038974,954248,84726,8.2
AR,1985,1,1042387,955985,86402,8.3
AR,1985,2,1048068,959334,88734,8.5
AR,1985,3,1051568,962674,88894,8.5
AR,1985,4,1056267,966559,89708,8.5
AR,1985,5,1058485,969209,89276,8.4
AR,1985,6,1062545,972732,89813,8.5
AR,1985,7,1061185,969837,91348,8.6
AR,1985,8,1062105,971028,91077,8.6
AR,1985,9,1064345,973053,91292,8.6
AR,1985,10,1063523,972739,90784,8.5
AR,1985,11,1061507,969611,91896,8.7
AR,1985,12,1061277,969799,91478,8.6
AR,1986,1,1061495,970987,90508,8.5
AR,1986,2,1060411,968601,91810,8.7
AR,1986,3,1060511,969189,91322,8.6
AR,1986,4,1059630,968518,91112,8.6
AR,1986,5,1060396,970666,89730,8.5
AR,1986,6,1059931,969565,90366,8.5
AR,1986,7,1060553,970937,89616,8.4
AR,1986,8,1063951,974448,89503,8.4
AR,1986,9,1065835,976552,89283,8.4
AR,1986,10,1067313,976868,90445,8.5
AR,1986,11,1069564,978092,91472,8.6
AR,1986,12,1070976,980506,90470,8.4
AR,1987,1,1071260,981556,89704,8.4
AR,1987,2,1072836,983198,89638,8.4
AR,1987,3,1075849,985173,90676,8.4
AR,1987,4,1082402,992668,89734,8.3
AR,1987,5,1086174,996572,89602,8.2
AR,1987,6,1090501,1001414,89087,8.2
AR,1987,7,1092124,1004292,87832,8
AR,1987,8,1094447,1006353,88094,8
AR,1987,9,1097644,1009629,88015,8
AR,1987,10,1101778,1014084,87694,8
AR,1987,11,1104516,1016751,87765,7.9
AR,1987,12,1105744,1018721,87023,7.9
AR,1988,1,1104132,1015979,88153,8
AR,1988,2,1106060,1018857,87203,7.9
AR,1988,3,1107236,1020040,87196,7.9
AR,1988,4,1106685,1019699,86986,7.9
AR,1988,5,1104931,1018063,86868,7.9
AR,1988,6,1105916,1020998,84918,7.7
AR,1988,7,1107053,1023313,83740,7.6
AR,1988,8,1105485,1021461,84024,7.6
AR,1988,9,1107861,1023912,83949,7.6
AR,1988,10,1110572,1027613,82959,7.5
AR,1988,11,1113555,1031464,82091,7.4
AR,1988,12,1113353,1031205,82148,7.4
AR,1989,1,1116079,1034609,81470,7.3
AR,1989,2,1119001,1036292,82709,7.4
AR,1989,3,1122153,1040046,82107,7.3
AR,1989,4,1121845,1040445,81400,7.3
AR,1989,5,1125695,1045053,80642,7.2
AR,1989,6,1126416,1047241,79175,7
AR,1989,7,1126612,1049034,77578,6.9
AR,1989,8,1127717,1050804,76913,6.8
AR,1989,9,1128498,1052018,76480,6.8
AR,1989,10,1128920,1052864,76056,6.7
AR,1989,11,1127861,1051703,76158,6.8
AR,1989,12,1129850,1053300,76550,6.8
AR,1990,1,1130103,1055546,74557,6.6
AR,1990,2,1129728,1054790,74938,6.6
AR,1990,3,1127415,1051390,76025,6.7
AR,1990,4,1127263,1051792,75471,6.7
AR,1990,5,1124414,1049243,75171,6.7
AR,1990,6,1122376,1047842,74534,6.6
AR,1990,7,1122096,1046851,75245,6.7
AR,1990,8,1124552,1049245,75307,6.7
AR,1990,9,1126000,1049291,76709,6.8
AR,1990,10,1126221,1048294,77927,6.9
AR,1990,11,1126474,1047998,78476,7
AR,1990,12,1124901,1045546,79355,7.1
AR,1991,1,1125577,1044357,81220,7.2
AR,1991,2,1123960,1043915,80045,7.1
AR,1991,3,1120934,1040350,80584,7.2
AR,1991,4,1121223,1040229,80994,7.2
AR,1991,5,1124385,1043362,81023,7.2
AR,1991,6,1123675,1043186,80489,7.2
AR,1991,7,1123147,1042517,80630,7.2
AR,1991,8,1125221,1044890,80331,7.1
AR,1991,9,1128128,1047134,80994,7.2
AR,1991,10,1130612,1049527,81085,7.2
AR,1991,11,1136844,1054773,82071,7.2
AR,1991,12,1141414,1057047,84367,7.4
AR,1992,1,1148599,1062860,85739,7.5
AR,1992,2,1150992,1065767,85225,7.4
AR,1992,3,1154291,1070027,84264,7.3
AR,1992,4,1156417,1071687,84730,7.3
AR,1992,5,1157301,1073510,83791,7.2
AR,1992,6,1156675,1072746,83929,7.3
AR,1992,7,1157707,1075136,82571,7.1
AR,1992,8,1157112,1075436,81676,7.1
AR,1992,9,1157754,1076416,81338,7
AR,1992,10,1158388,1078728,79660,6.9
AR,1992,11,1156662,1078480,78182,6.8
AR,1992,12,1156956,1079795,77161,6.7
AR,1993,1,1158943,1082934,76009,6.6
AR,1993,2,1162000,1088407,73593,6.3
AR,1993,3,1165469,1091984,73485,6.3
AR,1993,4,1169812,1095748,74064,6.3
AR,1993,5,1173984,1100335,73649,6.3
AR,1993,6,1178500,1106264,72236,6.1
AR,1993,7,1183034,1111721,71313,6
AR,1993,8,1185177,1114110,71067,6
AR,1993,9,1186512,1115249,71263,6
AR,1993,10,1190206,1119779,70427,5.9
AR,1993,11,1192637,1122917,69720,5.8
AR,1993,12,1194945,1125633,69312,5.8
AR,1994,1,1197272,1129697,67575,5.6
AR,1994,2,1198366,1132485,65881,5.5
AR,1994,3,1203629,1136401,67228,5.6
AR,1994,4,1209667,1142924,66743,5.5
AR,1994,5,1211877,1145140,66737,5.5
AR,1994,6,1211953,1145983,65970,5.4
AR,1994,7,1215694,1150587,65107,5.4
AR,1994,8,1220372,1155692,64680,5.3
AR,1994,9,1222468,1159188,63280,5.2
AR,1994,10,1221118,1158297,62821,5.1
AR,1994,11,1222528,1161492,61036,5
AR,1994,12,1223337,1162824,60513,4.9
AR,1995,1,1225450,1166266,59184,4.8
AR,1995,2,1228109,1166983,61126,5
AR,1995,3,1228415,1170236,58179,4.7
AR,1995,4,1224404,1167016,57388,4.7
AR,1995,5,1223719,1166897,56822,4.6
AR,1995,6,1226128,1168888,57240,4.7
AR,1995,7,1227230,1168974,58256,4.7
AR,1995,8,1229910,1170157,59753,4.9
AR,1995,9,1231544,1171790,59754,4.9
AR,1995,10,1233804,1173770,60034,4.9
AR,1995,11,1237054,1176741,60313,4.9
AR,1995,12,1239534,1179401,60133,4.9
AR,1996,1,1240864,1179511,61353,4.9
AR,1996,2,1240855,1178551,62304,5
AR,1996,3,1238602,1176276,62326,5
AR,1996,4,1240237,1177521,62716,5.1
AR,1996,5,1242005,1178182,63823,5.1
AR,1996,6,1243371,1178911,64460,5.2
AR,1996,7,1244076,1178549,65527,5.3
AR,1996,8,1245214,1180193,65021,5.2
AR,1996,9,1245504,1179935,65569,5.3
AR,1996,10,1244791,1179693,65098,5.2
AR,1996,11,1245344,1180802,64542,5.2
AR,1996,12,1243730,1180113,63617,5.1
AR,1997,1,1240739,1177434,63305,5.1
AR,1997,2,1241020,1179094,61926,5
AR,1997,3,1243423,1181187,62236,5
AR,1997,4,1242912,1181118,61794,5
AR,1997,5,1242509,1180193,62316,5
AR,1997,6,1240794,1176960,63834,5.1
AR,1997,7,1241232,1176339,64893,5.2
AR,1997,8,1241052,1176593,64459,5.2
AR,1997,9,1239509,1175146,64363,5.2
AR,1997,10,1236478,1172883,63595,5.1
AR,1997,11,1237502,1174258,63244,5.1
AR,1997,12,1237674,1174507,63167,5.1
AR,1998,1,1237526,1174299,63227,5.1
AR,1998,2,1235646,1172966,62680,5.1
AR,1998,3,1237587,1173811,63776,5.2
AR,1998,4,1240232,1177435,62797,5.1
AR,1998,5,1239620,1176794,62826,5.1
AR,1998,6,1240044,1178289,61755,5
AR,1998,7,1241572,1179823,61749,5
AR,1998,8,1243574,1180944,62630,5
AR,1998,9,1243859,1180576,63283,5.1
AR,1998,10,1246176,1183136,63040,5.1
AR,1998,11,1246785,1185770,61015,4.9
AR,1998,12,1247851,1188214,59637,4.8
AR,1999,1,1247821,1190084,57737,4.6
AR,1999,2,1248113,1192666,55447,4.4
AR,1999,3,1247714,1192830,54884,4.4
AR,1999,4,1249653,1194100,55553,4.4
AR,1999,5,1252125,1196079,56046,4.5
AR,1999,6,1254301,1197523,56778,4.5
AR,1999,7,1254484,1197907,56577,4.5
AR,1999,8,1254706,1197862,56844,4.5
AR,1999,9,1257455,1201599,55856,4.4
AR,1999,10,1258644,1203272,55372,4.4
AR,1999,11,1259858,1205792,54066,4.3
AR,1999,12,1259997,1206477,53520,4.2
AR,2000,1,1265889,1212044,53845,4.3
AR,2000,2,1264666,1210584,54082,4.3
AR,2000,3,1266348,1212558,53790,4.2
AR,2000,4,1264762,1211645,53117,4.2
AR,2000,5,1263987,1211255,52732,4.2
AR,2000,6,1264159,1212381,51778,4.1
AR,2000,7,1261562,1209530,52032,4.1
AR,2000,8,1259130,1206518,52612,4.2
AR,2000,9,1255184,1203125,52059,4.1
AR,2000,10,1254901,1202600,52301,4.2
AR,2000,11,1253297,1199724,53573,4.3
AR,2000,12,1249181,1196256,52925,4.2
AR,2001,1,1248541,1194836,53705,4.3
AR,2001,2,1250974,1195941,55033,4.4
AR,2001,3,1250250,1195035,55215,4.4
AR,2001,4,1249013,1192571,56442,4.5
AR,2001,5,1248568,1190995,57573,4.6
AR,2001,6,1251529,1192673,58856,4.7
AR,2001,7,1255160,1195748,59412,4.7
AR,2001,8,1253035,1193474,59561,4.8
AR,2001,9,1254563,1194236,60327,4.8
AR,2001,10,1255462,1194788,60674,4.8
AR,2001,11,1256915,1194200,62715,5
AR,2001,12,1258144,1193788,64356,5.1
AR,2002,1,1262031,1196210,65821,5.2
AR,2002,2,1266224,1199764,66460,5.2
AR,2002,3,1270610,1202950,67660,5.3
AR,2002,4,1272758,1204529,68229,5.4
AR,2002,5,1274401,1206266,68135,5.3
AR,2002,6,1272786,1204677,68109,5.4
AR,2002,7,1271929,1203924,68005,5.3
AR,2002,8,1275052,1207338,67714,5.3
AR,2002,9,1276917,1209084,67833,5.3
AR,2002,10,1274674,1206440,68234,5.4
AR,2002,11,1275526,1206633,68893,5.4
AR,2002,12,1275377,1205789,69588,5.5
AR,2003,1,1271359,1201513,69846,5.5
AR,2003,2,1269231,1198790,70441,5.5
AR,2003,3,1266236,1194555,71681,5.7
AR,2003,4,1265842,1192806,73036,5.8
AR,2003,5,1265374,1191228,74146,5.9
AR,2003,6,1265922,1191077,74845,5.9
AR,2003,7,1267493,1192300,75193,5.9
AR,2003,8,1269452,1194206,75246,5.9
AR,2003,9,1270935,1194933,76002,6
AR,2003,10,1271447,1195463,75984,6
AR,2003,11,1274383,1198730,75653,5.9
AR,2003,12,1280426,1205697,74729,5.8
AR,2004,1,1279794,1205718,74076,5.8
AR,2004,2,1280658,1206073,74585,5.8
AR,2004,3,1284338,1209825,74513,5.8
AR,2004,4,1288989,1214770,74219,5.8
AR,2004,5,1289795,1215392,74403,5.8
AR,2004,6,1289174,1215215,73959,5.7
AR,2004,7,1293679,1220760,72919,5.6
AR,2004,8,1298619,1226611,72008,5.5
AR,2004,9,1300772,1229344,71428,5.5
AR,2004,10,1304250,1233350,70900,5.4
AR,2004,11,1307535,1237603,69932,5.3
AR,2004,12,1313689,1243979,69710,5.3
AR,2005,1,1314900,1246143,68757,5.2
AR,2005,2,1318875,1251110,67765,5.1
AR,2005,3,1322944,1256239,66705,5
AR,2005,4,1327882,1261478,66404,5
AR,2005,5,1332029,1265220,66809,5
AR,2005,6,1335290,1268177,67113,5
AR,2005,7,1340301,1272678,67623,5
AR,2005,8,1340572,1272240,68332,5.1
AR,2005,9,1345332,1275762,69570,5.2
AR,2005,10,1348014,1278524,69490,5.2
AR,2005,11,1350633,1282165,68468,5.1
AR,2005,12,1349816,1282118,67698,5
AR,2006,1,1353387,1286193,67194,5
AR,2006,2,1353035,1284691,68344,5.1
AR,2006,3,1355316,1285978,69338,5.1
AR,2006,4,1354328,1284117,70211,5.2
AR,2006,5,1352934,1282366,70568,5.2
AR,2006,6,1354026,1283258,70768,5.2
AR,2006,7,1351988,1281256,70732,5.2
AR,2006,8,1353057,1281941,71116,5.3
AR,2006,9,1353032,1282196,70836,5.2
AR,2006,10,1354726,1284365,70361,5.2
AR,2006,11,1356786,1286018,70768,5.2
AR,2006,12,1357250,1287745,69505,5.1
AR,2007,1,1358120,1288804,69316,5.1
AR,2007,2,1360722,1291579,69143,5.1
AR,2007,3,1362171,1293388,68783,5
AR,2007,4,1360967,1291751,69216,5.1
AR,2007,5,1360025,1290435,69590,5.1
AR,2007,6,1359365,1289707,69658,5.1
AR,2007,7,1358960,1288387,70573,5.2
AR,2007,8,1361060,1290930,70130,5.2
AR,2007,9,1363432,1293537,69895,5.1
AR,2007,10,1361639,1292610,69029,5.1
AR,2007,11,1362656,1294684,67972,5
AR,2007,12,1364987,1297958,67029,4.9
AR,2008,1,1364984,1298872,66112,4.8
AR,2008,2,1365006,1299680,65326,4.8
AR,2008,3,1366462,1301032,65430,4.8
AR,2008,4,1367748,1301275,66473,4.9
AR,2008,5,1370462,1302783,67679,4.9
AR,2008,6,1369018,1301206,67812,5
AR,2008,7,1370777,1302765,68012,5
AR,2008,8,1371283,1301201,70082,5.1
AR,2008,9,1373048,1301141,71907,5.2
AR,2008,10,1375942,1301891,74051,5.4
AR,2008,11,1374877,1298816,76061,5.5
AR,2008,12,1373504,1295842,77662,5.7
AR,2009,1,1370033,1282080,87953,6.4
CA,1976,1,9732299,8824067,908232,9.3
CA,1976,2,9738316,8850391,887925,9.1
CA,1976,3,9753171,8873357,879814,9
CA,1976,4,9773169,8896378,876791,9
CA,1976,5,9804327,8936215,868112,8.9
CA,1976,6,9861052,8970897,890155,9
CA,1976,7,9912406,9004984,907422,9.2
CA,1976,8,9933025,9014792,918233,9.2
CA,1976,9,9980212,9046376,933836,9.4
CA,1976,10,10007120,9062039,945081,9.4
CA,1976,11,10059918,9109410,950508,9.4
CA,1976,12,10102470,9168355,934115,9.2
CA,1977,1,10137731,9224359,913372,9
CA,1977,2,10171977,9280083,891894,8.8
CA,1977,3,10207167,9323356,883811,8.7
CA,1977,4,10268796,9379237,889559,8.7
CA,1977,5,10323478,9439171,884307,8.6
CA,1977,6,10356894,9480611,876283,8.5
CA,1977,7,10401207,9540120,861087,8.3
CA,1977,8,10469758,9616796,852962,8.1
CA,1977,9,10491713,9640979,850734,8.1
CA,1977,10,10531728,9693128,838600,8
CA,1977,11,10596271,9764087,832184,7.9
CA,1977,12,10643671,9833652,810019,7.6
CA,1978,1,10665958,9865967,799991,7.5
CA,1978,2,10717243,9910561,806682,7.5
CA,1978,3,10805751,9993405,812346,7.5
CA,1978,4,10876527,10065917,810610,7.5
CA,1978,5,10919811,10107219,812592,7.4
CA,1978,6,10934385,10133185,801200,7.3
CA,1978,7,10932987,10135656,797331,7.3
CA,1978,8,10962573,10187923,774650,7.1
CA,1978,9,11015076,10253541,761535,6.9
CA,1978,10,11018011,10278160,739851,6.7
CA,1978,11,11034120,10307227,726893,6.6
CA,1978,12,11084618,10354321,730297,6.6
CA,1979,1,11131139,10410055,721084,6.5
CA,1979,2,11149099,10437538,711561,6.4
CA,1979,3,11148833,10445301,703532,6.3
CA,1979,4,11155268,10454969,700299,6.3
CA,1979,5,11198560,10504904,693656,6.2
CA,1979,6,11241508,10551854,689654,6.1
CA,1979,7,11301668,10610511,691157,6.1
CA,1979,8,11340404,10630276,710128,6.3
CA,1979,9,11368263,10651524,716739,6.3
CA,1979,10,11400342,10687198,713144,6.3
CA,1979,11,11436870,10734748,702122,6.1
CA,1979,12,11475134,10762853,712281,6.2
CA,1980,1,11450043,10745357,704686,6.2
CA,1980,2,11471026,10755527,715499,6.2
CA,1980,3,11520556,10789667,730889,6.3
CA,1980,4,11538513,10767369,771144,6.7
CA,1980,5,11557652,10744898,812754,7
CA,1980,6,11566063,10733503,832560,7.2
CA,1980,7,11597813,10771589,826224,7.1
CA,1980,8,11665064,10811086,853978,7.3
CA,1980,9,11650096,10806238,843858,7.2
CA,1980,10,11661220,10825500,835720,7.2
CA,1980,11,11682058,10858288,823770,7.1
CA,1980,12,11693412,10888194,805218,6.9
CA,1981,1,11727839,10902720,825119,7
CA,1981,2,11732222,10884711,847511,7.2
CA,1981,3,11753805,10916134,837671,7.1
CA,1981,4,11795957,10961376,834581,7.1
CA,1981,5,11794406,10969566,824840,7
CA,1981,6,11780171,10951049,829122,7
CA,1981,7,11823641,10969071,854570,7.2
CA,1981,8,11860382,10986667,873715,7.4
CA,1981,9,11861204,10956411,904793,7.6
CA,1981,10,11896825,10957273,939552,7.9
CA,1981,11,11935340,10965495,969845,8.1
CA,1981,12,11970351,10952161,1018190,8.5
CA,1982,1,12000523,10947515,1053008,8.8
CA,1982,2,12039373,10950207,1089166,9
CA,1982,3,12061965,10940186,1121779,9.3
CA,1982,4,12121523,10943107,1178416,9.7
CA,1982,5,12147763,10960158,1187605,9.8
CA,1982,6,12145945,10947433,1198512,9.9
CA,1982,7,12173466,10925891,1247575,10.2
CA,1982,8,12190087,10919678,1270409,10.4
CA,1982,9,12218623,10934577,1284046,10.5
CA,1982,10,12224170,10910763,1313407,10.7
CA,1982,11,12236678,10891284,1345394,11
CA,1982,12,12243878,10902342,1341536,11
CA,1983,1,12250749,10916295,1334454,10.9
CA,1983,2,12256970,10906277,1350693,11
CA,1983,3,12251424,10925803,1325621,10.8
CA,1983,4,12250394,10962510,1287884,10.5
CA,1983,5,12278254,11005240,1273014,10.4
CA,1983,6,12282624,11055967,1226657,10
CA,1983,7,12281180,11090339,1190841,9.7
CA,1983,8,12286916,11121802,1165114,9.5
CA,1983,9,12305988,11187152,1118836,9.1
CA,1983,10,12316875,11224769,1092106,8.9
CA,1983,11,12361783,11283888,1077895,8.7
CA,1983,12,12386534,11324345,1062189,8.6
CA,1984,1,12400272,11367898,1032374,8.3
CA,1984,2,12418792,11405981,1012811,8.2
CA,1984,3,12462402,11457879,1004523,8.1
CA,1984,4,12510295,11520630,989665,7.9
CA,1984,5,12561767,11580199,981568,7.8
CA,1984,6,12637080,11655905,981175,7.8
CA,1984,7,12668435,11685659,982776,7.8
CA,1984,8,12719539,11744110,975429,7.7
CA,1984,9,12740961,11765642,975319,7.7
CA,1984,10,12771331,11810806,960525,7.5
CA,1984,11,12802330,11843639,958691,7.5
CA,1984,12,12824988,11882978,942010,7.3
CA,1985,1,12870188,11929877,940311,7.3
CA,1985,2,12888066,11961971,926095,7.2
CA,1985,3,12899124,11968686,930438,7.2
CA,1985,4,12922823,11978918,943905,7.3
CA,1985,5,12922312,11982848,939464,7.3
CA,1985,6,12946424,11997222,949202,7.3
CA,1985,7,12976983,12027733,949250,7.3
CA,1985,8,12983271,12039357,943914,7.3
CA,1985,9,13011367,12071943,939424,7.2
CA,1985,10,13049951,12115170,934781,7.2
CA,1985,11,13030476,12125843,904633,6.9
CA,1985,12,13071701,12166398,905303,6.9
CA,1986,1,13100775,12219048,881727,6.7
CA,1986,2,13158669,12249227,909442,6.9
CA,1986,3,13203868,12292157,911711,6.9
CA,1986,4,13232998,12325093,907905,6.9
CA,1986,5,13279695,12369117,910578,6.9
CA,1986,6,13332062,12429942,902120,6.8
CA,1986,7,13363974,12450358,913616,6.8
CA,1986,8,13398132,12489441,908691,6.8
CA,1986,9,13443706,12541930,901776,6.7
CA,1986,10,13484062,12591365,892697,6.6
CA,1986,11,13509413,12621726,887687,6.6
CA,1986,12,13506974,12631100,875874,6.5
CA,1987,1,13540141,12679627,860514,6.4
CA,1987,2,13591765,12743883,847882,6.2
CA,1987,3,13642977,12797739,845238,6.2
CA,1987,4,13669032,12843209,825823,6
CA,1987,5,13708296,12899850,808446,5.9
CA,1987,6,13725888,12937437,788451,5.7
CA,1987,7,13759972,12976452,783520,5.7
CA,1987,8,13782407,13004143,778264,5.6
CA,1987,9,13823959,13037535,786424,5.7
CA,1987,10,13851766,13076432,775334,5.6
CA,1987,11,13896954,13143456,753498,5.4
CA,1987,12,13935364,13180688,754676,5.4
CA,1988,1,13977259,13229837,747422,5.3
CA,1988,2,14005222,13266219,739003,5.3
CA,1988,3,14038597,13302747,735850,5.2
CA,1988,4,14070630,13333331,737299,5.2
CA,1988,5,14102369,13337990,764379,5.4
CA,1988,6,14125456,13365832,759624,5.4
CA,1988,7,14149442,13392272,757170,5.4
CA,1988,8,14179502,13415782,763720,5.4
CA,1988,9,14201583,13445887,755696,5.3
CA,1988,10,14226141,13483324,742817,5.2
CA,1988,11,14258410,13526935,731475,5.1
CA,1988,12,14284434,13559621,724813,5.1
CA,1989,1,14300984,13575289,725695,5.1
CA,1989,2,14311338,13585510,725828,5.1
CA,1989,3,14342773,13613280,729493,5.1
CA,1989,4,14362921,13622616,740305,5.2
CA,1989,5,14419165,13668481,750684,5.2
CA,1989,6,14463901,13705305,758596,5.2
CA,1989,7,14516146,13759288,756858,5.2
CA,1989,8,14536520,13789260,747260,5.1
CA,1989,9,14633418,13879709,753709,5.2
CA,1989,10,14714845,13965057,749788,5.1
CA,1989,11,14784797,14022055,762742,5.2
CA,1989,12,14821589,14060844,760745,5.1
CA,1990,1,14966403,14199447,766956,5.1
CA,1990,2,15042106,14261385,780721,5.2
CA,1990,3,15117203,14314792,802411,5.3
CA,1990,4,15167988,14346559,821429,5.4
CA,1990,5,15231319,14396201,835118,5.5
CA,1990,6,15248045,14417463,830582,5.4
CA,1990,7,15249915,14394525,855390,5.6
CA,1990,8,15245277,14360875,884402,5.8
CA,1990,9,15192110,14275926,916184,6
CA,1990,10,15194275,14239607,954668,6.3
CA,1990,11,15199630,14189131,1010499,6.6
CA,1990,12,15168099,14133466,1034633,6.8
CA,1991,1,15135750,14063141,1072609,7.1
CA,1991,2,15131394,14024114,1107280,7.3
CA,1991,3,15111313,13957104,1154209,7.6
CA,1991,4,15105162,13935018,1170144,7.7
CA,1991,5,15065221,13891845,1173376,7.8
CA,1991,6,15054454,13884160,1170294,7.8
CA,1991,7,15063148,13886524,1176624,7.8
CA,1991,8,15087111,13908795,1178316,7.8
CA,1991,9,15090795,13900517,1190278,7.9
CA,1991,10,15114257,13913024,1201233,7.9
CA,1991,11,15137654,13911191,1226463,8.1
CA,1991,12,15168370,13904714,1263656,8.3
CA,1992,1,15188731,13892989,1295742,8.5
CA,1992,2,15244023,13878816,1365207,9
CA,1992,3,15257698,13897194,1360504,8.9
CA,1992,4,15278779,13913193,1365586,8.9
CA,1992,5,15296836,13893118,1403718,9.2
CA,1992,6,15341206,13896741,1444465,9.4
CA,1992,7,15365252,13901147,1464105,9.5
CA,1992,8,15377012,13891421,1485591,9.7
CA,1992,9,15356738,13852173,1504565,9.8
CA,1992,10,15343626,13831808,1511818,9.9
CA,1992,11,15334993,13825392,1509601,9.8
CA,1992,12,15333256,13816963,1516293,9.9
CA,1993,1,15316786,13802287,1514499,9.9
CA,1993,2,15293229,13793294,1499935,9.8
CA,1993,3,15278461,13792403,1486058,9.7
CA,1993,4,15280584,13817737,1462847,9.6
CA,1993,5,15269420,13805661,1463759,9.6
CA,1993,6,15257561,13794160,1463401,9.6
CA,1993,7,15269907,13821525,1448382,9.5
CA,1993,8,15257061,13821761,1435300,9.4
CA,1993,9,15241114,13806884,1434230,9.4
CA,1993,10,15229664,13794369,1435295,9.4
CA,1993,11,15225087,13807299,1417788,9.3
CA,1993,12,15255562,13842287,1413275,9.3
CA,1994,1,15283706,13865280,1418426,9.3
CA,1994,2,15307982,13894987,1412995,9.2
CA,1994,3,15301240,13917451,1383789,9
CA,1994,4,15284683,13921355,1363328,8.9
CA,1994,5,15310416,13950467,1359949,8.9
CA,1994,6,15277117,13938616,1338501,8.8
CA,1994,7,15269875,13949279,1320596,8.6
CA,1994,8,15262190,13961343,1300847,8.5
CA,1994,9,15251098,13989165,1261933,8.3
CA,1994,10,15255934,14020282,1235652,8.1
CA,1994,11,15230089,14019770,1210319,7.9
CA,1994,12,15218161,14018269,1199892,7.9
CA,1995,1,15223584,13991003,1232581,8.1
CA,1995,2,15220098,14025896,1194202,7.8
CA,1995,3,15208895,14016086,1192809,7.8
CA,1995,4,15218909,14027939,1190970,7.8
CA,1995,5,15221439,14020077,1201362,7.9
CA,1995,6,15254740,14058136,1196604,7.8
CA,1995,7,15259698,14057372,1202326,7.9
CA,1995,8,15280449,14080108,1200341,7.9
CA,1995,9,15310673,14117251,1193422,7.8
CA,1995,10,15316675,14117172,1199503,7.8
CA,1995,11,15318799,14103082,1215717,7.9
CA,1995,12,15329014,14134203,1194811,7.8
CA,1996,1,15344892,14150345,1194547,7.8
CA,1996,2,15361290,14171336,1189954,7.7
CA,1996,3,15364508,14181654,1182854,7.7
CA,1996,4,15338987,14177072,1161915,7.6
CA,1996,5,15368789,14228353,1140436,7.4
CA,1996,6,15392045,14260707,1131338,7.4
CA,1996,7,15408024,14287125,1120899,7.3
CA,1996,8,15453371,14348333,1105038,7.2
CA,1996,9,15507192,14408337,1098855,7.1
CA,1996,10,15542765,14448994,1093771,7
CA,1996,11,15573107,14482735,1090372,7
CA,1996,12,15575773,14497091,1078682,6.9
CA,1997,1,15615814,14533517,1082297,6.9
CA,1997,2,15644141,14589302,1054839,6.7
CA,1997,3,15681797,14645197,1036600,6.6
CA,1997,4,15729391,14704851,1024540,6.5
CA,1997,5,15739601,14735924,1003677,6.4
CA,1997,6,15765897,14760895,1005002,6.4
CA,1997,7,15798342,14803441,994901,6.3
CA,1997,8,15847437,14853834,993603,6.3
CA,1997,9,15871956,14878697,993259,6.3
CA,1997,10,15897117,14909247,987870,6.2
CA,1997,11,15921163,14944352,976811,6.1
CA,1997,12,15997782,15010240,987542,6.2
CA,1998,1,16024896,15045031,979865,6.1
CA,1998,2,16051144,15074180,976964,6.1
CA,1998,3,16078835,15106676,972159,6
CA,1998,4,16094570,15125534,969036,6
CA,1998,5,16122843,15159799,963044,6
CA,1998,6,16144376,15188152,956224,5.9
CA,1998,7,16192516,15239196,953320,5.9
CA,1998,8,16211407,15249857,961550,5.9
CA,1998,9,16261056,15293092,967964,6
CA,1998,10,16251042,15295580,955462,5.9
CA,1998,11,16281467,15332327,949140,5.8
CA,1998,12,16288794,15334894,953900,5.9
CA,1999,1,16279950,15347265,932685,5.7
CA,1999,2,16299401,15379777,919624,5.6
CA,1999,3,16333481,15426556,906925,5.6
CA,1999,4,16354285,15465595,888690,5.4
CA,1999,5,16360719,15507001,853718,5.2
CA,1999,6,16395887,15543311,852576,5.2
CA,1999,7,16447454,15604282,843172,5.1
CA,1999,8,16466811,15633333,833478,5.1
CA,1999,9,16503069,15673916,829153,5
CA,1999,10,16537730,15711110,826620,5
CA,1999,11,16557600,15728191,829409,5
CA,1999,12,16630580,15782468,848112,5.1
CA,2000,1,16657832,15820260,837572,5
CA,2000,2,16687343,15850703,836640,5
CA,2000,3,16713466,15867416,846050,5.1
CA,2000,4,16766338,15925516,840822,5
CA,2000,5,16816478,15963728,852750,5.1
CA,2000,6,16863412,16014376,849036,5
CA,2000,7,16867908,16026527,841381,5
CA,2000,8,16926413,16090114,836299,4.9
CA,2000,9,16958337,16137573,820764,4.8
CA,2000,10,16973782,16159434,814348,4.8
CA,2000,11,17006495,16193841,812654,4.8
CA,2000,12,17053133,16242603,810530,4.8
CA,2001,1,17062158,16255726,806432,4.7
CA,2001,2,17068945,16261779,807166,4.7
CA,2001,3,17108181,16277934,830247,4.9
CA,2001,4,17120753,16266678,854075,5
CA,2001,5,17123308,16246446,876862,5.1
CA,2001,6,17139906,16231552,908354,5.3
CA,2001,7,17138757,16210283,928474,5.4
CA,2001,8,17165106,16199791,965315,5.6
CA,2001,9,17180876,16189735,991141,5.8
CA,2001,10,17217616,16177982,1039634,6
CA,2001,11,17249726,16169549,1080177,6.3
CA,2001,12,17249940,16152946,1096994,6.4
CA,2002,1,17284520,16162020,1122500,6.5
CA,2002,2,17325568,16187645,1137923,6.6
CA,2002,3,17334797,16174604,1160193,6.7
CA,2002,4,17336071,16169203,1166868,6.7
CA,2002,5,17327523,16168936,1158587,6.7
CA,2002,6,17339876,16165429,1174447,6.8
CA,2002,7,17342717,16175268,1167449,6.7
CA,2002,8,17321630,16160641,1160989,6.7
CA,2002,9,17347198,16181280,1165918,6.7
CA,2002,10,17373671,16202399,1171272,6.7
CA,2002,11,17398847,16218353,1180494,6.8
CA,2002,12,17390537,16203813,1186724,6.8
CA,2003,1,17376182,16182864,1193318,6.9
CA,2003,2,17381180,16188587,1192593,6.9
CA,2003,3,17385452,16196545,1188907,6.8
CA,2003,4,17384498,16181228,1203270,6.9
CA,2003,5,17373958,16176687,1197271,6.9
CA,2003,6,17395878,16195023,1200855,6.9
CA,2003,7,17388831,16186468,1202363,6.9
CA,2003,8,17371438,16180794,1190644,6.9
CA,2003,9,17385065,16202532,1182533,6.8
CA,2003,10,17425112,16229550,1195562,6.9
CA,2003,11,17403266,16226981,1176285,6.8
CA,2003,12,17417148,16253503,1163645,6.7
CA,2004,1,17380393,16239209,1141184,6.6
CA,2004,2,17386375,16257628,1128747,6.5
CA,2004,3,17393010,16261927,1131083,6.5
CA,2004,4,17400174,16285394,1114780,6.4
CA,2004,5,17417743,16308705,1109038,6.4
CA,2004,6,17439977,16334888,1105089,6.3
CA,2004,7,17456772,16370602,1086170,6.2
CA,2004,8,17445942,16382143,1063799,6.1
CA,2004,9,17471309,16407143,1064166,6.1
CA,2004,10,17506180,16452865,1053315,6
CA,2004,11,17522265,16476758,1045507,6
CA,2004,12,17513087,16480085,1033002,5.9
CA,2005,1,17532360,16499942,1032418,5.9
CA,2005,2,17543088,16545300,997788,5.7
CA,2005,3,17542869,16564804,978065,5.6
CA,2005,4,17580867,16610248,970619,5.5
CA,2005,5,17598533,16629567,968966,5.5
CA,2005,6,17620362,16653762,966600,5.5
CA,2005,7,17630985,16686223,944762,5.4
CA,2005,8,17672279,16730618,941661,5.3
CA,2005,9,17677194,16745416,931778,5.3
CA,2005,10,17697861,16765940,931921,5.3
CA,2005,11,17707594,16793144,914450,5.2
CA,2005,12,17745918,16838007,907911,5.1
CA,2006,1,17735944,16835828,900116,5.1
CA,2006,2,17726207,16851312,874895,4.9
CA,2006,3,17759888,16887919,871969,4.9
CA,2006,4,17786378,16896266,890112,5
CA,2006,5,17809544,16932622,876922,4.9
CA,2006,6,17815874,16947507,868367,4.9
CA,2006,7,17825461,16965323,860138,4.8
CA,2006,8,17819177,16951365,867812,4.9
CA,2006,9,17865929,16999660,866269,4.8
CA,2006,10,17882923,17025405,857518,4.8
CA,2006,11,17896878,17038634,858244,4.8
CA,2006,12,17929068,17048645,880423,4.9
CA,2007,1,17962668,17073192,889476,5
CA,2007,2,17974498,17079047,895451,5
CA,2007,3,17994351,17099473,894878,5
CA,2007,4,18027063,17093130,933933,5.2
CA,2007,5,18045868,17102497,943371,5.2
CA,2007,6,18068995,17113856,955139,5.3
CA,2007,7,18100824,17136393,964431,5.3
CA,2007,8,18123547,17133596,989951,5.5
CA,2007,9,18123158,17108785,1014373,5.6
CA,2007,10,18131808,17103845,1027963,5.7
CA,2007,11,18172172,17128595,1043577,5.7
CA,2007,12,18210599,17132009,1078590,5.9
CA,2008,1,18213928,17104911,1109017,6.1
CA,2008,2,18241516,17115872,1125644,6.2
CA,2008,3,18269099,17102130,1166969,6.4
CA,2008,4,18322527,17108647,1213880,6.6
CA,2008,5,18350638,17097388,1253250,6.8
CA,2008,6,18381232,17084769,1296463,7.1
CA,2008,7,18405284,17058341,1346943,7.3
CA,2008,8,18435230,17038104,1397126,7.6
CA,2008,9,18481404,17033050,1448354,7.8
CA,2008,10,18507296,17021907,1485389,8
CA,2008,11,18536742,16998297,1538445,8.3
CA,2008,12,18557231,16951474,1605757,8.7
CA,2009,1,18531078,16667877,1863201,10.1
CO,1976,1,1237739,1164402,73337,5.9
CO,1976,2,1230983,1164643,66340,5.4
CO,1976,3,1242747,1164529,78218,6.3
CO,1976,4,1236135,1167540,68595,5.5
CO,1976,5,1231426,1166900,64526,5.2
CO,1976,6,1236255,1166049,70206,5.7
CO,1976,7,1246996,1168392,78604,6.3
CO,1976,8,1247168,1171316,75852,6.1
CO,1976,9,1256012,1175097,80915,6.4
CO,1976,10,1254113,1179127,74986,6
CO,1976,11,1264681,1183149,81532,6.4
CO,1976,12,1271940,1188217,83723,6.6
CO,1977,1,1265159,1193317,71842,5.7
CO,1977,2,1289933,1198293,91640,7.1
CO,1977,3,1297377,1201781,95596,7.4
CO,1977,4,1300499,1205693,94806,7.3
CO,1977,5,1293668,1212984,80684,6.2
CO,1977,6,1300595,1217760,82835,6.4
CO,1977,7,1305381,1223470,81911,6.3
CO,1977,8,1311436,1227072,84364,6.4
CO,1977,9,1314720,1231805,82915,6.3
CO,1977,10,1321000,1235850,85150,6.4
CO,1977,11,1323756,1241142,82614,6.2
CO,1977,12,1327309,1245187,82122,6.2
CO,1978,1,1335489,1249318,86171,6.5
CO,1978,2,1322181,1254828,67353,5.1
CO,1978,3,1342042,1261429,80613,6
CO,1978,4,1345035,1268362,76673,5.7
CO,1978,5,1345818,1273512,72306,5.4
CO,1978,6,1357675,1282619,75056,5.5
CO,1978,7,1361489,1288590,72899,5.4
CO,1978,8,1365780,1295013,70767,5.2
CO,1978,9,1372904,1300375,72529,5.3
CO,1978,10,1378185,1310589,67596,4.9
CO,1978,11,1386597,1317535,69062,5
CO,1978,12,1394486,1323553,70933,5.1
CO,1979,1,1394004,1330517,63487,4.6
CO,1979,2,1403253,1339426,63827,4.5
CO,1979,3,1408876,1347028,61848,4.4
CO,1979,4,1415647,1354827,60820,4.3
CO,1979,5,1433693,1363524,70169,4.9
CO,1979,6,1432370,1371570,60800,4.2
CO,1979,7,1442786,1377216,65570,4.5
CO,1979,8,1451530,1382664,68866,4.7
CO,1979,9,1455833,1387998,67835,4.7
CO,1979,10,1461377,1391961,69416,4.8
CO,1979,11,1463511,1394073,69438,4.7
CO,1979,12,1467713,1396408,71305,4.9
CO,1980,1,1466075,1399998,66077,4.5
CO,1980,2,1471262,1403573,67689,4.6
CO,1980,3,1474405,1406373,68032,4.6
CO,1980,4,1489294,1407576,81718,5.5
CO,1980,5,1502451,1408481,93970,6.3
CO,1980,6,1507573,1409714,97859,6.5
CO,1980,7,1514107,1411696,102411,6.8
CO,1980,8,1515313,1414165,101148,6.7
CO,1980,9,1518010,1417498,100512,6.6
CO,1980,10,1519162,1422846,96316,6.3
CO,1980,11,1518122,1426549,91573,6
CO,1980,12,1521857,1431599,90258,5.9
CO,1981,1,1526385,1436704,89681,5.9
CO,1981,2,1533788,1441278,92510,6
CO,1981,3,1536705,1447852,88853,5.8
CO,1981,4,1536002,1450993,85009,5.5
CO,1981,5,1538363,1454048,84315,5.5
CO,1981,6,1545553,1459653,85900,5.6
CO,1981,7,1547951,1467871,80080,5.2
CO,1981,8,1550807,1471903,78904,5.1
CO,1981,9,1554458,1473515,80943,5.2
CO,1981,10,1559634,1475821,83813,5.4
CO,1981,11,1562467,1477012,85455,5.5
CO,1981,12,1564573,1476451,88122,5.6
CO,1982,1,1574947,1478089,96858,6.1
CO,1982,2,1584215,1479176,105039,6.6
CO,1982,3,1585624,1481402,104222,6.6
CO,1982,4,1591202,1483068,108134,6.8
CO,1982,5,1599417,1483713,115704,7.2
CO,1982,6,1606747,1483551,123196,7.7
CO,1982,7,1613432,1482533,130899,8.1
CO,1982,8,1620053,1485724,134329,8.3
CO,1982,9,1625398,1486182,139216,8.6
CO,1982,10,1637046,1489013,148033,9
CO,1982,11,1643422,1494187,149235,9.1
CO,1982,12,1647545,1500209,147336,8.9
CO,1983,1,1654469,1507929,146540,8.9
CO,1983,2,1658945,1512763,146182,8.8
CO,1983,3,1662147,1517734,144413,8.7
CO,1983,4,1668321,1524232,144089,8.6
CO,1983,5,1662683,1531234,131449,7.9
CO,1983,6,1660461,1538069,122392,7.4
CO,1983,7,1660822,1546949,113873,6.9
CO,1983,8,1663563,1553985,109578,6.6
CO,1983,9,1667799,1562943,104856,6.3
CO,1983,10,1672910,1570543,102367,6.1
CO,1983,11,1675404,1578153,97251,5.8
CO,1983,12,1686101,1584960,101141,6
CO,1984,1,1691795,1591549,100246,5.9
CO,1984,2,1694482,1599926,94556,5.6
CO,1984,3,1694857,1605519,89338,5.3
CO,1984,4,1703258,1610176,93082,5.5
CO,1984,5,1706668,1615221,91447,5.4
CO,1984,6,1708678,1620675,88003,5.2
CO,1984,7,1709579,1622138,87441,5.1
CO,1984,8,1709381,1622519,86862,5.1
CO,1984,9,1709297,1621412,87885,5.1
CO,1984,10,1711357,1620823,90534,5.3
CO,1984,11,1716095,1622862,93233,5.4
CO,1984,12,1714084,1621310,92774,5.4
CO,1985,1,1716851,1617985,98866,5.8
CO,1985,2,1725259,1616276,108983,6.3
CO,1985,3,1720648,1615306,105342,6.1
CO,1985,4,1715501,1615751,99750,5.8
CO,1985,5,1714962,1615193,99769,5.8
CO,1985,6,1713014,1612393,100621,5.9
CO,1985,7,1709559,1609242,100317,5.9
CO,1985,8,1713160,1608196,104964,6.1
CO,1985,9,1709787,1608119,101668,5.9
CO,1985,10,1707669,1605076,102593,6
CO,1985,11,1711042,1603356,107686,6.3
CO,1985,12,1710599,1602701,107898,6.3
CO,1986,1,1723426,1602153,121273,7
CO,1986,2,1725741,1600458,125283,7.3
CO,1986,3,1723426,1599402,124024,7.2
CO,1986,4,1724566,1597738,126828,7.4
CO,1986,5,1721314,1595251,126063,7.3
CO,1986,6,1716856,1593606,123250,7.2
CO,1986,7,1717366,1591235,126131,7.3
CO,1986,8,1715952,1589046,126906,7.4
CO,1986,9,1722846,1587339,135507,7.9
CO,1986,10,1724177,1586561,137616,8
CO,1986,11,1724305,1584353,139952,8.1
CO,1986,12,1726653,1583881,142772,8.3
CO,1987,1,1730240,1584642,145598,8.4
CO,1987,2,1728581,1582696,145885,8.4
CO,1987,3,1728211,1582127,146084,8.5
CO,1987,4,1721298,1582281,139017,8.1
CO,1987,5,1714953,1582652,132301,7.7
CO,1987,6,1708244,1582225,126019,7.4
CO,1987,7,1702124,1583410,118714,7
CO,1987,8,1703335,1586382,116953,6.9
CO,1987,9,1704034,1587784,116250,6.8
CO,1987,10,1705775,1589688,116087,6.8
CO,1987,11,1705189,1591405,113784,6.7
CO,1987,12,1710046,1593182,116864,6.8
CO,1988,1,1719184,1594091,125093,7.3
CO,1988,2,1721146,1596314,124832,7.3
CO,1988,3,1717702,1596893,120809,7
CO,1988,4,1711562,1597715,113847,6.7
CO,1988,5,1708493,1598473,110020,6.4
CO,1988,6,1705467,1599739,105728,6.2
CO,1988,7,1705950,1602229,103721,6.1
CO,1988,8,1706239,1601818,104421,6.1
CO,1988,9,1706006,1603581,102425,6
CO,1988,10,1703879,1602739,101140,5.9
CO,1988,11,1703005,1603445,99560,5.8
CO,1988,12,1705786,1604904,100882,5.9
CO,1989,1,1708335,1605345,102990,6
CO,1989,2,1713656,1607336,106320,6.2
CO,1989,3,1709517,1610390,99127,5.8
CO,1989,4,1708856,1612012,96844,5.7
CO,1989,5,1710304,1614833,95471,5.6
CO,1989,6,1715063,1619466,95597,5.6
CO,1989,7,1718201,1624649,93552,5.4
CO,1989,8,1723387,1628694,94693,5.5
CO,1989,9,1726986,1633767,93219,5.4
CO,1989,10,1731309,1637983,93326,5.4
CO,1989,11,1736428,1643630,92798,5.3
CO,1989,12,1744379,1648544,95835,5.5
CO,1990,1,1743904,1653727,90177,5.2
CO,1990,2,1749514,1658253,91261,5.2
CO,1990,3,1756457,1663642,92815,5.3
CO,1990,4,1760443,1668284,92159,5.2
CO,1990,5,1767197,1674282,92915,5.3
CO,1990,6,1769034,1677964,91070,5.1
CO,1990,7,1771384,1680372,91012,5.1
CO,1990,8,1776136,1685882,90254,5.1
CO,1990,9,1779343,1689597,89746,5
CO,1990,10,1782329,1692613,89716,5
CO,1990,11,1785612,1696507,89105,5
CO,1990,12,1786098,1697624,88474,5
CO,1991,1,1788982,1697417,91565,5.1
CO,1991,2,1791895,1698536,93359,5.2
CO,1991,3,1791835,1698438,93397,5.2
CO,1991,4,1794433,1699892,94541,5.3
CO,1991,5,1799024,1701282,97742,5.4
CO,1991,6,1801090,1703824,97266,5.4
CO,1991,7,1802101,1703664,98437,5.5
CO,1991,8,1804327,1705768,98559,5.5
CO,1991,9,1808607,1708652,99955,5.5
CO,1991,10,1811299,1710231,101068,5.6
CO,1991,11,1816821,1711797,105024,5.8
CO,1991,12,1821411,1714766,106645,5.9
CO,1992,1,1827148,1718871,108277,5.9
CO,1992,2,1828412,1721340,107072,5.9
CO,1992,3,1838108,1725235,112873,6.1
CO,1992,4,1839602,1729664,109938,6
CO,1992,5,1846584,1734190,112394,6.1
CO,1992,6,1853140,1738851,114289,6.2
CO,1992,7,1859491,1745148,114343,6.1
CO,1992,8,1863139,1750041,113098,6.1
CO,1992,9,1869651,1757390,112261,6
CO,1992,10,1875688,1764072,111616,6
CO,1992,11,1878694,1769649,109045,5.8
CO,1992,12,1890793,1776367,114426,6.1
CO,1993,1,1898916,1785022,113894,6
CO,1993,2,1901510,1792028,109482,5.8
CO,1993,3,1906847,1800610,106237,5.6
CO,1993,4,1913541,1809105,104436,5.5
CO,1993,5,1919102,1815825,103277,5.4
CO,1993,6,1925915,1824731,101184,5.3
CO,1993,7,1934635,1834877,99758,5.2
CO,1993,8,1941268,1843029,98239,5.1
CO,1993,9,1949150,1851383,97767,5
CO,1993,10,1960552,1862412,98140,5
CO,1993,11,1970797,1873426,97371,4.9
CO,1993,12,1982383,1885416,96967,4.9
CO,1994,1,1991567,1895282,96285,4.8
CO,1994,2,2001930,1905637,96293,4.8
CO,1994,3,2010393,1916142,94251,4.7
CO,1994,4,2020028,1927702,92326,4.6
CO,1994,5,2029785,1938220,91565,4.5
CO,1994,6,2036242,1948436,87806,4.3
CO,1994,7,2046606,1959635,86971,4.2
CO,1994,8,2056448,1970738,85710,4.2
CO,1994,9,2062588,1980669,81919,4
CO,1994,10,2069764,1990056,79708,3.9
CO,1994,11,2076910,1998396,78514,3.8
CO,1994,12,2082320,2006422,75898,3.6
CO,1995,1,2089395,2012582,76813,3.7
CO,1995,2,2096010,2019407,76603,3.7
CO,1995,3,2101162,2025687,75475,3.6
CO,1995,4,2113226,2029920,83306,3.9
CO,1995,5,2123093,2034690,88403,4.2
CO,1995,6,2128541,2040017,88524,4.2
CO,1995,7,2134809,2044596,90213,4.2
CO,1995,8,2141345,2050105,91240,4.3
CO,1995,9,2144725,2054948,89777,4.2
CO,1995,10,2147789,2058342,89447,4.2
CO,1995,11,2152025,2063054,88971,4.1
CO,1995,12,2153272,2066470,86802,4
CO,1996,1,2156018,2068340,87678,4.1
CO,1996,2,2160373,2070754,89619,4.1
CO,1996,3,2164958,2073467,91491,4.2
CO,1996,4,2167619,2075425,92194,4.3
CO,1996,5,2177323,2078807,98516,4.5
CO,1996,6,2185429,2080284,105145,4.8
CO,1996,7,2176560,2080362,96198,4.4
CO,1996,8,2180124,2085620,94504,4.3
CO,1996,9,2182477,2089735,92742,4.2
CO,1996,10,2183767,2094133,89634,4.1
CO,1996,11,2186700,2100718,85982,3.9
CO,1996,12,2187102,2107233,79869,3.7
CO,1997,1,2197854,2114095,83759,3.8
CO,1997,2,2196441,2121975,74466,3.4
CO,1997,3,2202044,2129411,72633,3.3
CO,1997,4,2207443,2135059,72384,3.3
CO,1997,5,2215154,2141564,73590,3.3
CO,1997,6,2224632,2150210,74422,3.3
CO,1997,7,2233865,2159155,74710,3.3
CO,1997,8,2241715,2165283,76432,3.4
CO,1997,9,2248838,2172698,76140,3.4
CO,1997,10,2255116,2181149,73967,3.3
CO,1997,11,2264587,2187286,77301,3.4
CO,1997,12,2269885,2193644,76241,3.4
CO,1998,1,2273717,2200162,73555,3.2
CO,1998,2,2279376,2205772,73604,3.2
CO,1998,3,2286437,2210077,76360,3.3
CO,1998,4,2297153,2215309,81844,3.6
CO,1998,5,2304074,2220191,83883,3.6
CO,1998,6,2309873,2224277,85596,3.7
CO,1998,7,2317130,2229623,87507,3.8
CO,1998,8,2321196,2233929,87267,3.8
CO,1998,9,2326002,2237911,88091,3.8
CO,1998,10,2327438,2242614,84824,3.6
CO,1998,11,2326360,2245796,80564,3.5
CO,1998,12,2326123,2249885,76238,3.3
CO,1999,1,2324629,2254546,70083,3
CO,1999,2,2322154,2258001,64153,2.8
CO,1999,3,2325577,2260534,65043,2.8
CO,1999,4,2333087,2263660,69427,3
CO,1999,5,2338208,2266252,71956,3.1
CO,1999,6,2343111,2268509,74602,3.2
CO,1999,7,2348306,2272664,75642,3.2
CO,1999,8,2349850,2273407,76443,3.3
CO,1999,9,2351029,2275857,75172,3.2
CO,1999,10,2352354,2278042,74312,3.2
CO,1999,11,2351559,2281176,70383,3
CO,1999,12,2351392,2283371,68021,2.9
CO,2000,1,2350334,2287582,62752,2.7
CO,2000,2,2350779,2290049,60730,2.6
CO,2000,3,2354132,2294889,59243,2.5
CO,2000,4,2358291,2295911,62380,2.6
CO,2000,5,2361667,2298900,62767,2.7
CO,2000,6,2365777,2300650,65127,2.8
CO,2000,7,2370548,2302145,68403,2.9
CO,2000,8,2373700,2303320,70380,3
CO,2000,9,2374381,2304587,69794,2.9
CO,2000,10,2373320,2305777,67543,2.8
CO,2000,11,2375296,2308268,67028,2.8
CO,2000,12,2371649,2310222,61427,2.6
CO,2001,1,2366713,2308502,58211,2.5
CO,2001,2,2371180,2308332,62848,2.7
CO,2001,3,2373726,2307892,65834,2.8
CO,2001,4,2379567,2306983,72584,3.1
CO,2001,5,2385358,2306054,79304,3.3
CO,2001,6,2390495,2307352,83143,3.5
CO,2001,7,2397032,2305723,91309,3.8
CO,2001,8,2400920,2304342,96578,4
CO,2001,9,2404673,2301850,102823,4.3
CO,2001,10,2415988,2297540,118448,4.9
CO,2001,11,2426909,2295034,131875,5.4
CO,2001,12,2430608,2292323,138285,5.7
CO,2002,1,2443848,2301235,142613,5.8
CO,2002,2,2442251,2301402,140849,5.8
CO,2002,3,2443410,2301737,141673,5.8
CO,2002,4,2441821,2303077,138744,5.7
CO,2002,5,2438516,2305191,133325,5.5
CO,2002,6,2442607,2305338,137269,5.6
CO,2002,7,2438949,2303433,135516,5.6
CO,2002,8,2441548,2305359,136189,5.6
CO,2002,9,2444091,2305022,139069,5.7
CO,2002,10,2444440,2304886,139554,5.7
CO,2002,11,2445475,2305860,139615,5.7
CO,2002,12,2445851,2306769,139082,5.7
CO,2003,1,2469891,2324124,145767,5.9
CO,2003,2,2474511,2325083,149428,6
CO,2003,3,2480484,2325409,155075,6.3
CO,2003,4,2485998,2328166,157832,6.3
CO,2003,5,2490007,2332540,157467,6.3
CO,2003,6,2491846,2335087,156759,6.3
CO,2003,7,2497986,2340161,157825,6.3
CO,2003,8,2499430,2345056,154374,6.2
CO,2003,9,2499883,2348361,151522,6.1
CO,2003,10,2503951,2353586,150365,6
CO,2003,11,2505437,2356274,149163,6
CO,2003,12,2508663,2360541,148122,5.9
CO,2004,1,2513418,2366228,147190,5.9
CO,2004,2,2519703,2370109,149594,5.9
CO,2004,3,2519067,2375177,143890,5.7
CO,2004,4,2523749,2383188,140561,5.6
CO,2004,5,2527728,2387896,139832,5.5
CO,2004,6,2532479,2391958,140521,5.5
CO,2004,7,2536997,2396200,140797,5.5
CO,2004,8,2543254,2400761,142493,5.6
CO,2004,9,2546865,2405626,141239,5.5
CO,2004,10,2551111,2409528,141583,5.5
CO,2004,11,2553365,2411950,141415,5.5
CO,2004,12,2557318,2416805,140513,5.5
CO,2005,1,2553513,2419942,133571,5.2
CO,2005,2,2559373,2424673,134700,5.3
CO,2005,3,2563874,2428336,135538,5.3
CO,2005,4,2570476,2433179,137297,5.3
CO,2005,5,2575012,2438063,136949,5.3
CO,2005,6,2575924,2442720,133204,5.2
CO,2005,7,2581285,2448875,132410,5.1
CO,2005,8,2585337,2453613,131724,5.1
CO,2005,9,2592947,2461606,131341,5.1
CO,2005,10,2596787,2467771,129016,5
CO,2005,11,2602729,2474958,127771,4.9
CO,2005,12,2611763,2484059,127704,4.9
CO,2006,1,2615070,2492062,123008,4.7
CO,2006,2,2613276,2499671,113605,4.3
CO,2006,3,2623941,2507039,116902,4.5
CO,2006,4,2632913,2514019,118894,4.5
CO,2006,5,2640327,2519838,120489,4.6
CO,2006,6,2646990,2527998,118992,4.5
CO,2006,7,2649637,2530786,118851,4.5
CO,2006,8,2655299,2535896,119403,4.5
CO,2006,9,2655793,2541114,114679,4.3
CO,2006,10,2658614,2546554,112060,4.2
CO,2006,11,2660318,2551960,108358,4.1
CO,2006,12,2660747,2556892,103855,3.9
CO,2007,1,2661980,2558940,103040,3.9
CO,2007,2,2666180,2564811,101369,3.8
CO,2007,3,2667380,2570606,96774,3.6
CO,2007,4,2670078,2574311,95767,3.6
CO,2007,5,2677773,2579497,98276,3.7
CO,2007,6,2684856,2584270,100586,3.7
CO,2007,7,2689928,2586964,102964,3.8
CO,2007,8,2694851,2589476,105375,3.9
CO,2007,9,2702010,2591832,110178,4.1
CO,2007,10,2704170,2595019,109151,4
CO,2007,11,2709677,2597329,112348,4.1
CO,2007,12,2708234,2596773,111461,4.1
CO,2008,1,2715634,2597565,118069,4.3
CO,2008,2,2721376,2597844,123532,4.5
CO,2008,3,2722799,2597400,125399,4.6
CO,2008,4,2724986,2597702,127284,4.7
CO,2008,5,2726411,2597640,128771,4.7
CO,2008,6,2726717,2596220,130497,4.8
CO,2008,7,2730874,2597229,133645,4.9
CO,2008,8,2731332,2597219,134113,4.9
CO,2008,9,2732730,2596876,135854,5
CO,2008,10,2739724,2595458,144266,5.3
CO,2008,11,2741519,2593168,148351,5.4
CO,2008,12,2751262,2591387,159875,5.8
CO,2009,1,2737202,2556227,180975,6.6
CT,1976,1,1448267,1303370,144897,10
CT,1976,2,1445090,1306104,138986,9.6
CT,1976,3,1444604,1309064,135540,9.4
CT,1976,4,1447902,1312249,135653,9.4
CT,1976,5,1449679,1315662,134017,9.2
CT,1976,6,1452592,1319303,133289,9.2
CT,1976,7,1454040,1323172,130868,9
CT,1976,8,1460926,1327265,133661,9.1
CT,1976,9,1463161,1331585,131576,9
CT,1976,10,1462510,1336135,126375,8.6
CT,1976,11,1465992,1340917,125075,8.5
CT,1976,12,1469030,1345936,123094,8.4
CT,1977,1,1471660,1351192,120468,8.2
CT,1977,2,1475961,1356392,119569,8.1
CT,1977,3,1478259,1361532,116727,7.9
CT,1977,4,1475548,1366610,108938,7.4
CT,1977,5,1476246,1371620,104626,7.1
CT,1977,6,1478817,1376556,102261,6.9
CT,1977,7,1483293,1381414,101879,6.9
CT,1977,8,1486506,1386188,100318,6.7
CT,1977,9,1490193,1390873,99320,6.7
CT,1977,10,1493470,1395464,98006,6.6
CT,1977,11,1495600,1399959,95641,6.4
CT,1977,12,1496005,1404353,91652,6.1
CT,1978,1,1495313,1408644,86669,5.8
CT,1978,2,1497731,1412898,84833,5.7
CT,1978,3,1499559,1417118,82441,5.5
CT,1978,4,1500066,1421304,78762,5.3
CT,1978,5,1501860,1425461,76399,5.1
CT,1978,6,1503392,1429590,73802,4.9
CT,1978,7,1508029,1433689,74340,4.9
CT,1978,8,1517496,1437755,79741,5.3
CT,1978,9,1520384,1441793,78591,5.2
CT,1978,10,1524107,1445801,78306,5.1
CT,1978,11,1527885,1449772,78113,5.1
CT,1978,12,1533985,1453702,80283,5.2
CT,1979,1,1539384,1457586,81798,5.3
CT,1979,2,1544311,1461147,83164,5.4
CT,1979,3,1547776,1464380,83396,5.4
CT,1979,4,1549772,1467281,82491,5.3
CT,1979,5,1550165,1469847,80318,5.2
CT,1979,6,1550209,1472076,78133,5
CT,1979,7,1554202,1473970,80232,5.2
CT,1979,8,1551572,1475529,76043,4.9
CT,1979,9,1555769,1476748,79021,5.1
CT,1979,10,1559317,1477624,81693,5.2
CT,1979,11,1559188,1478161,81027,5.2
CT,1979,12,1558854,1478362,80492,5.2
CT,1980,1,1562793,1478223,84570,5.4
CT,1980,2,1560180,1478294,81886,5.2
CT,1980,3,1561590,1478581,83009,5.3
CT,1980,4,1565540,1479089,86451,5.5
CT,1980,5,1571131,1479820,91311,5.8
CT,1980,6,1575257,1480784,94473,6
CT,1980,7,1581083,1481986,99097,6.3
CT,1980,8,1584401,1483434,100967,6.4
CT,1980,9,1584273,1485137,99136,6.3
CT,1980,10,1585088,1487103,97985,6.2
CT,1980,11,1587706,1489339,98367,6.2
CT,1980,12,1590133,1491853,98280,6.2
CT,1981,1,1589623,1494653,94970,6
CT,1981,2,1591867,1497252,94615,5.9
CT,1981,3,1590992,1499652,91340,5.7
CT,1981,4,1595508,1501856,93652,5.9
CT,1981,5,1598321,1503866,94455,5.9
CT,1981,6,1602071,1505684,96387,6
CT,1981,7,1604793,1507311,97482,6.1
CT,1981,8,1608195,1508748,99447,6.2
CT,1981,9,1607916,1509993,97923,6.1
CT,1981,10,1608937,1511048,97889,6.1
CT,1981,11,1611775,1511912,99863,6.2
CT,1981,12,1616426,1512584,103842,6.4
CT,1982,1,1618267,1513065,105202,6.5
CT,1982,2,1621106,1513611,107495,6.6
CT,1982,3,1623055,1514224,108831,6.7
CT,1982,4,1625265,1514911,110354,6.8
CT,1982,5,1626336,1515678,110658,6.8
CT,1982,6,1630250,1516529,113721,7
CT,1982,7,1629248,1517473,111775,6.9
CT,1982,8,1627972,1518515,109457,6.7
CT,1982,9,1632628,1519662,112966,6.9
CT,1982,10,1639467,1520916,118551,7.2
CT,1982,11,1639306,1522280,117026,7.1
CT,1982,12,1642342,1523758,118584,7.2
CT,1983,1,1645025,1525349,119676,7.3
CT,1983,2,1640892,1527280,113612,6.9
CT,1983,3,1640626,1529552,111074,6.8
CT,1983,4,1637794,1532167,105627,6.4
CT,1983,5,1635871,1535121,100750,6.2
CT,1983,6,1635548,1538416,97132,5.9
CT,1983,7,1635127,1542049,93078,5.7
CT,1983,8,1633217,1546019,87198,5.3
CT,1983,9,1636964,1550321,86643,5.3
CT,1983,10,1640555,1554955,85600,5.2
CT,1983,11,1643929,1559919,84010,5.1
CT,1983,12,1646740,1565208,81532,5
CT,1984,1,1649101,1570821,78280,4.7
CT,1984,2,1652109,1576136,75973,4.6
CT,1984,3,1655135,1581147,73988,4.5
CT,1984,4,1660656,1585844,74812,4.5
CT,1984,5,1665898,1590223,75675,4.5
CT,1984,6,1668806,1594275,74531,4.5
CT,1984,7,1671003,1597990,73013,4.4
CT,1984,8,1675110,1601366,73744,4.4
CT,1984,9,1680847,1604399,76448,4.5
CT,1984,10,1682999,1607084,75915,4.5
CT,1984,11,1688101,1609415,78686,4.7
CT,1984,12,1691316,1611389,79927,4.7
CT,1985,1,1693546,1613003,80543,4.8
CT,1985,2,1696160,1614745,81415,4.8
CT,1985,3,1695547,1616611,78936,4.7
CT,1985,4,1698894,1618600,80294,4.7
CT,1985,5,1702662,1620715,81947,4.8
CT,1985,6,1704514,1622957,81557,4.8
CT,1985,7,1705987,1625324,80663,4.7
CT,1985,8,1705463,1627817,77646,4.6
CT,1985,9,1706790,1630432,76358,4.5
CT,1985,10,1708485,1633167,75318,4.4
CT,1985,11,1708306,1636017,72289,4.2
CT,1985,12,1709688,1638978,70710,4.1
CT,1986,1,1708601,1642047,66554,3.9
CT,1986,2,1709557,1645057,64500,3.8
CT,1986,3,1714246,1648002,66244,3.9
CT,1986,4,1716894,1650882,66012,3.8
CT,1986,5,1717955,1653693,64262,3.7
CT,1986,6,1721983,1656434,65549,3.8
CT,1986,7,1724263,1659099,65164,3.8
CT,1986,8,1725582,1661689,63893,3.7
CT,1986,9,1729779,1664206,65573,3.8
CT,1986,10,1731110,1666650,64460,3.7
CT,1986,11,1732354,1669019,63335,3.7
CT,1986,12,1734414,1671314,63100,3.6
CT,1987,1,1732972,1673533,59439,3.4
CT,1987,2,1735359,1675627,59732,3.4
CT,1987,3,1736757,1677596,59161,3.4
CT,1987,4,1736217,1679437,56780,3.3
CT,1987,5,1736134,1681149,54985,3.2
CT,1987,6,1738709,1682734,55975,3.2
CT,1987,7,1738070,1684192,53878,3.1
CT,1987,8,1739298,1685523,53775,3.1
CT,1987,9,1742173,1686725,55448,3.2
CT,1987,10,1743756,1687804,55952,3.2
CT,1987,11,1742448,1688768,53680,3.1
CT,1987,12,1739871,1689617,50254,2.9
CT,1988,1,1740454,1690354,50100,2.9
CT,1988,2,1738088,1691090,46998,2.7
CT,1988,3,1738703,1691827,46876,2.7
CT,1988,4,1739057,1692564,46493,2.7
CT,1988,5,1742533,1693299,49234,2.8
CT,1988,6,1745314,1694030,51284,2.9
CT,1988,7,1746720,1694760,51960,3
CT,1988,8,1747691,1695491,52200,3
CT,1988,9,1747379,1696223,51156,2.9
CT,1988,10,1748369,1696954,51415,2.9
CT,1988,11,1747798,1697685,50113,2.9
CT,1988,12,1750567,1698419,52148,3
CT,1989,1,1750620,1699158,51462,2.9
CT,1989,2,1752637,1700064,52573,3
CT,1989,3,1756280,1701131,55149,3.1
CT,1989,4,1758972,1702361,56611,3.2
CT,1989,5,1764123,1703754,60369,3.4
CT,1989,6,1767672,1705312,62360,3.5
CT,1989,7,1771915,1707035,64880,3.7
CT,1989,8,1776419,1708920,67499,3.8
CT,1989,9,1780599,1710968,69631,3.9
CT,1989,10,1786385,1713180,73205,4.1
CT,1989,11,1790766,1715557,75209,4.2
CT,1989,12,1797045,1718096,78949,4.4
CT,1990,1,1803762,1720795,82967,4.6
CT,1990,2,1808523,1723068,85455,4.7
CT,1990,3,1812314,1724915,87399,4.8
CT,1990,4,1815430,1726332,89098,4.9
CT,1990,5,1816453,1727316,89137,4.9
CT,1990,6,1815831,1727865,87966,4.8
CT,1990,7,1816906,1727977,88929,4.9
CT,1990,8,1817094,1727651,89443,4.9
CT,1990,9,1817483,1726890,90593,5
CT,1990,10,1817864,1725694,92170,5.1
CT,1990,11,1818634,1724065,94569,5.2
CT,1990,12,1818792,1722005,96787,5.3
CT,1991,1,1822280,1719517,102763,5.6
CT,1991,2,1826719,1717143,109576,6
CT,1991,3,1827679,1714885,112794,6.2
CT,1991,4,1827906,1712745,115161,6.3
CT,1991,5,1828716,1710725,117991,6.5
CT,1991,6,1829553,1708825,120728,6.6
CT,1991,7,1830581,1707047,123534,6.7
CT,1991,8,1828865,1705393,123472,6.8
CT,1991,9,1827869,1703866,124003,6.8
CT,1991,10,1827708,1702465,125243,6.9
CT,1991,11,1829261,1701194,128067,7
CT,1991,12,1830612,1700054,130558,7.1
CT,1992,1,1833319,1699051,134268,7.3
CT,1992,2,1835931,1698040,137891,7.5
CT,1992,3,1834169,1697027,137142,7.5
CT,1992,4,1834505,1696014,138491,7.5
CT,1992,5,1831612,1695005,136607,7.5
CT,1992,6,1829004,1694002,135002,7.4
CT,1992,7,1826923,1693010,133913,7.3
CT,1992,8,1824786,1692029,132757,7.3
CT,1992,9,1821184,1691061,130123,7.1
CT,1992,10,1817264,1690107,127157,7
CT,1992,11,1817146,1689167,127979,7
CT,1992,12,1815385,1688243,127142,7
CT,1993,1,1810479,1687336,123143,6.8
CT,1993,2,1806549,1686427,120122,6.6
CT,1993,3,1805994,1685517,120477,6.7
CT,1993,4,1808957,1684603,124354,6.9
CT,1993,5,1804765,1683686,121079,6.7
CT,1993,6,1801165,1682764,118401,6.6
CT,1993,7,1796945,1681833,115112,6.4
CT,1993,8,1793340,1680893,112447,6.3
CT,1993,9,1788422,1679947,108475,6.1
CT,1993,10,1784176,1678997,105179,5.9
CT,1993,11,1781130,1678046,103084,5.8
CT,1993,12,1777768,1677100,100668,5.7
CT,1994,1,1775761,1676162,99599,5.6
CT,1994,2,1774773,1675179,99594,5.6
CT,1994,3,1775089,1674150,100939,5.7
CT,1994,4,1771887,1673081,98806,5.6
CT,1994,5,1771112,1671977,99135,5.6
CT,1994,6,1768777,1670841,97936,5.5
CT,1994,7,1766384,1669675,96709,5.5
CT,1994,8,1765366,1668479,96887,5.5
CT,1994,9,1761826,1667256,94570,5.4
CT,1994,10,1758787,1666009,92778,5.3
CT,1994,11,1758393,1664739,93654,5.3
CT,1994,12,1756346,1663447,92899,5.3
CT,1995,1,1756086,1662132,93954,5.4
CT,1995,2,1756898,1660932,95966,5.5
CT,1995,3,1754426,1659847,94579,5.4
CT,1995,4,1751500,1658882,92618,5.3
CT,1995,5,1750986,1658035,92951,5.3
CT,1995,6,1750583,1657313,93270,5.3
CT,1995,7,1750356,1656716,93640,5.3
CT,1995,8,1748851,1656243,92608,5.3
CT,1995,9,1745737,1655893,89844,5.1
CT,1995,10,1744636,1655666,88970,5.1
CT,1995,11,1744849,1655558,89291,5.1
CT,1995,12,1745813,1655567,90246,5.2
CT,1996,1,1749273,1655693,93580,5.3
CT,1996,2,1748363,1655959,92404,5.3
CT,1996,3,1748607,1656361,92246,5.3
CT,1996,4,1747954,1656901,91053,5.2
CT,1996,5,1748629,1657575,91054,5.2
CT,1996,6,1749555,1658384,91171,5.2
CT,1996,7,1751029,1659329,91700,5.2
CT,1996,8,1752562,1660410,92152,5.3
CT,1996,9,1755232,1661626,93606,5.3
CT,1996,10,1758794,1662974,95820,5.4
CT,1996,11,1760738,1664451,96287,5.5
CT,1996,12,1762540,1666056,96484,5.5
CT,1997,1,1763539,1667790,95749,5.4
CT,1997,2,1763121,1669428,93693,5.3
CT,1997,3,1763683,1670968,92715,5.3
CT,1997,4,1765475,1672407,93068,5.3
CT,1997,5,1764404,1673745,90659,5.1
CT,1997,6,1762797,1674979,87818,5
CT,1997,7,1760396,1676109,84287,4.8
CT,1997,8,1758349,1677133,81216,4.6
CT,1997,9,1756591,1678052,78539,4.5
CT,1997,10,1756237,1678866,77371,4.4
CT,1997,11,1753282,1679576,73706,4.2
CT,1997,12,1750362,1680184,70178,4
CT,1998,1,1746080,1680690,65390,3.7
CT,1998,2,1744620,1681258,63362,3.6
CT,1998,3,1744112,1681888,62224,3.6
CT,1998,4,1742126,1682575,59551,3.4
CT,1998,5,1741185,1683320,57865,3.3
CT,1998,6,1740519,1684116,56403,3.2
CT,1998,7,1739247,1684964,54283,3.1
CT,1998,8,1740607,1685861,54746,3.1
CT,1998,9,1742849,1686803,56046,3.2
CT,1998,10,1740719,1687789,52930,3
CT,1998,11,1740225,1688819,51406,3
CT,1998,12,1737395,1689891,47504,2.7
CT,1999,1,1741000,1692779,48221,2.8
CT,1999,2,1741642,1693661,47981,2.8
CT,1999,3,1742637,1694452,48185,2.8
CT,1999,4,1745030,1695153,49877,2.9
CT,1999,5,1743809,1695760,48049,2.8
CT,1999,6,1742007,1696295,45712,2.6
CT,1999,7,1736047,1696753,39294,2.3
CT,1999,8,1733995,1697114,36881,2.1
CT,1999,9,1743166,1697371,45795,2.6
CT,1999,10,1747025,1697532,49493,2.8
CT,1999,11,1746643,1697610,49033,2.8
CT,1999,12,1743601,1697603,45998,2.6
CT,2000,1,1738618,1697496,41122,2.4
CT,2000,2,1741483,1697439,44044,2.5
CT,2000,3,1737373,1697423,39950,2.3
CT,2000,4,1736425,1697436,38989,2.2
CT,2000,5,1737616,1697477,40139,2.3
CT,2000,6,1736354,1697538,38816,2.2
CT,2000,7,1736904,1697617,39287,2.3
CT,2000,8,1737074,1697695,39379,2.3
CT,2000,9,1735594,1697789,37805,2.2
CT,2000,10,1734305,1697895,36410,2.1
CT,2000,11,1733682,1698031,35651,2.1
CT,2000,12,1736537,1698199,38338,2.2
CT,2001,1,1742303,1698386,43917,2.5
CT,2001,2,1742676,1698573,44103,2.5
CT,2001,3,1746694,1698783,47911,2.7
CT,2001,4,1749497,1699029,50468,2.9
CT,2001,5,1753153,1699318,53835,3.1
CT,2001,6,1757514,1699642,57872,3.3
CT,2001,7,1759263,1700001,59262,3.4
CT,2001,8,1761727,1700398,61329,3.5
CT,2001,9,1759860,1700835,59025,3.4
CT,2001,10,1759177,1701318,57859,3.3
CT,2001,11,1761919,1701845,60074,3.4
CT,2001,12,1764288,1702424,61864,3.5
CT,2002,1,1760634,1698367,62267,3.5
CT,2002,2,1763545,1699025,64520,3.7
CT,2002,3,1766283,1699632,66651,3.8
CT,2002,4,1771923,1700179,71744,4
CT,2002,5,1774459,1700662,73797,4.2
CT,2002,6,1775311,1701080,74231,4.2
CT,2002,7,1780032,1701435,78597,4.4
CT,2002,8,1783736,1701747,81989,4.6
CT,2002,9,1787032,1702011,85021,4.8
CT,2002,10,1791633,1702234,89399,5
CT,2002,11,1795449,1702427,93022,5.2
CT,2002,12,1797889,1702590,95299,5.3
CT,2003,1,1791906,1695816,96090,5.4
CT,2003,2,1794417,1695764,98653,5.5
CT,2003,3,1797877,1695769,102108,5.7
CT,2003,4,1797881,1695844,102037,5.7
CT,2003,5,1793736,1695998,97738,5.4
CT,2003,6,1794963,1696227,98736,5.5
CT,2003,7,1796507,1696537,99970,5.6
CT,2003,8,1795120,1696934,98186,5.5
CT,2003,9,1795145,1697416,97729,5.4
CT,2003,10,1793891,1697991,95900,5.3
CT,2003,11,1794380,1698636,95744,5.3
CT,2003,12,1794179,1699356,94823,5.3
CT,2004,1,1790162,1698926,91236,5.1
CT,2004,2,1792800,1699700,93100,5.2
CT,2004,3,1792268,1700519,91749,5.1
CT,2004,4,1790376,1701377,88999,5
CT,2004,5,1792157,1702270,89887,5
CT,2004,6,1790318,1703194,87124,4.9
CT,2004,7,1791268,1704153,87115,4.9
CT,2004,8,1792515,1705141,87374,4.9
CT,2004,9,1792230,1706161,86069,4.8
CT,2004,10,1793302,1707215,86087,4.8
CT,2004,11,1794245,1708305,85940,4.8
CT,2004,12,1793366,1709422,83944,4.7
CT,2005,1,1798732,1710566,88166,4.9
CT,2005,2,1800679,1711868,88811,4.9
CT,2005,3,1804330,1713321,91009,5
CT,2005,4,1804214,1714925,89289,4.9
CT,2005,5,1807915,1716656,91259,5
CT,2005,6,1808025,1718527,89498,5
CT,2005,7,1808986,1720537,88449,4.9
CT,2005,8,1812620,1722691,89929,5
CT,2005,9,1812625,1724988,87637,4.8
CT,2005,10,1815713,1727414,88299,4.9
CT,2005,11,1815021,1729982,85039,4.7
CT,2005,12,1816290,1732681,83609,4.6
CT,2006,1,1819660,1735497,84163,4.6
CT,2006,2,1819271,1738211,81060,4.5
CT,2006,3,1821214,1740818,80396,4.4
CT,2006,4,1818492,1743320,75172,4.1
CT,2006,5,1823616,1745698,77918,4.3
CT,2006,6,1827663,1747963,79700,4.4
CT,2006,7,1832106,1750117,81989,4.5
CT,2006,8,1835828,1752156,83672,4.6
CT,2006,9,1837709,1754071,83638,4.6
CT,2006,10,1837007,1755875,81132,4.4
CT,2006,11,1837887,1757564,80323,4.4
CT,2006,12,1837829,1759124,78705,4.3
CT,2007,1,1841334,1760536,80798,4.4
CT,2007,2,1842983,1761850,81133,4.4
CT,2007,3,1844200,1763065,81135,4.4
CT,2007,4,1845902,1764183,81719,4.4
CT,2007,5,1846491,1765207,81284,4.4
CT,2007,6,1847188,1766117,81071,4.4
CT,2007,7,1849796,1766903,82893,4.5
CT,2007,8,1852828,1767569,85259,4.6
CT,2007,9,1854441,1768120,86321,4.7
CT,2007,10,1858067,1768552,89515,4.8
CT,2007,11,1860794,1768866,91928,4.9
CT,2007,12,1860119,1769052,91067,4.9
CT,2008,1,1862296,1769104,93192,5
CT,2008,2,1865639,1769144,96495,5.2
CT,2008,3,1868105,1769171,98934,5.3
CT,2008,4,1865841,1769187,96654,5.2
CT,2008,5,1869243,1769200,100043,5.4
CT,2008,6,1871949,1769204,102745,5.5
CT,2008,7,1877881,1769205,108676,5.8
CT,2008,8,1883230,1769217,114013,6.1
CT,2008,9,1881923,1769245,112678,6
CT,2008,10,1884751,1769281,115470,6.1
CT,2008,11,1888407,1769319,119088,6.3
CT,2008,12,1894238,1769398,124840,6.6
CT,2009,1,1889081,1751490,137591,7.3
DE,1976,1,262136,241292,20844,8
DE,1976,2,262405,241414,20991,8
DE,1976,3,262674,241546,21128,8
DE,1976,4,262946,241691,21255,8.1
DE,1976,5,263228,241857,21371,8.1
DE,1976,6,263524,242050,21474,8.1
DE,1976,7,263832,242271,21561,8.2
DE,1976,8,264156,242522,21634,8.2
DE,1976,9,264496,242807,21689,8.2
DE,1976,10,264849,243124,21725,8.2
DE,1976,11,265216,243474,21742,8.2
DE,1976,12,265593,243854,21739,8.2
DE,1977,1,265981,244265,21716,8.2
DE,1977,2,266386,244710,21676,8.1
DE,1977,3,266812,245192,21620,8.1
DE,1977,4,267252,245702,21550,8.1
DE,1977,5,267703,246236,21467,8
DE,1977,6,268165,246793,21372,8
DE,1977,7,268639,247372,21267,7.9
DE,1977,8,269126,247973,21153,7.9
DE,1977,9,269626,248594,21032,7.8
DE,1977,10,270138,249232,20906,7.7
DE,1977,11,270665,249888,20777,7.7
DE,1977,12,271204,250559,20645,7.6
DE,1978,1,271760,251246,20514,7.5
DE,1978,2,272310,251918,20392,7.5
DE,1978,3,272859,252579,20280,7.4
DE,1978,4,273407,253228,20179,7.4
DE,1978,5,273954,253865,20089,7.3
DE,1978,6,274498,254487,20011,7.3
DE,1978,7,275041,255096,19945,7.3
DE,1978,8,275582,255692,19890,7.2
DE,1978,9,276124,256276,19848,7.2
DE,1978,10,276664,256845,19819,7.2
DE,1978,11,277203,257399,19804,7.1
DE,1978,12,277743,257941,19802,7.1
DE,1979,1,278278,258466,19812,7.1
DE,1979,2,278782,258953,19829,7.1
DE,1979,3,279252,259400,19852,7.1
DE,1979,4,279689,259810,19879,7.1
DE,1979,5,280093,260182,19911,7.1
DE,1979,6,280466,260517,19949,7.1
DE,1979,7,280808,260815,19993,7.1
DE,1979,8,281118,261076,20042,7.1
DE,1979,9,281397,261301,20096,7.1
DE,1979,10,281641,261487,20154,7.2
DE,1979,11,281847,261632,20215,7.2
DE,1979,12,282016,261735,20281,7.2
DE,1980,1,282145,261796,20349,7.2
DE,1980,2,282302,261873,20429,7.2
DE,1980,3,282484,261965,20519,7.3
DE,1980,4,282699,262078,20621,7.3
DE,1980,5,282952,262218,20734,7.3
DE,1980,6,283245,262388,20857,7.4
DE,1980,7,283582,262593,20989,7.4
DE,1980,8,283965,262838,21127,7.4
DE,1980,9,284391,263122,21269,7.5
DE,1980,10,284859,263444,21415,7.5
DE,1980,11,285363,263799,21564,7.6
DE,1980,12,285899,264183,21716,7.6
DE,1981,1,286467,264597,21870,7.6
DE,1981,2,287009,264991,22018,7.7
DE,1981,3,287526,265367,22159,7.7
DE,1981,4,288019,265726,22293,7.7
DE,1981,5,288483,266064,22419,7.8
DE,1981,6,288921,266384,22537,7.8
DE,1981,7,289329,266682,22647,7.8
DE,1981,8,289706,266956,22750,7.9
DE,1981,9,290052,267209,22843,7.9
DE,1981,10,290371,267445,22926,7.9
DE,1981,11,290668,267669,22999,7.9
DE,1981,12,290944,267885,23059,7.9
DE,1982,1,291202,268097,23105,7.9
DE,1982,2,291479,268326,23153,7.9
DE,1982,3,291768,268566,23202,8
DE,1982,4,292062,268811,23251,8
DE,1982,5,292363,269063,23300,8
DE,1982,6,292668,269322,23346,8
DE,1982,7,292981,269590,23391,8
DE,1982,8,293298,269863,23435,8
DE,1982,9,293622,270145,23477,8
DE,1982,10,293952,270435,23517,8
DE,1982,11,294290,270734,23556,8
DE,1982,12,294641,271047,23594,8
DE,1983,1,295003,271371,23632,8
DE,1983,2,295405,271779,23626,8
DE,1983,3,295849,272272,23577,8
DE,1983,4,296339,272855,23484,7.9
DE,1983,5,296881,273531,23350,7.9
DE,1983,6,297476,274302,23174,7.8
DE,1983,7,298128,275170,22958,7.7
DE,1983,8,298837,276133,22704,7.6
DE,1983,9,299606,277193,22413,7.5
DE,1983,10,300434,278348,22086,7.4
DE,1983,11,301323,279598,21725,7.2
DE,1983,12,302274,280942,21332,7.1
DE,1984,1,303290,282378,20912,6.9
DE,1984,2,304269,283755,20514,6.7
DE,1984,3,305207,285069,20138,6.6
DE,1984,4,306103,286317,19786,6.5
DE,1984,5,306952,287497,19455,6.3
DE,1984,6,307752,288606,19146,6.2
DE,1984,7,308503,289648,18855,6.1
DE,1984,8,309202,290618,18584,6
DE,1984,9,309839,291511,18328,5.9
DE,1984,10,310413,292325,18088,5.8
DE,1984,11,310921,293059,17862,5.7
DE,1984,12,311365,293715,17650,5.7
DE,1985,1,311743,294292,17451,5.6
DE,1985,2,312149,294911,17238,5.5
DE,1985,3,312583,295573,17010,5.4
DE,1985,4,313047,296278,16769,5.4
DE,1985,5,313540,297025,16515,5.3
DE,1985,6,314066,297816,16250,5.2
DE,1985,7,314624,298649,15975,5.1
DE,1985,8,315210,299520,15690,5
DE,1985,9,315828,300430,15398,4.9
DE,1985,10,316481,301380,15101,4.8
DE,1985,11,317173,302374,14799,4.7
DE,1985,12,317908,303414,14494,4.6
DE,1986,1,318690,304505,14185,4.5
DE,1986,2,319475,305593,13882,4.3
DE,1986,3,320269,306685,13584,4.2
DE,1986,4,321078,307786,13292,4.1
DE,1986,5,321904,308899,13005,4
DE,1986,6,322744,310019,12725,3.9
DE,1986,7,323600,311147,12453,3.8
DE,1986,8,324472,312281,12191,3.8
DE,1986,9,325358,313419,11939,3.7
DE,1986,10,326258,314559,11699,3.6
DE,1986,11,327171,315698,11473,3.5
DE,1986,12,328092,316831,11261,3.4
DE,1987,1,329019,317954,11065,3.4
DE,1987,2,329956,319072,10884,3.3
DE,1987,3,330903,320184,10719,3.2
DE,1987,4,331859,321290,10569,3.2
DE,1987,5,332822,322388,10434,3.1
DE,1987,6,333792,323478,10314,3.1
DE,1987,7,334770,324560,10210,3
DE,1987,8,335756,325634,10122,3
DE,1987,9,336751,326700,10051,3
DE,1987,10,337756,327759,9997,3
DE,1987,11,338768,328810,9958,2.9
DE,1987,12,339785,329853,9932,2.9
DE,1988,1,340806,330890,9916,2.9
DE,1988,2,341836,331924,9912,2.9
DE,1988,3,342875,332954,9921,2.9
DE,1988,4,343920,333977,9943,2.9
DE,1988,5,344970,334992,9978,2.9
DE,1988,6,346022,335996,10026,2.9
DE,1988,7,347067,336981,10086,2.9
DE,1988,8,348100,337946,10154,2.9
DE,1988,9,349123,338893,10230,2.9
DE,1988,10,350138,339825,10313,2.9
DE,1988,11,351141,340739,10402,3
DE,1988,12,352132,341635,10497,3
DE,1989,1,353104,342509,10595,3
DE,1989,2,354060,343364,10696,3
DE,1989,3,354999,344201,10798,3
DE,1989,4,355922,345021,10901,3.1
DE,1989,5,356829,345827,11002,3.1
DE,1989,6,357722,346621,11101,3.1
DE,1989,7,358604,347408,11196,3.1
DE,1989,8,359475,348189,11286,3.1
DE,1989,9,360330,348959,11371,3.2
DE,1989,10,361169,349718,11451,3.2
DE,1989,11,361993,350469,11524,3.2
DE,1989,12,362800,351209,11591,3.2
DE,1990,1,363589,351937,11652,3.2
DE,1990,2,364319,352618,11701,3.2
DE,1990,3,364982,353245,11737,3.2
DE,1990,4,365573,353813,11760,3.2
DE,1990,5,366092,354322,11770,3.2
DE,1990,6,366538,354772,11766,3.2
DE,1990,7,351677,339927,11750,3.3
DE,1990,8,351992,340273,11719,3.3
DE,1990,9,362416,340565,21851,6
DE,1990,10,362582,340808,21774,6
DE,1990,11,362683,341005,21678,6
DE,1990,12,362730,341167,21563,5.9
DE,1991,1,362723,341294,21429,5.9
DE,1991,2,362735,341437,21298,5.9
DE,1991,3,362769,341600,21169,5.8
DE,1991,4,362826,341782,21044,5.8
DE,1991,5,362917,341993,20924,5.8
DE,1991,6,363037,342228,20809,5.7
DE,1991,7,363189,342488,20701,5.7
DE,1991,8,363380,342779,20601,5.7
DE,1991,9,363614,343106,20508,5.6
DE,1991,10,363892,343467,20425,5.6
DE,1991,11,364207,343855,20352,5.6
DE,1991,12,364561,344271,20290,5.6
DE,1992,1,364955,344715,20240,5.5
DE,1992,2,365341,345161,20180,5.5
DE,1992,3,365724,345612,20112,5.5
DE,1992,4,366104,346068,20036,5.5
DE,1992,5,366476,346523,19953,5.4
DE,1992,6,366839,346976,19863,5.4
DE,1992,7,367192,347425,19767,5.4
DE,1992,8,367538,347872,19666,5.4
DE,1992,9,367880,348318,19562,5.3
DE,1992,10,368224,348768,19456,5.3
DE,1992,11,368567,349220,19347,5.2
DE,1992,12,368907,349669,19238,5.2
DE,1993,1,369238,350111,19127,5.2
DE,1993,2,369602,350582,19020,5.1
DE,1993,3,369996,351080,18916,5.1
DE,1993,4,370421,351607,18814,5.1
DE,1993,5,370872,352158,18714,5
DE,1993,6,371348,352731,18617,5
DE,1993,7,371845,353325,18520,5
DE,1993,8,372359,353938,18421,4.9
DE,1993,9,372891,354573,18318,4.9
DE,1993,10,373439,355229,18210,4.9
DE,1993,11,374009,355912,18097,4.8
DE,1993,12,374604,356627,17977,4.8
DE,1994,1,375226,357376,17850,4.8
DE,1994,2,375828,358100,17728,4.7
DE,1994,3,376412,358801,17611,4.7
DE,1994,4,376977,359478,17499,4.6
DE,1994,5,377523,360131,17392,4.6
DE,1994,6,378050,360757,17293,4.6
DE,1994,7,378555,361353,17202,4.5
DE,1994,8,379035,361915,17120,4.5
DE,1994,9,379489,362440,17049,4.5
DE,1994,10,379913,362923,16990,4.5
DE,1994,11,380305,363362,16943,4.5
DE,1994,12,380662,363753,16909,4.4
DE,1995,1,380985,364097,16888,4.4
DE,1995,2,381313,364443,16870,4.4
DE,1995,3,381650,364794,16856,4.4
DE,1995,4,381996,365151,16845,4.4
DE,1995,5,382359,365521,16838,4.4
DE,1995,6,382738,365906,16832,4.4
DE,1995,7,383138,366310,16828,4.4
DE,1995,8,383556,366731,16825,4.4
DE,1995,9,383987,367166,16821,4.4
DE,1995,10,384431,367616,16815,4.4
DE,1995,11,384889,368085,16804,4.4
DE,1995,12,385361,368574,16787,4.4
DE,1996,1,385853,369090,16763,4.3
DE,1996,2,386356,369618,16738,4.3
DE,1996,3,386863,370153,16710,4.3
DE,1996,4,387368,370690,16678,4.3
DE,1996,5,387862,371221,16641,4.3
DE,1996,6,388336,371740,16596,4.3
DE,1996,7,388794,372249,16545,4.3
DE,1996,8,389241,372755,16486,4.2
DE,1996,9,389682,373264,16418,4.2
DE,1996,10,390123,373781,16342,4.2
DE,1996,11,390563,374305,16258,4.2
DE,1996,12,391004,374836,16168,4.1
DE,1997,1,391446,375375,16071,4.1
DE,1997,2,391867,375905,15962,4.1
DE,1997,3,392269,376426,15843,4
DE,1997,4,392655,376938,15717,4
DE,1997,5,393027,377441,15586,4
DE,1997,6,393387,377935,15452,3.9
DE,1997,7,393735,378419,15316,3.9
DE,1997,8,394072,378893,15179,3.9
DE,1997,9,394397,379354,15043,3.8
DE,1997,10,394712,379804,14908,3.8
DE,1997,11,395020,380242,14778,3.7
DE,1997,12,395319,380667,14652,3.7
DE,1998,1,395604,381076,14528,3.7
DE,1998,2,395895,381485,14410,3.6
DE,1998,3,396192,381895,14297,3.6
DE,1998,4,396497,382308,14189,3.6
DE,1998,5,396807,382723,14084,3.5
DE,1998,6,397124,383142,13982,3.5
DE,1998,7,397447,383562,13885,3.5
DE,1998,8,397773,383982,13791,3.5
DE,1998,9,398104,384401,13703,3.4
DE,1998,10,398442,384821,13621,3.4
DE,1998,11,398790,385245,13545,3.4
DE,1998,12,399152,385676,13476,3.4
DE,1999,1,399525,386110,13415,3.4
DE,1999,2,399883,386519,13364,3.3
DE,1999,3,400225,386901,13324,3.3
DE,1999,4,400549,387254,13295,3.3
DE,1999,5,400850,387574,13276,3.3
DE,1999,6,401133,387865,13268,3.3
DE,1999,7,401396,388126,13270,3.3
DE,1999,8,401639,388355,13284,3.3
DE,1999,9,401857,388549,13308,3.3
DE,1999,10,402052,388709,13343,3.3
DE,1999,11,402216,388830,13386,3.3
DE,1999,12,402344,388909,13435,3.3
DE,2000,1,402832,390074,12758,3.2
DE,2000,2,403264,390323,12941,3.2
DE,2000,3,417708,404978,12730,3
DE,2000,4,418393,405147,13246,3.2
DE,2000,5,418813,405278,13535,3.2
DE,2000,6,418993,405372,13621,3.3
DE,2000,7,419230,405429,13801,3.3
DE,2000,8,419440,405448,13992,3.3
DE,2000,9,419525,405431,14094,3.4
DE,2000,10,419623,405380,14243,3.4
DE,2000,11,419865,405293,14572,3.5
DE,2000,12,420351,405169,15182,3.6
DE,2001,1,420669,405003,15666,3.7
DE,2001,2,419972,404841,15131,3.6
DE,2001,3,419144,404676,14468,3.5
DE,2001,4,418628,404505,14123,3.4
DE,2001,5,418417,404332,14085,3.4
DE,2001,6,418081,404161,13920,3.3
DE,2001,7,418009,403996,14013,3.4
DE,2001,8,417976,403843,14133,3.4
DE,2001,9,417966,403707,14259,3.4
DE,2001,10,418082,403595,14487,3.5
DE,2001,11,418498,403510,14988,3.6
DE,2001,12,419129,403453,15676,3.7
DE,2002,1,417240,400999,16241,3.9
DE,2002,2,417212,400986,16226,3.9
DE,2002,3,417665,400996,16669,4
DE,2002,4,418203,401030,17173,4.1
DE,2002,5,418153,401087,17066,4.1
DE,2002,6,417894,401164,16730,4
DE,2002,7,417483,401259,16224,3.9
DE,2002,8,417510,401366,16144,3.9
DE,2002,9,417822,401483,16339,3.9
DE,2002,10,417996,401606,16390,3.9
DE,2002,11,418546,401740,16806,4
DE,2002,12,418894,401890,17004,4.1
DE,2003,1,419259,402047,17212,4.1
DE,2003,2,420348,402231,18117,4.3
DE,2003,3,421108,402442,18666,4.4
DE,2003,4,421086,402684,18402,4.4
DE,2003,5,420606,402955,17651,4.2
DE,2003,6,420810,403248,17562,4.2
DE,2003,7,421286,403559,17727,4.2
DE,2003,8,421763,403885,17878,4.2
DE,2003,9,421500,404225,17275,4.1
DE,2003,10,421327,404572,16755,4
DE,2003,11,421674,404923,16751,4
DE,2003,12,421968,405277,16691,4
DE,2004,1,421951,405905,16046,3.8
DE,2004,2,422456,406261,16195,3.8
DE,2004,3,423098,406634,16464,3.9
DE,2004,4,423525,407027,16498,3.9
DE,2004,5,423835,407444,16391,3.9
DE,2004,6,424372,407886,16486,3.9
DE,2004,7,425073,408354,16719,3.9
DE,2004,8,425687,408847,16840,4
DE,2004,9,426624,409367,17257,4
DE,2004,10,426868,409913,16955,4
DE,2004,11,427457,410480,16977,4
DE,2004,12,428010,411070,16940,4
DE,2005,1,428694,411686,17008,4
DE,2005,2,428806,412322,16484,3.8
DE,2005,3,429520,412977,16543,3.9
DE,2005,4,430240,413651,16589,3.9
DE,2005,5,431630,414341,17289,4
DE,2005,6,432702,415047,17655,4.1
DE,2005,7,433246,415772,17474,4
DE,2005,8,433799,416512,17287,4
DE,2005,9,434695,417263,17432,4
DE,2005,10,435720,418018,17702,4.1
DE,2005,11,436260,418773,17487,4
DE,2005,12,437096,419523,17573,4
DE,2006,1,436815,420269,16546,3.8
DE,2006,2,437009,420964,16045,3.7
DE,2006,3,437219,421609,15610,3.6
DE,2006,4,437822,422207,15615,3.6
DE,2006,5,438471,422759,15712,3.6
DE,2006,6,438630,423267,15363,3.5
DE,2006,7,438937,423734,15203,3.5
DE,2006,8,439400,424165,15235,3.5
DE,2006,9,439772,424562,15210,3.5
DE,2006,10,439818,424920,14898,3.4
DE,2006,11,439797,425238,14559,3.3
DE,2006,12,439712,425512,14200,3.2
DE,2007,1,439977,425743,14234,3.2
DE,2007,2,440533,425919,14614,3.3
DE,2007,3,441147,426044,15103,3.4
DE,2007,4,441500,426117,15383,3.5
DE,2007,5,441162,426136,15026,3.4
DE,2007,6,441125,426098,15027,3.4
DE,2007,7,440941,426000,14941,3.4
DE,2007,8,440378,425842,14536,3.3
DE,2007,9,440610,425625,14985,3.4
DE,2007,10,441201,425349,15852,3.6
DE,2007,11,441155,425010,16145,3.7
DE,2007,12,441220,424602,16618,3.8
DE,2008,1,441257,424118,17139,3.9
DE,2008,2,441211,423654,17557,4
DE,2008,3,441147,423204,17943,4.1
DE,2008,4,441413,422768,18645,4.2
DE,2008,5,441836,422345,19491,4.4
DE,2008,6,442285,421937,20348,4.6
DE,2008,7,442689,421544,21145,4.8
DE,2008,8,443569,421165,22404,5.1
DE,2008,9,443937,420804,23133,5.2
DE,2008,10,444830,420465,24365,5.5
DE,2008,11,445174,420157,25017,5.6
DE,2008,12,445476,419891,25585,5.7
DE,2009,1,439927,410354,29573,6.7
DC,1976,1,341457,309041,32416,9.5
DC,1976,2,341205,309083,32122,9.4
DC,1976,3,340400,308577,31823,9.3
DC,1976,4,338922,307390,31532,9.3
DC,1976,5,337403,306138,31265,9.3
DC,1976,6,336778,305761,31017,9.2
DC,1976,7,335223,304440,30783,9.2
DC,1976,8,334424,303857,30567,9.1
DC,1976,9,331375,301002,30373,9.2
DC,1976,10,331893,301710,30183,9.1
DC,1976,11,331769,301797,29972,9
DC,1976,12,331062,301316,29746,9
DC,1977,1,330527,301027,29500,8.9
DC,1977,2,330305,301054,29251,8.9
DC,1977,3,328866,299879,28987,8.8
DC,1977,4,329094,300390,28704,8.7
DC,1977,5,329201,300786,28415,8.6
DC,1977,6,327815,299691,28124,8.6
DC,1977,7,325955,298123,27832,8.5
DC,1977,8,326328,298796,27532,8.4
DC,1977,9,327726,300506,27220,8.3
DC,1977,10,328991,302089,26902,8.2
DC,1977,11,329650,303067,26583,8.1
DC,1977,12,330859,304594,26265,7.9
DC,1978,1,332164,306229,25935,7.8
DC,1978,2,332036,306435,25601,7.7
DC,1978,3,332018,306749,25269,7.6
DC,1978,4,331706,306760,24946,7.5
DC,1978,5,331617,306985,24632,7.4
DC,1978,6,332011,307677,24334,7.3
DC,1978,7,332994,308937,24057,7.2
DC,1978,8,333494,309700,23794,7.1
DC,1978,9,332780,309233,23547,7.1
DC,1978,10,333627,310299,23328,7
DC,1978,11,333225,310090,23135,6.9
DC,1978,12,332175,309216,22959,6.9
DC,1979,1,330905,308110,22795,6.9
DC,1979,2,329281,306657,22624,6.9
DC,1979,3,327557,305099,22458,6.9
DC,1979,4,327260,304962,22298,6.8
DC,1979,5,327910,305765,22145,6.8
DC,1979,6,328908,306898,22010,6.7
DC,1979,7,329418,307519,21899,6.6
DC,1979,8,330066,308245,21821,6.6
DC,1979,9,331455,309674,21781,6.6
DC,1979,10,329008,307226,21782,6.6
DC,1979,11,327580,305759,21821,6.7
DC,1979,12,327150,305256,21894,6.7
DC,1980,1,324867,302853,22014,6.8
DC,1980,2,326103,303923,22180,6.8
DC,1980,3,325593,303208,22385,6.9
DC,1980,4,325489,302863,22626,7
DC,1980,5,324453,301565,22888,7.1
DC,1980,6,325232,302070,23162,7.1
DC,1980,7,325182,301739,23443,7.2
DC,1980,8,323235,299501,23734,7.3
DC,1980,9,317993,293957,24036,7.6
DC,1980,10,315933,291592,24341,7.7
DC,1980,11,315792,291130,24662,7.8
DC,1980,12,314479,289488,24991,7.9
DC,1981,1,312899,287556,25343,8.1
DC,1981,2,311657,285945,25712,8.3
DC,1981,3,311841,285735,26106,8.4
DC,1981,4,310212,283693,26519,8.5
DC,1981,5,308725,281765,26960,8.7
DC,1981,6,307469,280052,27417,8.9
DC,1981,7,307180,279298,27882,9.1
DC,1981,8,305615,277269,28346,9.3
DC,1981,9,306581,277783,28798,9.4
DC,1981,10,307143,277902,29241,9.5
DC,1981,11,306873,277191,29682,9.7
DC,1981,12,305309,275191,30118,9.9
DC,1982,1,305731,275195,30536,10
DC,1982,2,305732,274756,30976,10.1
DC,1982,3,306000,274587,31413,10.3
DC,1982,4,306173,274330,31843,10.4
DC,1982,5,307138,274871,32267,10.5
DC,1982,6,308070,275382,32688,10.6
DC,1982,7,310117,277026,33091,10.7
DC,1982,8,310965,277487,33478,10.8
DC,1982,9,309973,276117,33856,10.9
DC,1982,10,309987,275755,34232,11
DC,1982,11,310768,276178,34590,11.1
DC,1982,12,311174,276244,34930,11.2
DC,1983,1,311314,276065,35249,11.3
DC,1983,2,311375,275932,35443,11.4
DC,1983,3,312280,276757,35523,11.4
DC,1983,4,314206,278712,35494,11.3
DC,1983,5,313403,278050,35353,11.3
DC,1983,6,314513,279401,35112,11.2
DC,1983,7,314483,279702,34781,11.1
DC,1983,8,313581,279219,34362,11
DC,1983,9,314718,280863,33855,10.8
DC,1983,10,313929,280655,33274,10.6
DC,1983,11,312797,280165,32632,10.4
DC,1983,12,312010,280071,31939,10.2
DC,1984,1,312597,281399,31198,10
DC,1984,2,314089,283579,30510,9.7
DC,1984,3,315654,285773,29881,9.5
DC,1984,4,316072,286762,29310,9.3
DC,1984,5,317746,288950,28796,9.1
DC,1984,6,320414,292076,28338,8.8
DC,1984,7,322737,294797,27940,8.7
DC,1984,8,325399,297810,27589,8.5
DC,1984,9,323422,296134,27288,8.4
DC,1984,10,325452,298418,27034,8.3
DC,1984,11,326334,299501,26833,8.2
DC,1984,12,327082,300388,26694,8.2
DC,1985,1,325580,298967,26613,8.2
DC,1985,2,323285,296758,26527,8.2
DC,1985,3,322559,296129,26430,8.2
DC,1985,4,320194,293879,26315,8.2
DC,1985,5,321180,295001,26179,8.2
DC,1985,6,321981,295956,26025,8.1
DC,1985,7,321804,295950,25854,8
DC,1985,8,321332,295658,25674,8
DC,1985,9,321052,295570,25482,7.9
DC,1985,10,320282,295004,25278,7.9
DC,1985,11,321285,296219,25066,7.8
DC,1985,12,322565,297719,24846,7.7
DC,1986,1,323377,298756,24621,7.6
DC,1986,2,322450,298035,24415,7.6
DC,1986,3,320450,296225,24225,7.6
DC,1986,4,321484,297443,24041,7.5
DC,1986,5,320463,296607,23856,7.4
DC,1986,6,319547,295882,23665,7.4
DC,1986,7,321754,298287,23467,7.3
DC,1986,8,322197,298933,23264,7.2
DC,1986,9,324043,300986,23057,7.1
DC,1986,10,323492,300654,22838,7.1
DC,1986,11,323516,300908,22608,7
DC,1986,12,323857,301497,22360,6.9
DC,1987,1,325128,303032,22096,6.8
DC,1987,2,325958,304143,21815,6.7
DC,1987,3,328736,307226,21510,6.5
DC,1987,4,330404,309217,21187,6.4
DC,1987,5,330044,309197,20847,6.3
DC,1987,6,330618,310124,20494,6.2
DC,1987,7,331519,311389,20130,6.1
DC,1987,8,331352,311580,19772,6
DC,1987,9,327657,308235,19422,5.9
DC,1987,10,329602,310523,19079,5.8
DC,1987,11,329004,310257,18747,5.7
DC,1987,12,329675,311248,18427,5.6
DC,1988,1,329388,311266,18122,5.5
DC,1988,2,330442,312616,17826,5.4
DC,1988,3,331666,314127,17539,5.3
DC,1988,4,332012,314749,17263,5.2
DC,1988,5,332273,315278,16995,5.1
DC,1988,6,333061,316322,16739,5
DC,1988,7,332790,316290,16500,5
DC,1988,8,331085,314795,16290,4.9
DC,1988,9,328500,312393,16107,4.9
DC,1988,10,327124,311178,15946,4.9
DC,1988,11,327114,311303,15811,4.8
DC,1988,12,324292,308586,15706,4.8
DC,1989,1,322120,306489,15631,4.9
DC,1989,2,320569,304981,15588,4.9
DC,1989,3,319021,303445,15576,4.9
DC,1989,4,316441,300842,15599,4.9
DC,1989,5,316622,300970,15652,4.9
DC,1989,6,316163,300432,15731,5
DC,1989,7,313653,297809,15844,5.1
DC,1989,8,314252,298259,15993,5.1
DC,1989,9,315730,299542,16188,5.1
DC,1989,10,315466,299036,16430,5.2
DC,1989,11,313309,296590,16719,5.3
DC,1989,12,312239,295183,17056,5.5
DC,1990,1,336440,319004,17436,5.2
DC,1990,2,335565,317732,17833,5.3
DC,1990,3,335056,316804,18252,5.4
DC,1990,4,333028,314339,18689,5.6
DC,1990,5,333928,314791,19137,5.7
DC,1990,6,331199,311603,19596,5.9
DC,1990,7,330726,310665,20061,6.1
DC,1990,8,329902,309369,20533,6.2
DC,1990,9,329648,308638,21010,6.4
DC,1990,10,328471,306991,21480,6.5
DC,1990,11,327989,306049,21940,6.7
DC,1990,12,328457,306077,22380,6.8
DC,1991,1,326166,303374,22792,7
DC,1991,2,325051,301842,23209,7.1
DC,1991,3,324558,300942,23616,7.3
DC,1991,4,323325,299318,24007,7.4
DC,1991,5,321940,297570,24370,7.6
DC,1991,6,323942,299238,24704,7.6
DC,1991,7,322150,297133,25017,7.8
DC,1991,8,322450,297137,25313,7.9
DC,1991,9,320862,295263,25599,8
DC,1991,10,319544,293665,25879,8.1
DC,1991,11,320321,294170,26151,8.2
DC,1991,12,320695,294279,26416,8.2
DC,1992,1,322273,295607,26666,8.3
DC,1992,2,321894,295019,26875,8.3
DC,1992,3,321426,294380,27046,8.4
DC,1992,4,321875,294696,27179,8.4
DC,1992,5,319702,292420,27282,8.5
DC,1992,6,318867,291513,27354,8.6
DC,1992,7,316566,289169,27397,8.7
DC,1992,8,314961,287542,27419,8.7
DC,1992,9,313568,286148,27420,8.7
DC,1992,10,313502,286105,27397,8.7
DC,1992,11,311541,284188,27353,8.8
DC,1992,12,311735,284453,27282,8.8
DC,1993,1,313498,286297,27201,8.7
DC,1993,2,314971,287860,27111,8.6
DC,1993,3,315228,288212,27016,8.6
DC,1993,4,314931,288014,26917,8.5
DC,1993,5,315029,288218,26811,8.5
DC,1993,6,314627,287924,26703,8.5
DC,1993,7,314399,287813,26586,8.5
DC,1993,8,313144,286693,26451,8.4
DC,1993,9,314779,288487,26292,8.4
DC,1993,10,313788,287673,26115,8.3
DC,1993,11,313239,287323,25916,8.3
DC,1993,12,313951,288252,25699,8.2
DC,1994,1,311538,286068,25470,8.2
DC,1994,2,308717,283456,25261,8.2
DC,1994,3,309717,284642,25075,8.1
DC,1994,4,313023,288108,24915,8
DC,1994,5,312401,287607,24794,7.9
DC,1994,6,312476,287766,24710,7.9
DC,1994,7,311410,286749,24661,7.9
DC,1994,8,309642,285003,24639,8
DC,1994,9,309336,284683,24653,8
DC,1994,10,308953,284238,24715,8
DC,1994,11,308243,283416,24827,8.1
DC,1994,12,305731,280747,24984,8.2
DC,1995,1,304222,279040,25182,8.3
DC,1995,2,303880,278514,25366,8.3
DC,1995,3,302724,277194,25530,8.4
DC,1995,4,300925,275247,25678,8.5
DC,1995,5,300743,274942,25801,8.6
DC,1995,6,299150,273258,25892,8.7
DC,1995,7,298345,272395,25950,8.7
DC,1995,8,296634,270664,25970,8.8
DC,1995,9,297671,271723,25948,8.7
DC,1995,10,298137,272244,25893,8.7
DC,1995,11,296007,270197,25810,8.7
DC,1995,12,295451,269749,25702,8.7
DC,1996,1,294115,268546,25569,8.7
DC,1996,2,295237,269810,25427,8.6
DC,1996,3,292973,267679,25294,8.6
DC,1996,4,289770,264615,25155,8.7
DC,1996,5,289618,264607,25011,8.6
DC,1996,6,288655,263795,24860,8.6
DC,1996,7,289109,264400,24709,8.5
DC,1996,8,287989,263435,24554,8.5
DC,1996,9,289624,265233,24391,8.4
DC,1996,10,289508,265282,24226,8.4
DC,1996,11,289908,265844,24064,8.3
DC,1996,12,289479,265567,23912,8.3
DC,1997,1,288557,264790,23767,8.2
DC,1997,2,287497,263831,23666,8.2
DC,1997,3,287994,264393,23601,8.2
DC,1997,4,285850,262276,23574,8.2
DC,1997,5,285388,261805,23583,8.3
DC,1997,6,281816,258194,23622,8.4
DC,1997,7,285200,261515,23685,8.3
DC,1997,8,286002,262242,23760,8.3
DC,1997,9,287617,263775,23842,8.3
DC,1997,10,285897,261974,23923,8.4
DC,1997,11,287431,263429,24002,8.4
DC,1997,12,289321,265242,24079,8.3
DC,1998,1,290458,266311,24147,8.3
DC,1998,2,291445,267271,24174,8.3
DC,1998,3,292385,268232,24153,8.3
DC,1998,4,295197,271112,24085,8.2
DC,1998,5,295377,271391,23986,8.1
DC,1998,6,294697,270838,23859,8.1
DC,1998,7,292254,268558,23696,8.1
DC,1998,8,293320,269818,23502,8
DC,1998,9,293489,270215,23274,7.9
DC,1998,10,294303,271298,23005,7.8
DC,1998,11,295225,272525,22700,7.7
DC,1998,12,297690,275330,22360,7.5
DC,1999,1,300511,278518,21993,7.3
DC,1999,2,303333,281709,21624,7.1
DC,1999,3,303723,282469,21254,7
DC,1999,4,306904,286014,20890,6.8
DC,1999,5,308548,288016,20532,6.7
DC,1999,6,309751,289570,20181,6.5
DC,1999,7,309709,289871,19838,6.4
DC,1999,8,310690,291183,19507,6.3
DC,1999,9,309830,290644,19186,6.2
DC,1999,10,311471,292589,18882,6.1
DC,1999,11,311521,292921,18600,6
DC,1999,12,311032,292691,18341,5.9
DC,2000,1,308384,290537,17847,5.8
DC,2000,2,309113,291472,17641,5.7
DC,2000,3,308593,291119,17474,5.7
DC,2000,4,309043,291691,17352,5.6
DC,2000,5,308021,290748,17273,5.6
DC,2000,6,308344,291101,17243,5.6
DC,2000,7,307926,290664,17262,5.6
DC,2000,8,308929,291600,17329,5.6
DC,2000,9,310232,292791,17441,5.6
DC,2000,10,310862,293286,17576,5.7
DC,2000,11,312510,294782,17728,5.7
DC,2000,12,311101,293202,17899,5.8
DC,2001,1,310023,291937,18086,5.8
DC,2001,2,307643,289366,18277,5.9
DC,2001,3,305830,287356,18474,6
DC,2001,4,305696,287020,18676,6.1
DC,2001,5,306500,287613,18887,6.2
DC,2001,6,305221,286119,19102,6.3
DC,2001,7,305514,286204,19310,6.3
DC,2001,8,306532,287018,19514,6.4
DC,2001,9,305365,285662,19703,6.5
DC,2001,10,305096,285224,19872,6.5
DC,2001,11,303158,283149,20009,6.6
DC,2001,12,303220,283117,20103,6.6
DC,2002,1,306993,286542,20451,6.7
DC,2002,2,305754,285238,20516,6.7
DC,2002,3,306701,286140,20561,6.7
DC,2002,4,307467,286879,20588,6.7
DC,2002,5,305841,285243,20598,6.7
DC,2002,6,304939,284346,20593,6.8
DC,2002,7,305540,284942,20598,6.7
DC,2002,8,304490,283886,20604,6.8
DC,2002,9,304370,283753,20617,6.8
DC,2002,10,302643,282004,20639,6.8
DC,2002,11,303952,283280,20672,6.8
DC,2002,12,303844,283126,20718,6.8
DC,2003,1,304718,283874,20844,6.8
DC,2003,2,305078,284153,20925,6.9
DC,2003,3,306987,285970,21017,6.8
DC,2003,4,305765,284638,21127,6.9
DC,2003,5,307647,286397,21250,6.9
DC,2003,6,307947,286556,21391,6.9
DC,2003,7,307989,286448,21541,7
DC,2003,8,305903,284203,21700,7.1
DC,2003,9,308569,286695,21874,7.1
DC,2003,10,308740,286668,22072,7.1
DC,2003,11,307676,285388,22288,7.2
DC,2003,12,305864,283342,22522,7.4
DC,2004,1,309485,286724,22761,7.4
DC,2004,2,310723,287722,23001,7.4
DC,2004,3,310188,286966,23222,7.5
DC,2004,4,310306,286892,23414,7.5
DC,2004,5,310051,286481,23570,7.6
DC,2004,6,310306,286622,23684,7.6
DC,2004,7,308759,285010,23749,7.7
DC,2004,8,311904,288157,23747,7.6
DC,2004,9,313794,290122,23672,7.5
DC,2004,10,314413,290887,23526,7.5
DC,2004,11,315020,291712,23308,7.4
DC,2004,12,316494,293472,23022,7.3
DC,2005,1,318742,296070,22672,7.1
DC,2005,2,319106,296803,22303,7
DC,2005,3,318737,296804,21933,6.9
DC,2005,4,318714,297151,21563,6.8
DC,2005,5,316762,295564,21198,6.7
DC,2005,6,317537,296701,20836,6.6
DC,2005,7,318719,298237,20482,6.4
DC,2005,8,319390,299236,20154,6.3
DC,2005,9,319423,299565,19858,6.2
DC,2005,10,317686,298089,19597,6.2
DC,2005,11,317793,298422,19371,6.1
DC,2005,12,319055,299873,19182,6
DC,2006,1,320241,301212,19029,5.9
DC,2006,2,320401,301504,18897,5.9
DC,2006,3,318934,300145,18789,5.9
DC,2006,4,317634,298936,18698,5.9
DC,2006,5,320463,301842,18621,5.8
DC,2006,6,323544,304987,18557,5.7
DC,2006,7,321261,302758,18503,5.8
DC,2006,8,321001,302545,18456,5.7
DC,2006,9,321127,302724,18403,5.7
DC,2006,10,324256,305929,18327,5.7
DC,2006,11,324188,305967,18221,5.6
DC,2006,12,324259,306169,18090,5.6
DC,2007,1,325454,307511,17943,5.5
DC,2007,2,326763,308938,17825,5.5
DC,2007,3,326868,309127,17741,5.4
DC,2007,4,327289,309590,17699,5.4
DC,2007,5,327013,309310,17703,5.4
DC,2007,6,324773,307019,17754,5.5
DC,2007,7,324634,306781,17853,5.5
DC,2007,8,326329,308320,18009,5.5
DC,2007,9,327430,309212,18218,5.6
DC,2007,10,328922,310441,18481,5.6
DC,2007,11,330480,311677,18803,5.7
DC,2007,12,330658,311468,19190,5.8
DC,2008,1,330552,310903,19649,5.9
DC,2008,2,332077,311936,20141,6.1
DC,2008,3,332507,311829,20678,6.2
DC,2008,4,332560,311297,21263,6.4
DC,2008,5,332437,310541,21896,6.6
DC,2008,6,331852,309277,22575,6.8
DC,2008,7,333035,309732,23303,7
DC,2008,8,334640,310569,24071,7.2
DC,2008,9,334168,309296,24872,7.4
DC,2008,10,333261,307560,25701,7.7
DC,2008,11,332550,305997,26553,8
DC,2008,12,332805,305402,27403,8.2
DC,2009,1,332289,301532,30757,9.3
FL,1976,1,3572397,3226842,345555,9.7
FL,1976,2,3586826,3237978,348848,9.7
FL,1976,3,3593281,3243791,349490,9.7
FL,1976,4,3597164,3259312,337852,9.4
FL,1976,5,3592805,3269355,323450,9
FL,1976,6,3607761,3275184,332577,9.2
FL,1976,7,3606073,3286228,319845,8.9
FL,1976,8,3617531,3297066,320465,8.9
FL,1976,9,3633369,3304942,328427,9
FL,1976,10,3637877,3307071,330806,9.1
FL,1976,11,3640626,3305411,335215,9.2
FL,1976,12,3654828,3318112,336716,9.2
FL,1977,1,3671427,3331305,340122,9.3
FL,1977,2,3678225,3337254,340971,9.3
FL,1977,3,3690349,3353364,336985,9.1
FL,1977,4,3702975,3377827,325148,8.8
FL,1977,5,3718044,3394579,323465,8.7
FL,1977,6,3719059,3410664,308395,8.3
FL,1977,7,3748819,3449033,299786,8
FL,1977,8,3770459,3474463,295996,7.9
FL,1977,9,3789832,3496403,293429,7.7
FL,1977,10,3810311,3515980,294331,7.7
FL,1977,11,3834435,3539953,294482,7.7
FL,1977,12,3854470,3563560,290910,7.5
FL,1978,1,3883753,3595982,287771,7.4
FL,1978,2,3910516,3628186,282330,7.2
FL,1978,3,3919757,3645021,274736,7
FL,1978,4,3931822,3660190,271632,6.9
FL,1978,5,3947770,3680084,267686,6.8
FL,1978,6,3976674,3714458,262216,6.6
FL,1978,7,3987471,3725467,262004,6.6
FL,1978,8,4006010,3735264,270746,6.8
FL,1978,9,4028008,3757028,270980,6.7
FL,1978,10,4046765,3775831,270934,6.7
FL,1978,11,4064801,3797348,267453,6.6
FL,1978,12,4082130,3814752,267378,6.5
FL,1979,1,4093833,3832288,261545,6.4
FL,1979,2,4101067,3841235,259832,6.3
FL,1979,3,4119223,3863958,255265,6.2
FL,1979,4,4133342,3880516,252826,6.1
FL,1979,5,4136542,3889128,247414,6
FL,1979,6,4148963,3904514,244449,5.9
FL,1979,7,4151747,3901273,250474,6
FL,1979,8,4159604,3909828,249776,6
FL,1979,9,4170172,3921962,248210,6
FL,1979,10,4188410,3937299,251111,6
FL,1979,11,4191588,3945091,246497,5.9
FL,1979,12,4197098,3952054,245044,5.8
FL,1980,1,4216378,3971999,244379,5.8
FL,1980,2,4237363,3992975,244388,5.8
FL,1980,3,4236675,3995860,240815,5.7
FL,1980,4,4244678,3996814,247864,5.8
FL,1980,5,4252791,3999390,253401,6
FL,1980,6,4261980,4004339,257641,6
FL,1980,7,4283961,4019977,263984,6.2
FL,1980,8,4304478,4034225,270253,6.3
FL,1980,9,4323456,4043718,279738,6.5
FL,1980,10,4344904,4063502,281402,6.5
FL,1980,11,4366851,4087674,279177,6.4
FL,1980,12,4391715,4107426,284289,6.5
FL,1981,1,4407982,4117625,290357,6.6
FL,1981,2,4424845,4145695,279150,6.3
FL,1981,3,4450438,4163730,286708,6.4
FL,1981,4,4476586,4187117,289469,6.5
FL,1981,5,4501986,4205454,296532,6.6
FL,1981,6,4520528,4222699,297829,6.6
FL,1981,7,4537556,4230227,307329,6.8
FL,1981,8,4546338,4233405,312933,6.9
FL,1981,9,4567827,4245717,322110,7.1
FL,1981,10,4588255,4256398,331857,7.2
FL,1981,11,4603082,4260557,342525,7.4
FL,1981,12,4617804,4268142,349662,7.6
FL,1982,1,4633655,4278745,354910,7.7
FL,1982,2,4653739,4290366,363373,7.8
FL,1982,3,4670782,4300417,370365,7.9
FL,1982,4,4688245,4309765,378480,8.1
FL,1982,5,4703070,4319966,383104,8.1
FL,1982,6,4716761,4326092,390669,8.3
FL,1982,7,4737739,4338193,399546,8.4
FL,1982,8,4758600,4352054,406546,8.5
FL,1982,9,4762362,4351578,410784,8.6
FL,1982,10,4779029,4356150,422879,8.8
FL,1982,11,4793682,4360614,433068,9
FL,1982,12,4797125,4362867,434258,9.1
FL,1983,1,4807707,4367445,440262,9.2
FL,1983,2,4816736,4369982,446754,9.3
FL,1983,3,4824556,4378806,445750,9.2
FL,1983,4,4847362,4415817,431545,8.9
FL,1983,5,4868483,4435715,432768,8.9
FL,1983,6,4898596,4468292,430304,8.8
FL,1983,7,4926819,4501857,424962,8.6
FL,1983,8,4941746,4526427,415319,8.4
FL,1983,9,4970517,4565218,405299,8.2
FL,1983,10,4980525,4584062,396463,8
FL,1983,11,5001732,4614530,387202,7.7
FL,1983,12,5026508,4650456,376052,7.5
FL,1984,1,5051340,4687175,364165,7.2
FL,1984,2,5071995,4715574,356421,7
FL,1984,3,5091868,4744259,347609,6.8
FL,1984,4,5107333,4760808,346525,6.8
FL,1984,5,5129032,4787446,341586,6.7
FL,1984,6,5142185,4808603,333582,6.5
FL,1984,7,5160542,4827867,332675,6.4
FL,1984,8,5180718,4849349,331369,6.4
FL,1984,9,5202676,4870293,332383,6.4
FL,1984,10,5205956,4874461,331495,6.4
FL,1984,11,5228799,4895582,333217,6.4
FL,1984,12,5243910,4912353,331557,6.3
FL,1985,1,5254906,4926450,328456,6.3
FL,1985,2,5263073,4934553,328520,6.2
FL,1985,3,5276267,4944402,331865,6.3
FL,1985,4,5289549,4954905,334644,6.3
FL,1985,5,5297520,4969935,327585,6.2
FL,1985,6,5298812,4972204,326608,6.2
FL,1985,7,5307169,4980569,326600,6.2
FL,1985,8,5331542,5005758,325784,6.1
FL,1985,9,5341633,5015710,325923,6.1
FL,1985,10,5358307,5034853,323454,6
FL,1985,11,5378613,5054450,324163,6
FL,1985,12,5401784,5078045,323739,6
FL,1986,1,5428773,5105082,323691,6
FL,1986,2,5448133,5128202,319931,5.9
FL,1986,3,5471931,5146275,325656,6
FL,1986,4,5501761,5171045,330716,6
FL,1986,5,5529741,5198138,331603,6
FL,1986,6,5548780,5219459,329321,5.9
FL,1986,7,5572649,5243473,329176,5.9
FL,1986,8,5602154,5275757,326397,5.8
FL,1986,9,5619318,5290412,328906,5.9
FL,1986,10,5646092,5318127,327965,5.8
FL,1986,11,5672525,5342866,329659,5.8
FL,1986,12,5696898,5368788,328110,5.8
FL,1987,1,5713496,5393893,319603,5.6
FL,1987,2,5736371,5415163,321208,5.6
FL,1987,3,5759852,5436754,323098,5.6
FL,1987,4,5784324,5462766,321558,5.6
FL,1987,5,5806390,5484865,321525,5.5
FL,1987,6,5822774,5505927,316847,5.4
FL,1987,7,5850994,5534347,316647,5.4
FL,1987,8,5859705,5546337,313368,5.3
FL,1987,9,5881252,5568757,312495,5.3
FL,1987,10,5909555,5596513,313042,5.3
FL,1987,11,5922085,5606610,315475,5.3
FL,1987,12,5945992,5630336,315656,5.3
FL,1988,1,5956854,5641448,315406,5.3
FL,1988,2,5976674,5661965,314709,5.3
FL,1988,3,5997439,5681255,316184,5.3
FL,1988,4,6009952,5691697,318255,5.3
FL,1988,5,6018414,5704621,313793,5.2
FL,1988,6,6032103,5718632,313471,5.2
FL,1988,7,6043060,5730154,312906,5.2
FL,1988,8,6062671,5745630,317041,5.2
FL,1988,9,6083168,5763019,320149,5.3
FL,1988,10,6108123,5782389,325734,5.3
FL,1988,11,6130888,5800572,330316,5.4
FL,1988,12,6132673,5798566,334107,5.4
FL,1989,1,6139714,5802335,337379,5.5
FL,1989,2,6149734,5812370,337364,5.5
FL,1989,3,6170486,5826581,343905,5.6
FL,1989,4,6181518,5830233,351285,5.7
FL,1989,5,6195745,5838225,357520,5.8
FL,1989,6,6222736,5863456,359280,5.8
FL,1989,7,6233144,5875334,357810,5.7
FL,1989,8,6251939,5891573,360366,5.8
FL,1989,9,6263499,5903934,359565,5.7
FL,1989,10,6280296,5914952,365344,5.8
FL,1989,11,6299655,5931029,368626,5.9
FL,1989,12,6327445,5956157,371288,5.9
FL,1990,1,6371320,5991447,379873,6
FL,1990,2,6400440,6015268,385172,6
FL,1990,3,6427465,6037132,390333,6.1
FL,1990,4,6440956,6045825,395131,6.1
FL,1990,5,6460660,6061549,399111,6.2
FL,1990,6,6470719,6069512,401207,6.2
FL,1990,7,6476410,6075646,400764,6.2
FL,1990,8,6489742,6081778,407964,6.3
FL,1990,9,6499968,6087409,412559,6.3
FL,1990,10,6512776,6092947,419829,6.4
FL,1990,11,6520044,6091101,428943,6.6
FL,1990,12,6516444,6082314,434130,6.7
FL,1991,1,6500629,6059572,441057,6.8
FL,1991,2,6513991,6042819,471172,7.2
FL,1991,3,6518785,6038156,480629,7.4
FL,1991,4,6526544,6039050,487494,7.5
FL,1991,5,6535952,6045114,490838,7.5
FL,1991,6,6545077,6047333,497744,7.6
FL,1991,7,6558455,6056915,501540,7.6
FL,1991,8,6573870,6072013,501857,7.6
FL,1991,9,6571158,6065504,505654,7.7
FL,1991,10,6577436,6063209,514227,7.8
FL,1991,11,6589270,6069516,519754,7.9
FL,1991,12,6608926,6063858,545068,8.2
FL,1992,1,6634551,6075120,559431,8.4
FL,1992,2,6654066,6081731,572335,8.6
FL,1992,3,6677069,6104594,572475,8.6
FL,1992,4,6677047,6104504,572543,8.6
FL,1992,5,6693318,6114315,579003,8.7
FL,1992,6,6709944,6125302,584642,8.7
FL,1992,7,6730561,6139318,591243,8.8
FL,1992,8,6735412,6138356,597056,8.9
FL,1992,9,6756929,6153547,603382,8.9
FL,1992,10,6671156,6178931,492225,7.4
FL,1992,11,6678956,6185816,493140,7.4
FL,1992,12,6692093,6199473,492620,7.4
FL,1993,1,6713848,6215496,498352,7.4
FL,1993,2,6733459,6238904,494555,7.3
FL,1993,3,6737819,6244665,493154,7.3
FL,1993,4,6770357,6277527,492830,7.3
FL,1993,5,6781105,6287069,494036,7.3
FL,1993,6,6790471,6298021,492450,7.3
FL,1993,7,6801953,6310320,491633,7.2
FL,1993,8,6800152,6310260,489892,7.2
FL,1993,9,6805667,6321333,484334,7.1
FL,1993,10,6829734,6344987,484747,7.1
FL,1993,11,6837448,6352504,484944,7.1
FL,1993,12,6858345,6376612,481733,7
FL,1994,1,6875827,6398054,477773,6.9
FL,1994,2,6890137,6416734,473403,6.9
FL,1994,3,6909381,6436989,472392,6.8
FL,1994,4,6932074,6464497,467577,6.7
FL,1994,5,6948283,6483011,465272,6.7
FL,1994,6,6962324,6500336,461988,6.6
FL,1994,7,6974630,6514922,459708,6.6
FL,1994,8,6982105,6527655,454450,6.5
FL,1994,9,6992353,6548129,444224,6.4
FL,1994,10,6990983,6554626,436357,6.2
FL,1994,11,7016323,6588961,427362,6.1
FL,1994,12,7003881,6586359,417522,6
FL,1995,1,7003503,6592448,411055,5.9
FL,1995,2,7012267,6609901,402366,5.7
FL,1995,3,7016722,6619506,397216,5.7
FL,1995,4,7020715,6622421,398294,5.7
FL,1995,5,7030000,6631387,398613,5.7
FL,1995,6,7044704,6641845,402859,5.7
FL,1995,7,7046974,6643474,403500,5.7
FL,1995,8,7054860,6652597,402263,5.7
FL,1995,9,7071509,6671103,400406,5.7
FL,1995,10,7081232,6681310,399922,5.6
FL,1995,11,7096468,6703213,393255,5.5
FL,1995,12,7122047,6731560,390487,5.5
FL,1996,1,7117669,6728611,389058,5.5
FL,1996,2,7138003,6751058,386945,5.4
FL,1996,3,7169551,6785947,383604,5.4
FL,1996,4,7162017,6779466,382551,5.3
FL,1996,5,7176512,6794035,382477,5.3
FL,1996,6,7186623,6804372,382251,5.3
FL,1996,7,7202590,6817074,385516,5.4
FL,1996,8,7225557,6842173,383384,5.3
FL,1996,9,7240179,6857253,382926,5.3
FL,1996,10,7262138,6882737,379401,5.2
FL,1996,11,7278907,6903874,375033,5.2
FL,1996,12,7296192,6923604,372588,5.1
FL,1997,1,7319106,6949054,370052,5.1
FL,1997,2,7326737,6957732,369005,5
FL,1997,3,7337944,6967243,370701,5.1
FL,1997,4,7370789,6998120,372669,5.1
FL,1997,5,7395527,7022054,373473,5
FL,1997,6,7406871,7032870,374001,5
FL,1997,7,7425569,7052086,373483,5
FL,1997,8,7449361,7076094,373267,5
FL,1997,9,7462226,7093222,369004,4.9
FL,1997,10,7459985,7100757,359228,4.8
FL,1997,11,7467995,7109823,358172,4.8
FL,1997,12,7484242,7128868,355374,4.7
FL,1998,1,7510228,7156552,353676,4.7
FL,1998,2,7518771,7168956,349815,4.7
FL,1998,3,7523735,7173585,350150,4.7
FL,1998,4,7529148,7180681,348467,4.6
FL,1998,5,7539328,7194180,345148,4.6
FL,1998,6,7560287,7216694,343593,4.5
FL,1998,7,7577896,7235579,342317,4.5
FL,1998,8,7584347,7244279,340068,4.5
FL,1998,9,7605476,7269061,336415,4.4
FL,1998,10,7627993,7298839,329154,4.3
FL,1998,11,7641228,7317418,323810,4.2
FL,1998,12,7653145,7332321,320824,4.2
FL,1999,1,7652019,7331613,320406,4.2
FL,1999,2,7669060,7350740,318320,4.2
FL,1999,3,7676842,7359602,317240,4.1
FL,1999,4,7691028,7376893,314135,4.1
FL,1999,5,7706111,7391913,314198,4.1
FL,1999,6,7729571,7419134,310437,4
FL,1999,7,7707746,7399999,307747,4
FL,1999,8,7699746,7391742,308004,4
FL,1999,9,7720390,7417226,303164,3.9
FL,1999,10,7746029,7443636,302393,3.9
FL,1999,11,7761603,7461099,300504,3.9
FL,1999,12,7771706,7476305,295401,3.8
FL,2000,1,7798213,7504143,294070,3.8
FL,2000,2,7804072,7509248,294824,3.8
FL,2000,3,7819786,7525439,294347,3.8
FL,2000,4,7838086,7541237,296849,3.8
FL,2000,5,7854593,7556698,297895,3.8
FL,2000,6,7866344,7561342,305002,3.9
FL,2000,7,7889134,7589312,299822,3.8
FL,2000,8,7901011,7597668,303343,3.8
FL,2000,9,7901995,7598479,303516,3.8
FL,2000,10,7907957,7604811,303146,3.8
FL,2000,11,7920834,7617936,302898,3.8
FL,2000,12,7934252,7626557,307695,3.9
FL,2001,1,7932834,7616775,316059,4
FL,2001,2,7953234,7632672,320562,4
FL,2001,3,7972002,7645798,326204,4.1
FL,2001,4,7980392,7643807,336585,4.2
FL,2001,5,7991933,7648400,343533,4.3
FL,2001,6,8006561,7659274,347287,4.3
FL,2001,7,8025766,7675203,350563,4.4
FL,2001,8,8057386,7704416,352970,4.4
FL,2001,9,8056587,7704181,352406,4.4
FL,2001,10,7991300,7518331,472969,5.9
FL,2001,11,7999351,7521446,477905,6
FL,2001,12,8009395,7526313,483082,6
FL,2002,1,8069817,7587685,482132,6
FL,2002,2,8072286,7597415,474871,5.9
FL,2002,3,8084868,7615282,469586,5.8
FL,2002,4,8096683,7630104,466579,5.8
FL,2002,5,8109965,7645477,464488,5.7
FL,2002,6,8116091,7653001,463090,5.7
FL,2002,7,8128583,7665197,463386,5.7
FL,2002,8,8143668,7684955,458713,5.6
FL,2002,9,8156896,7702040,454856,5.6
FL,2002,10,8162954,7709465,453489,5.6
FL,2002,11,8171706,7722524,449182,5.5
FL,2002,12,8185635,7736982,448653,5.5
FL,2003,1,8172435,7726584,445851,5.5
FL,2003,2,8176435,7732471,443964,5.4
FL,2003,3,8187137,7744875,442262,5.4
FL,2003,4,8183811,7742198,441613,5.4
FL,2003,5,8197391,7755632,441759,5.4
FL,2003,6,8205591,7765240,440351,5.4
FL,2003,7,8217698,7778396,439302,5.3
FL,2003,8,8231894,7798758,433136,5.3
FL,2003,9,8259079,7831420,427659,5.2
FL,2003,10,8262343,7844174,418169,5.1
FL,2003,11,8256952,7842506,414446,5
FL,2003,12,8274831,7864305,410526,5
FL,2004,1,8290816,7887615,403201,4.9
FL,2004,2,8304691,7901812,402879,4.9
FL,2004,3,8322652,7922688,399964,4.8
FL,2004,4,8352421,7956384,396037,4.7
FL,2004,5,8363253,7969541,393712,4.7
FL,2004,6,8385003,7993606,391397,4.7
FL,2004,7,8407171,8019365,387806,4.6
FL,2004,8,8401823,8018530,383293,4.6
FL,2004,9,8401467,8009698,391769,4.7
FL,2004,10,8448404,8060683,387721,4.6
FL,2004,11,8484605,8106301,378304,4.5
FL,2004,12,8503644,8132200,371444,4.4
FL,2005,1,8513645,8152926,360719,4.2
FL,2005,2,8530517,8176447,354070,4.2
FL,2005,3,8532928,8185111,347817,4.1
FL,2005,4,8575021,8233565,341456,4
FL,2005,5,8597836,8261399,336437,3.9
FL,2005,6,8606788,8275081,331707,3.9
FL,2005,7,8642404,8317863,324541,3.8
FL,2005,8,8671969,8352538,319431,3.7
FL,2005,9,8708865,8392838,316027,3.6
FL,2005,10,8712268,8399638,312630,3.6
FL,2005,11,8731166,8414238,316928,3.6
FL,2005,12,8748315,8441047,307268,3.5
FL,2006,1,8766882,8464050,302832,3.5
FL,2006,2,8785899,8489127,296772,3.4
FL,2006,3,8816254,8521265,294989,3.3
FL,2006,4,8833335,8539405,293930,3.3
FL,2006,5,8859915,8564742,295173,3.3
FL,2006,6,8886385,8590025,296360,3.3
FL,2006,7,8893972,8598234,295738,3.3
FL,2006,8,8923450,8622942,300508,3.4
FL,2006,9,8947604,8643855,303749,3.4
FL,2006,10,8962386,8654526,307860,3.4
FL,2006,11,8986362,8673492,312870,3.5
FL,2006,12,9008705,8691118,317587,3.5
FL,2007,1,9025163,8702479,322684,3.6
FL,2007,2,9041015,8714933,326082,3.6
FL,2007,3,9062922,8730857,332065,3.7
FL,2007,4,9069625,8729404,340221,3.8
FL,2007,5,9079230,8729961,349269,3.8
FL,2007,6,9093429,8730783,362646,4
FL,2007,7,9083466,8711991,371475,4.1
FL,2007,8,9100237,8716696,383541,4.2
FL,2007,9,9103957,8708617,395340,4.3
FL,2007,10,9108041,8697297,410744,4.5
FL,2007,11,9141494,8716188,425306,4.7
FL,2007,12,9152694,8712374,440320,4.8
FL,2008,1,9154682,8697799,456883,5
FL,2008,2,9163690,8687669,476021,5.2
FL,2008,3,9163303,8668823,494480,5.4
FL,2008,4,9168770,8655202,513568,5.6
FL,2008,5,9182221,8648114,534107,5.8
FL,2008,6,9198453,8643440,555013,6
FL,2008,7,9240335,8658677,581658,6.3
FL,2008,8,9253078,8651884,601194,6.5
FL,2008,9,9277652,8659731,617921,6.7
FL,2008,10,9316739,8672133,644606,6.9
FL,2008,11,9315998,8641106,674892,7.2
FL,2008,12,9342620,8633693,708927,7.6
FL,2009,1,9255986,8455510,800476,8.6
GA,1976,1,2239739,2055613,184126,8.2
GA,1976,2,2243888,2061087,182801,8.1
GA,1976,3,2249974,2066509,183465,8.2
GA,1976,4,2256524,2071989,184535,8.2
GA,1976,5,2261503,2077551,183952,8.1
GA,1976,6,2265379,2083171,182208,8
GA,1976,7,2269440,2088830,180610,8
GA,1976,8,2276272,2094437,181835,8
GA,1976,9,2282912,2099994,182918,8
GA,1976,10,2290883,2105638,185245,8.1
GA,1976,11,2298181,2111549,186632,8.1
GA,1976,12,2302635,2117800,184835,8
GA,1977,1,2306804,2124468,182336,7.9
GA,1977,2,2317465,2131471,185994,8
GA,1977,3,2313876,2138887,174989,7.6
GA,1977,4,2314291,2146572,167719,7.2
GA,1977,5,2317556,2154457,163099,7
GA,1977,6,2320682,2162536,158146,6.8
GA,1977,7,2328622,2170781,157841,6.8
GA,1977,8,2336324,2179103,157221,6.7
GA,1977,9,2338562,2187578,150984,6.5
GA,1977,10,2345415,2196222,149193,6.4
GA,1977,11,2355975,2205074,150901,6.4
GA,1977,12,2356884,2214346,142538,6
GA,1978,1,2362482,2223916,138566,5.9
GA,1978,2,2368692,2233491,135201,5.7
GA,1978,3,2378309,2243039,135270,5.7
GA,1978,4,2388188,2252550,135638,5.7
GA,1978,5,2399305,2261723,137582,5.7
GA,1978,6,2407994,2270563,137431,5.7
GA,1978,7,2416560,2278950,137610,5.7
GA,1978,8,2433724,2286863,146861,6
GA,1978,9,2435851,2294384,141467,5.8
GA,1978,10,2437652,2301569,136083,5.6
GA,1978,11,2447160,2308475,138685,5.7
GA,1978,12,2450642,2314979,135663,5.5
GA,1979,1,2452872,2321035,131837,5.4
GA,1979,2,2458962,2326590,132372,5.4
GA,1979,3,2462004,2331662,130342,5.3
GA,1979,4,2465295,2336224,129071,5.2
GA,1979,5,2465210,2340436,124774,5.1
GA,1979,6,2470609,2344210,126399,5.1
GA,1979,7,2470033,2347465,122568,5
GA,1979,8,2477695,2350574,127121,5.1
GA,1979,9,2475044,2353544,121500,4.9
GA,1979,10,2484576,2356270,128306,5.2
GA,1979,11,2484052,2358516,125536,5.1
GA,1979,12,2494402,2360102,134300,5.4
GA,1980,1,2497337,2361117,136220,5.5
GA,1980,2,2503733,2362167,141566,5.7
GA,1980,3,2510097,2363156,146941,5.9
GA,1980,4,2519218,2364156,155062,6.2
GA,1980,5,2527337,2365420,161917,6.4
GA,1980,6,2538983,2367089,171894,6.8
GA,1980,7,2545158,2369544,175614,6.9
GA,1980,8,2542123,2372806,169317,6.7
GA,1980,9,2540945,2376715,164230,6.5
GA,1980,10,2541573,2381095,160478,6.3
GA,1980,11,2542317,2385812,156505,6.2
GA,1980,12,2544123,2390738,153385,6
GA,1981,1,2550722,2395659,155063,6.1
GA,1981,2,2564957,2399936,165021,6.4
GA,1981,3,2563312,2403826,159486,6.2
GA,1981,4,2568533,2407244,161289,6.3
GA,1981,5,2571495,2410181,161314,6.3
GA,1981,6,2574432,2412709,161723,6.3
GA,1981,7,2577571,2414875,162696,6.3
GA,1981,8,2581584,2416703,164881,6.4
GA,1981,9,2590592,2418099,172493,6.7
GA,1981,10,2600771,2419183,181588,7
GA,1981,11,2605162,2419982,185180,7.1
GA,1981,12,2614690,2420607,194083,7.4
GA,1982,1,2620283,2421249,199034,7.6
GA,1982,2,2610036,2422117,187919,7.2
GA,1982,3,2614945,2422932,192013,7.3
GA,1982,4,2618108,2423696,194412,7.4
GA,1982,5,2623282,2424401,198881,7.6
GA,1982,6,2625332,2425084,200248,7.6
GA,1982,7,2626362,2425815,200547,7.6
GA,1982,8,2623037,2426722,196315,7.5
GA,1982,9,2633281,2427833,205448,7.8
GA,1982,10,2640856,2429276,211580,8
GA,1982,11,2649504,2431120,218384,8.2
GA,1982,12,2654737,2433443,221294,8.3
GA,1983,1,2655326,2436198,219128,8.3
GA,1983,2,2658259,2440032,218227,8.2
GA,1983,3,2659563,2444941,214622,8.1
GA,1983,4,2661424,2450954,210470,7.9
GA,1983,5,2666200,2457951,208249,7.8
GA,1983,6,2666594,2466009,200585,7.5
GA,1983,7,2676736,2475062,201674,7.5
GA,1983,8,2683094,2485029,198065,7.4
GA,1983,9,2691709,2496146,195563,7.3
GA,1983,10,2698181,2508052,190129,7
GA,1983,11,2705433,2520868,184565,6.8
GA,1983,12,2714857,2534662,180195,6.6
GA,1984,1,2725823,2549404,176419,6.5
GA,1984,2,2735611,2563504,172107,6.3
GA,1984,3,2748263,2576925,171338,6.2
GA,1984,4,2758376,2589662,168714,6.1
GA,1984,5,2766549,2601753,164796,6
GA,1984,6,2776949,2613098,163851,5.9
GA,1984,7,2790101,2623504,166597,6
GA,1984,8,2797692,2632829,164863,5.9
GA,1984,9,2808076,2640976,167100,6
GA,1984,10,2815149,2648151,166998,5.9
GA,1984,11,2822504,2654567,167937,5.9
GA,1984,12,2830435,2660119,170316,6
GA,1985,1,2837074,2664735,172339,6.1
GA,1985,2,2849089,2669682,179407,6.3
GA,1985,3,2855347,2675119,180228,6.3
GA,1985,4,2864190,2680948,183242,6.4
GA,1985,5,2874442,2687105,187337,6.5
GA,1985,6,2879320,2693581,185739,6.5
GA,1985,7,2884816,2700448,184368,6.4
GA,1985,8,2889815,2707768,182047,6.3
GA,1985,9,2896388,2715529,180859,6.2
GA,1985,10,2901738,2723705,178033,6.1
GA,1985,11,2907433,2732211,175222,6
GA,1985,12,2916172,2741081,175091,6
GA,1986,1,2921402,2750390,171012,5.9
GA,1986,2,2933747,2759581,174166,5.9
GA,1986,3,2944016,2768685,175331,6
GA,1986,4,2954361,2777724,176637,6
GA,1986,5,2964929,2786553,178376,6
GA,1986,6,2970954,2795245,175709,5.9
GA,1986,7,2982567,2803928,178639,6
GA,1986,8,2988081,2812640,175441,5.9
GA,1986,9,2995654,2821293,174361,5.8
GA,1986,10,3002656,2829943,172713,5.8
GA,1986,11,3010052,2838386,171666,5.7
GA,1986,12,3017805,2846713,171092,5.7
GA,1987,1,3026091,2855006,171085,5.7
GA,1987,2,3034491,2863278,171213,5.6
GA,1987,3,3042615,2871513,171102,5.6
GA,1987,4,3046034,2879849,166185,5.5
GA,1987,5,3052476,2888329,164147,5.4
GA,1987,6,3064137,2896862,167275,5.5
GA,1987,7,3074434,2905489,168945,5.5
GA,1987,8,3084798,2914036,170762,5.5
GA,1987,9,3096268,2922523,173745,5.6
GA,1987,10,3103365,2930877,172488,5.6
GA,1987,11,3110164,2938961,171203,5.5
GA,1987,12,3119241,2946851,172390,5.5
GA,1988,1,3134771,2954485,180286,5.8
GA,1988,2,3138405,2962002,176403,5.6
GA,1988,3,3146910,2969400,177510,5.6
GA,1988,4,3155454,2976564,178890,5.7
GA,1988,5,3160856,2983508,177348,5.6
GA,1988,6,3163533,2990371,173162,5.5
GA,1988,7,3169508,2997080,172428,5.4
GA,1988,8,3178230,3003583,174647,5.5
GA,1988,9,3183852,3009983,173869,5.5
GA,1988,10,3187493,3016327,171166,5.4
GA,1988,11,3191668,3022726,168942,5.3
GA,1988,12,3199165,3029041,170124,5.3
GA,1989,1,3205044,3035326,169718,5.3
GA,1989,2,3209248,3041446,167802,5.2
GA,1989,3,3222678,3047304,175374,5.4
GA,1989,4,3229266,3053206,176060,5.5
GA,1989,5,3230813,3059390,171423,5.3
GA,1989,6,3240384,3065798,174586,5.4
GA,1989,7,3242827,3072381,170446,5.3
GA,1989,8,3252477,3079003,173474,5.3
GA,1989,9,3255374,3085601,169773,5.2
GA,1989,10,3262624,3092089,170535,5.2
GA,1989,11,3270283,3098466,171817,5.3
GA,1989,12,3270761,3104806,165955,5.1
GA,1990,1,3280087,3110973,169114,5.2
GA,1990,2,3284365,3116699,167666,5.1
GA,1990,3,3290440,3121866,168574,5.1
GA,1990,4,3295179,3126285,168894,5.1
GA,1990,5,3298284,3130083,168201,5.1
GA,1990,6,3301639,3133169,168470,5.1
GA,1990,7,3305973,3135325,170648,5.2
GA,1990,8,3305478,3136585,168893,5.1
GA,1990,9,3310312,3136850,173462,5.2
GA,1990,10,3309441,3136264,173177,5.2
GA,1990,11,3310311,3135134,175177,5.3
GA,1990,12,3310116,3133433,176683,5.3
GA,1991,1,3310355,3131302,179053,5.4
GA,1991,2,3316059,3129558,186501,5.6
GA,1991,3,3314355,3128463,185892,5.6
GA,1991,4,3306892,3128004,178888,5.4
GA,1991,5,3300569,3128218,172351,5.2
GA,1991,6,3294970,3128925,166045,5
GA,1991,7,3287326,3130000,157326,4.8
GA,1991,8,3284911,3131658,153253,4.7
GA,1991,9,3286859,3133846,153013,4.7
GA,1991,10,3288865,3136621,152244,4.6
GA,1991,11,3292251,3140151,152100,4.6
GA,1991,12,3300572,3144412,156160,4.7
GA,1992,1,3310156,3149362,160794,4.9
GA,1992,2,3399868,3154592,245276,7.2
GA,1992,3,3401601,3160205,241396,7.1
GA,1992,4,3405026,3166102,238924,7
GA,1992,5,3408939,3172204,236735,6.9
GA,1992,6,3414589,3178474,236115,6.9
GA,1992,7,3416523,3185020,231503,6.8
GA,1992,8,3426477,3191626,234851,6.9
GA,1992,9,3428801,3198409,230392,6.7
GA,1992,10,3433651,3205384,228267,6.6
GA,1992,11,3438002,3212395,225607,6.6
GA,1992,12,3441308,3219544,221764,6.4
GA,1993,1,3446619,3226882,219737,6.4
GA,1993,2,3449766,3234688,215078,6.2
GA,1993,3,3459303,3242901,216402,6.3
GA,1993,4,3460593,3251750,208843,6
GA,1993,5,3466934,3260987,205947,5.9
GA,1993,6,3475466,3270772,204694,5.9
GA,1993,7,3483499,3281220,202279,5.8
GA,1993,8,3494426,3292000,202426,5.8
GA,1993,9,3504972,3303258,201714,5.8
GA,1993,10,3517681,3315019,202662,5.8
GA,1993,11,3528577,3326943,201634,5.7
GA,1993,12,3539275,3339113,200162,5.7
GA,1994,1,3549358,3351531,197827,5.6
GA,1994,2,3557597,3363619,193978,5.5
GA,1994,3,3565232,3375392,189840,5.3
GA,1994,4,3571602,3386862,184740,5.2
GA,1994,5,3580829,3397962,182867,5.1
GA,1994,6,3589083,3408822,180261,5
GA,1994,7,3605346,3419491,185855,5.2
GA,1994,8,3606871,3429934,176937,4.9
GA,1994,9,3615449,3440119,175330,4.8
GA,1994,10,3625074,3449956,175118,4.8
GA,1994,11,3631379,3459392,171987,4.7
GA,1994,12,3638373,3468197,170176,4.7
GA,1995,1,3643517,3476405,167112,4.6
GA,1995,2,3655117,3484524,170593,4.7
GA,1995,3,3663560,3492663,170897,4.7
GA,1995,4,3676138,3500777,175361,4.8
GA,1995,5,3686806,3509000,177806,4.8
GA,1995,6,3698016,3517365,180651,4.9
GA,1995,7,3710641,3525802,184839,5
GA,1995,8,3717196,3534717,182479,4.9
GA,1995,9,3725088,3543947,181141,4.9
GA,1995,10,3734567,3553359,181208,4.9
GA,1995,11,3739540,3563119,176421,4.7
GA,1995,12,3746543,3573187,173356,4.6
GA,1996,1,3756534,3583563,172971,4.6
GA,1996,2,3762380,3594066,168314,4.5
GA,1996,3,3774562,3604498,170064,4.5
GA,1996,4,3786846,3614828,172018,4.5
GA,1996,5,3796469,3625005,171464,4.5
GA,1996,6,3806186,3634835,171351,4.5
GA,1996,7,3816433,3644205,172228,4.5
GA,1996,8,3828458,3653268,175190,4.6
GA,1996,9,3840327,3662200,178127,4.6
GA,1996,10,3851207,3671340,179867,4.7
GA,1996,11,3862504,3680681,181823,4.7
GA,1996,12,3872990,3690134,182856,4.7
GA,1997,1,3879819,3699701,180118,4.6
GA,1997,2,3889607,3709199,180408,4.6
GA,1997,3,3895564,3718660,176904,4.5
GA,1997,4,3903195,3728036,175159,4.5
GA,1997,5,3914633,3737345,177288,4.5
GA,1997,6,3921710,3746635,175075,4.5
GA,1997,7,3930823,3756055,174768,4.4
GA,1997,8,3940620,3765596,175024,4.4
GA,1997,9,3949571,3775331,174240,4.4
GA,1997,10,3954841,3785043,169798,4.3
GA,1997,11,3966034,3794642,171392,4.3
GA,1997,12,3975196,3804145,171051,4.3
GA,1998,1,3980599,3813343,167256,4.2
GA,1998,2,3991814,3822312,169502,4.2
GA,1998,3,3998955,3831174,167781,4.2
GA,1998,4,4008701,3840012,168689,4.2
GA,1998,5,4017827,3848908,168919,4.2
GA,1998,6,4026218,3857805,168413,4.2
GA,1998,7,4036999,3866617,170382,4.2
GA,1998,8,4042456,3875306,167150,4.1
GA,1998,9,4051032,3883843,167189,4.1
GA,1998,10,4058321,3892175,166146,4.1
GA,1998,11,4066355,3900253,166102,4.1
GA,1998,12,4071669,3908008,163661,4
GA,1999,1,4074696,3915517,159179,3.9
GA,1999,2,4083301,3922822,160479,3.9
GA,1999,3,4088367,3929844,158523,3.9
GA,1999,4,4092773,3936706,156067,3.8
GA,1999,5,4098154,3943394,154760,3.8
GA,1999,6,4103876,3949908,153968,3.8
GA,1999,7,4109762,3956105,153657,3.7
GA,1999,8,4117855,3962075,155780,3.8
GA,1999,9,4123494,3967917,155577,3.8
GA,1999,10,4124587,3973517,151070,3.7
GA,1999,11,4128551,3978779,149772,3.6
GA,1999,12,4134721,3983625,151096,3.7
GA,2000,1,4142307,3994420,147887,3.6
GA,2000,2,4227886,4081623,146263,3.5
GA,2000,3,4234812,4087828,146984,3.5
GA,2000,4,4241337,4093612,147725,3.5
GA,2000,5,4248335,4098956,149379,3.5
GA,2000,6,4253210,4103661,149549,3.5
GA,2000,7,4253434,4107772,145662,3.4
GA,2000,8,4261929,4111143,150786,3.5
GA,2000,9,4263118,4113842,149276,3.5
GA,2000,10,4262134,4115891,146243,3.4
GA,2000,11,4261319,4117332,143987,3.4
GA,2000,12,4264842,4118261,146581,3.4
GA,2001,1,4269905,4118575,151330,3.5
GA,2001,2,4270593,4118280,152313,3.6
GA,2001,3,4271904,4117428,154476,3.6
GA,2001,4,4275118,4116057,159061,3.7
GA,2001,5,4274927,4114612,160315,3.8
GA,2001,6,4278514,4113272,165242,3.9
GA,2001,7,4280725,4112012,168713,3.9
GA,2001,8,4283521,4110885,172636,4
GA,2001,9,4287052,4109734,177318,4.1
GA,2001,10,4296282,4108628,187654,4.4
GA,2001,11,4303358,4107749,195609,4.5
GA,2001,12,4305979,4107188,198791,4.6
GA,2002,1,4325980,4121070,204910,4.7
GA,2002,2,4328083,4122415,205668,4.8
GA,2002,3,4332890,4124469,208421,4.8
GA,2002,4,4336095,4127047,209048,4.8
GA,2002,5,4341463,4129911,211552,4.9
GA,2002,6,4344611,4132922,211689,4.9
GA,2002,7,4345439,4135875,209564,4.8
GA,2002,8,4349740,4139118,210622,4.8
GA,2002,9,4354479,4142586,211893,4.9
GA,2002,10,4358427,4146178,212249,4.9
GA,2002,11,4362068,4149751,212317,4.9
GA,2002,12,4365552,4153231,212321,4.9
GA,2003,1,4362075,4150706,211369,4.8
GA,2003,2,4362419,4153967,208452,4.8
GA,2003,3,4370382,4157452,212930,4.9
GA,2003,4,4376190,4161162,215028,4.9
GA,2003,5,4380163,4165231,214932,4.9
GA,2003,6,4385060,4169694,215366,4.9
GA,2003,7,4390047,4174593,215454,4.9
GA,2003,8,4386746,4179746,207000,4.7
GA,2003,9,4389214,4185039,204175,4.7
GA,2003,10,4391501,4190280,201221,4.6
GA,2003,11,4394784,4195832,198952,4.5
GA,2003,12,4397602,4201746,195856,4.5
GA,2004,1,4402524,4207166,195358,4.4
GA,2004,2,4403478,4213540,189938,4.3
GA,2004,3,4412588,4220326,192262,4.4
GA,2004,4,4426204,4227366,198838,4.5
GA,2004,5,4440459,4234690,205769,4.6
GA,2004,6,4454082,4242463,211619,4.8
GA,2004,7,4463792,4250762,213030,4.8
GA,2004,8,4478933,4259319,219614,4.9
GA,2004,9,4490229,4268272,221957,4.9
GA,2004,10,4503302,4277938,225364,5
GA,2004,11,4516936,4287930,229006,5.1
GA,2004,12,4529127,4298318,230809,5.1
GA,2005,1,4539086,4309179,229907,5.1
GA,2005,2,4554046,4320207,233839,5.1
GA,2005,3,4566123,4331492,234631,5.1
GA,2005,4,4581121,4343321,237800,5.2
GA,2005,5,4598162,4355116,243046,5.3
GA,2005,6,4610787,4366864,243923,5.3
GA,2005,7,4622640,4378825,243815,5.3
GA,2005,8,4634420,4390883,243537,5.3
GA,2005,9,4654017,4402916,251101,5.4
GA,2005,10,4658906,4414916,243990,5.2
GA,2005,11,4668081,4427105,240976,5.2
GA,2005,12,4675629,4439352,236277,5.1
GA,2006,1,4682121,4451647,230474,4.9
GA,2006,2,4687402,4463438,223964,4.8
GA,2006,3,4692536,4474722,217814,4.6
GA,2006,4,4704169,4485433,218736,4.6
GA,2006,5,4716963,4495592,221371,4.7
GA,2006,6,4726243,4505290,220953,4.7
GA,2006,7,4732286,4514516,217770,4.6
GA,2006,8,4740502,4523500,217002,4.6
GA,2006,9,4749661,4532327,217334,4.6
GA,2006,10,4759952,4540972,218980,4.6
GA,2006,11,4763441,4549126,214315,4.5
GA,2006,12,4769424,4556661,212763,4.5
GA,2007,1,4769550,4563486,206064,4.3
GA,2007,2,4771479,4569297,202182,4.2
GA,2007,3,4777396,4574086,203310,4.3
GA,2007,4,4786644,4577826,208818,4.4
GA,2007,5,4792239,4580778,211461,4.4
GA,2007,6,4797945,4582944,215001,4.5
GA,2007,7,4802725,4584309,218416,4.5
GA,2007,8,4806015,4584924,221091,4.6
GA,2007,9,4811983,4584691,227292,4.7
GA,2007,10,4816899,4583532,233367,4.8
GA,2007,11,4819691,4581558,238133,4.9
GA,2007,12,4823467,4578505,244962,5.1
GA,2008,1,4827630,4574208,253422,5.2
GA,2008,2,4833087,4569736,263351,5.4
GA,2008,3,4834846,4564957,269889,5.6
GA,2008,4,4838992,4559925,279067,5.8
GA,2008,5,4840682,4554695,285987,5.9
GA,2008,6,4842409,4549264,293145,6.1
GA,2008,7,4845555,4543706,301849,6.2
GA,2008,8,4847831,4537995,309836,6.4
GA,2008,9,4852086,4532174,319912,6.6
GA,2008,10,4859703,4526309,333394,6.9
GA,2008,11,4868341,4520382,347959,7.1
GA,2008,12,4880643,4514751,365892,7.5
GA,2009,1,4819554,4406784,412770,8.6
HI,1976,1,406473,366696,39777,9.8
HI,1976,2,407788,366921,40867,10
HI,1976,3,410170,368455,41715,10.2
HI,1976,4,410274,369903,40371,9.8
HI,1976,5,410115,370861,39254,9.6
HI,1976,6,409455,371916,37539,9.2
HI,1976,7,410040,373393,36647,8.9
HI,1976,8,411885,374316,37569,9.1
HI,1976,9,411271,374423,36848,9
HI,1976,10,411608,375452,36156,8.8
HI,1976,11,412095,376795,35300,8.6
HI,1976,12,411804,378013,33791,8.2
HI,1977,1,415391,380212,35179,8.5
HI,1977,2,415680,381632,34048,8.2
HI,1977,3,416218,383168,33050,7.9
HI,1977,4,415604,384386,31218,7.5
HI,1977,5,416378,385494,30884,7.4
HI,1977,6,418372,387312,31060,7.4
HI,1977,7,418450,387622,30828,7.4
HI,1977,8,417756,387810,29946,7.2
HI,1977,9,419746,388158,31588,7.5
HI,1977,10,422757,388633,34124,8.1
HI,1977,11,422989,388897,34092,8.1
HI,1977,12,422938,390205,32733,7.7
HI,1978,1,420451,390034,30417,7.2
HI,1978,2,420389,390667,29722,7.1
HI,1978,3,420157,391207,28950,6.9
HI,1978,4,420159,392408,27751,6.6
HI,1978,5,420620,392562,28058,6.7
HI,1978,6,422076,393711,28365,6.7
HI,1978,7,422739,394257,28482,6.7
HI,1978,8,423504,395311,28193,6.7
HI,1978,9,425044,396721,28323,6.7
HI,1978,10,425445,397462,27983,6.6
HI,1978,11,425420,398836,26584,6.2
HI,1978,12,424757,398602,26155,6.2
HI,1979,1,425140,399253,25887,6.1
HI,1979,2,425990,400881,25109,5.9
HI,1979,3,426433,402246,24187,5.7
HI,1979,4,428004,402534,25470,6
HI,1979,5,430039,404579,25460,5.9
HI,1979,6,430964,405683,25281,5.9
HI,1979,7,432033,407642,24391,5.6
HI,1979,8,433027,409491,23536,5.4
HI,1979,9,433420,411007,22413,5.2
HI,1979,10,433571,410335,23236,5.4
HI,1979,11,436105,410955,25150,5.8
HI,1979,12,434967,412768,22199,5.1
HI,1980,1,436671,415871,20800,4.8
HI,1980,2,437189,416771,20418,4.7
HI,1980,3,437324,417193,20131,4.6
HI,1980,4,438681,418463,20218,4.6
HI,1980,5,439650,418856,20794,4.7
HI,1980,6,439244,418362,20882,4.8
HI,1980,7,440341,419355,20986,4.8
HI,1980,8,441862,420304,21558,4.9
HI,1980,9,444305,421482,22823,5.1
HI,1980,10,444893,422623,22270,5
HI,1980,11,445680,423787,21893,4.9
HI,1980,12,446172,423966,22206,5
HI,1981,1,447117,424845,22272,5
HI,1981,2,447956,426117,21839,4.9
HI,1981,3,449400,427759,21641,4.8
HI,1981,4,450222,427842,22380,5
HI,1981,5,450781,427867,22914,5.1
HI,1981,6,451533,428788,22745,5
HI,1981,7,452682,429560,23122,5.1
HI,1981,8,453124,429902,23222,5.1
HI,1981,9,453997,430324,23673,5.2
HI,1981,10,454533,429817,24716,5.4
HI,1981,11,454330,429573,24757,5.4
HI,1981,12,455077,429833,25244,5.5
HI,1982,1,455392,429243,26149,5.7
HI,1982,2,456101,429342,26759,5.9
HI,1982,3,456118,429230,26888,5.9
HI,1982,4,456525,429289,27236,6
HI,1982,5,457517,430020,27497,6
HI,1982,6,458576,430828,27748,6.1
HI,1982,7,459611,431681,27930,6.1
HI,1982,8,460221,432609,27612,6
HI,1982,9,461623,434269,27354,5.9
HI,1982,10,463345,436576,26769,5.8
HI,1982,11,464639,437961,26678,5.7
HI,1982,12,467266,438628,28638,6.1
HI,1983,1,468091,439747,28344,6.1
HI,1983,2,468859,439468,29391,6.3
HI,1983,3,469685,440286,29399,6.3
HI,1983,4,469573,440710,28863,6.1
HI,1983,5,470444,442096,28348,6
HI,1983,6,470962,443194,27768,5.9
HI,1983,7,472859,445342,27517,5.8
HI,1983,8,474130,446588,27542,5.8
HI,1983,9,473696,446505,27191,5.7
HI,1983,10,473758,447109,26649,5.6
HI,1983,11,474810,448037,26773,5.6
HI,1983,12,476004,449138,26866,5.6
HI,1984,1,474125,448672,25453,5.4
HI,1984,2,475776,450123,25653,5.4
HI,1984,3,476163,450329,25834,5.4
HI,1984,4,477135,451145,25990,5.4
HI,1984,5,476934,451606,25328,5.3
HI,1984,6,477789,452286,25503,5.3
HI,1984,7,476031,451390,24641,5.2
HI,1984,8,476915,451625,25290,5.3
HI,1984,9,477540,451539,26001,5.4
HI,1984,10,479127,452904,26223,5.5
HI,1984,11,478312,452170,26142,5.5
HI,1984,12,479415,452797,26618,5.6
HI,1985,1,480508,454646,25862,5.4
HI,1985,2,480049,456217,23832,5
HI,1985,3,479066,455870,23196,4.8
HI,1985,4,480171,456183,23988,5
HI,1985,5,481872,457968,23904,5
HI,1985,6,483386,458429,24957,5.2
HI,1985,7,483734,458950,24784,5.1
HI,1985,8,484112,459403,24709,5.1
HI,1985,9,486253,461519,24734,5.1
HI,1985,10,488104,463710,24394,5
HI,1985,11,489008,464628,24380,5
HI,1985,12,489695,465466,24229,4.9
HI,1986,1,491347,466807,24540,5
HI,1986,2,492772,468526,24246,4.9
HI,1986,3,494014,469739,24275,4.9
HI,1986,4,494675,470149,24526,5
HI,1986,5,494048,471023,23025,4.7
HI,1986,6,495701,472487,23214,4.7
HI,1986,7,496133,473681,22452,4.5
HI,1986,8,496760,474815,21945,4.4
HI,1986,9,497757,476552,21205,4.3
HI,1986,10,497766,477589,20177,4.1
HI,1986,11,498520,479395,19125,3.8
HI,1986,12,500505,481169,19336,3.9
HI,1987,1,501232,482439,18793,3.7
HI,1987,2,503840,484855,18985,3.8
HI,1987,3,506586,487327,19259,3.8
HI,1987,4,508216,488968,19248,3.8
HI,1987,5,509962,490218,19744,3.9
HI,1987,6,510892,491684,19208,3.8
HI,1987,7,512839,493910,18929,3.7
HI,1987,8,513229,494542,18687,3.6
HI,1987,9,515061,496427,18634,3.6
HI,1987,10,516927,499345,17582,3.4
HI,1987,11,518795,501663,17132,3.3
HI,1987,12,517629,501274,16355,3.2
HI,1988,1,518605,502082,16523,3.2
HI,1988,2,518690,502179,16511,3.2
HI,1988,3,518776,502273,16503,3.2
HI,1988,4,518403,502682,15721,3
HI,1988,5,518514,502610,15904,3.1
HI,1988,6,518066,503020,15046,2.9
HI,1988,7,519586,503798,15788,3
HI,1988,8,520400,504658,15742,3
HI,1988,9,520837,505191,15646,3
HI,1988,10,520098,504867,15231,2.9
HI,1988,11,520000,505176,14824,2.9
HI,1988,12,521484,506707,14777,2.8
HI,1989,1,522315,507631,14684,2.8
HI,1989,2,522059,508464,13595,2.6
HI,1989,3,522157,509421,12736,2.4
HI,1989,4,523079,510676,12403,2.4
HI,1989,5,524907,512671,12236,2.3
HI,1989,6,526840,514637,12203,2.3
HI,1989,7,527841,515764,12077,2.3
HI,1989,8,529876,517919,11957,2.3
HI,1989,9,530654,518339,12315,2.3
HI,1989,10,531888,520158,11730,2.2
HI,1989,11,534533,522814,11719,2.2
HI,1989,12,537052,524301,12751,2.4
HI,1990,1,539170,525638,13532,2.5
HI,1990,2,542127,528632,13495,2.5
HI,1990,3,544982,531273,13709,2.5
HI,1990,4,548500,534271,14229,2.6
HI,1990,5,550491,536379,14112,2.6
HI,1990,6,551762,538067,13695,2.5
HI,1990,7,552245,539176,13069,2.4
HI,1990,8,554062,541045,13017,2.3
HI,1990,9,555478,541966,13512,2.4
HI,1990,10,556915,543992,12923,2.3
HI,1990,11,558364,545328,13036,2.3
HI,1990,12,558240,545676,12564,2.3
HI,1991,1,559728,546273,13455,2.4
HI,1991,2,561550,547349,14201,2.5
HI,1991,3,562433,546739,15694,2.8
HI,1991,4,561480,545957,15523,2.8
HI,1991,5,560849,546187,14662,2.6
HI,1991,6,562873,547650,15223,2.7
HI,1991,7,563052,547664,15388,2.7
HI,1991,8,563497,547785,15712,2.8
HI,1991,9,564934,548130,16804,3
HI,1991,10,564170,548166,16004,2.8
HI,1991,11,564989,548084,16905,3
HI,1991,12,566975,548226,18749,3.3
HI,1992,1,568320,549173,19147,3.4
HI,1992,2,571040,549351,21689,3.8
HI,1992,3,572201,549964,22237,3.9
HI,1992,4,572622,550034,22588,3.9
HI,1992,5,574713,550287,24426,4.3
HI,1992,6,575939,551135,24804,4.3
HI,1992,7,577730,552159,25571,4.4
HI,1992,8,578879,552665,26214,4.5
HI,1992,9,576783,552607,24176,4.2
HI,1992,10,580600,552764,27836,4.8
HI,1992,11,581310,553746,27564,4.7
HI,1992,12,581975,554870,27105,4.7
HI,1993,1,581656,554560,27096,4.7
HI,1993,2,581475,554516,26959,4.6
HI,1993,3,582268,555345,26923,4.6
HI,1993,4,582154,556479,25675,4.4
HI,1993,5,582253,556985,25268,4.3
HI,1993,6,581764,557032,24732,4.3
HI,1993,7,581459,556959,24500,4.2
HI,1993,8,581529,556944,24585,4.2
HI,1993,9,580341,556874,23467,4
HI,1993,10,581308,557294,24014,4.1
HI,1993,11,582025,556648,25377,4.4
HI,1993,12,582707,556335,26372,4.5
HI,1994,1,585486,556790,28696,4.9
HI,1994,2,585436,555827,29609,5.1
HI,1994,3,585233,555270,29963,5.1
HI,1994,4,586105,555906,30199,5.2
HI,1994,5,585838,555288,30550,5.2
HI,1994,6,584958,554995,29963,5.1
HI,1994,7,586427,554779,31648,5.4
HI,1994,8,586102,554782,31320,5.3
HI,1994,9,585976,555455,30521,5.2
HI,1994,10,585969,555842,30127,5.1
HI,1994,11,586374,557057,29317,5
HI,1994,12,585906,556995,28911,4.9
HI,1995,1,586886,556656,30230,5.2
HI,1995,2,586717,556762,29955,5.1
HI,1995,3,587942,557508,30434,5.2
HI,1995,4,589847,557891,31956,5.4
HI,1995,5,590768,557916,32852,5.6
HI,1995,6,590760,557610,33150,5.6
HI,1995,7,590985,556889,34096,5.8
HI,1995,8,591055,556259,34796,5.9
HI,1995,9,589591,555898,33693,5.7
HI,1995,10,589946,556476,33470,5.7
HI,1995,11,588825,556870,31955,5.4
HI,1995,12,590428,557775,32653,5.5
HI,1996,1,592819,558098,34721,5.9
HI,1996,2,594138,559251,34887,5.9
HI,1996,3,594773,559912,34861,5.9
HI,1996,4,596060,560420,35640,6
HI,1996,5,595816,560965,34851,5.8
HI,1996,6,596807,561396,35411,5.9
HI,1996,7,597513,561887,35626,6
HI,1996,8,597902,562283,35619,6
HI,1996,9,597851,563051,34800,5.8
HI,1996,10,597442,563573,33869,5.7
HI,1996,11,599970,564156,35814,6
HI,1996,12,599941,565206,34735,5.8
HI,1997,1,599989,565563,34426,5.7
HI,1997,2,600777,565998,34779,5.8
HI,1997,3,600660,566163,34497,5.7
HI,1997,4,601050,566169,34881,5.8
HI,1997,5,601109,566035,35074,5.8
HI,1997,6,602596,566715,35881,6
HI,1997,7,603519,567109,36410,6
HI,1997,8,603451,567681,35770,5.9
HI,1997,9,603147,567601,35546,5.9
HI,1997,10,601402,567552,33850,5.6
HI,1997,11,600748,567116,33632,5.6
HI,1997,12,601519,567484,34035,5.7
HI,1998,1,601133,568137,32996,5.5
HI,1998,2,601611,568030,33581,5.6
HI,1998,3,602276,568281,33995,5.6
HI,1998,4,602166,569303,32863,5.5
HI,1998,5,604081,569223,34858,5.8
HI,1998,6,604690,569322,35368,5.8
HI,1998,7,605694,570454,35240,5.8
HI,1998,8,606119,571368,34751,5.7
HI,1998,9,607154,571581,35573,5.9
HI,1998,10,605477,571641,33836,5.6
HI,1998,11,604925,571681,33244,5.5
HI,1998,12,606295,572805,33490,5.5
HI,1999,1,604699,572128,32571,5.4
HI,1999,2,604126,572039,32087,5.3
HI,1999,3,605031,573086,31945,5.3
HI,1999,4,605780,574480,31300,5.2
HI,1999,5,606283,575296,30987,5.1
HI,1999,6,606277,575129,31148,5.1
HI,1999,7,606957,576428,30529,5
HI,1999,8,608310,578066,30244,5
HI,1999,9,608133,578936,29197,4.8
HI,1999,10,608120,579544,28576,4.7
HI,1999,11,607637,579669,27968,4.6
HI,1999,12,608562,580969,27593,4.5
HI,2000,1,609110,582564,26546,4.4
HI,2000,2,608370,582504,25866,4.3
HI,2000,3,608188,583382,24806,4.1
HI,2000,4,608745,584251,24494,4
HI,2000,5,608691,584336,24355,4
HI,2000,6,608533,584921,23612,3.9
HI,2000,7,607410,583780,23630,3.9
HI,2000,8,607751,583788,23963,3.9
HI,2000,9,609492,586022,23470,3.9
HI,2000,10,610069,587012,23057,3.8
HI,2000,11,610447,587892,22555,3.7
HI,2000,12,611409,587846,23563,3.9
HI,2001,1,611980,588603,23377,3.8
HI,2001,2,614327,590470,23857,3.9
HI,2001,3,614471,590843,23628,3.8
HI,2001,4,615633,589943,25690,4.2
HI,2001,5,614961,590450,24511,4
HI,2001,6,614793,589977,24816,4
HI,2001,7,614541,589617,24924,4.1
HI,2001,8,614169,589834,24335,4
HI,2001,9,614743,589826,24917,4.1
HI,2001,10,616632,587936,28696,4.7
HI,2001,11,619347,587044,32303,5.2
HI,2001,12,617456,586047,31409,5.1
HI,2002,1,614653,584862,29791,4.8
HI,2002,2,611616,583366,28250,4.6
HI,2002,3,610432,583445,26987,4.4
HI,2002,4,608376,582568,25808,4.2
HI,2002,5,608493,583294,25199,4.1
HI,2002,6,608079,584268,23811,3.9
HI,2002,7,607602,584169,23433,3.9
HI,2002,8,607007,584261,22746,3.7
HI,2002,9,608067,585089,22978,3.8
HI,2002,10,607525,585203,22322,3.7
HI,2002,11,607465,585387,22078,3.6
HI,2002,12,607929,586331,21598,3.6
HI,2003,1,614565,591675,22890,3.7
HI,2003,2,614144,591808,22336,3.6
HI,2003,3,613435,590258,23177,3.8
HI,2003,4,614757,590893,23864,3.9
HI,2003,5,615909,591786,24123,3.9
HI,2003,6,616161,591343,24818,4
HI,2003,7,617048,592717,24331,3.9
HI,2003,8,616657,592334,24323,3.9
HI,2003,9,618214,593215,24999,4
HI,2003,10,617741,593452,24289,3.9
HI,2003,11,617827,594238,23589,3.8
HI,2003,12,619422,595905,23517,3.8
HI,2004,1,614847,592718,22129,3.6
HI,2004,2,613951,592105,21846,3.6
HI,2004,3,615799,593991,21808,3.5
HI,2004,4,616563,595834,20729,3.4
HI,2004,5,617424,597474,19950,3.2
HI,2004,6,616931,597556,19375,3.1
HI,2004,7,618040,599218,18822,3
HI,2004,8,619425,600194,19231,3.1
HI,2004,9,619209,600093,19116,3.1
HI,2004,10,621300,602010,19290,3.1
HI,2004,11,622325,603443,18882,3
HI,2004,12,621979,603465,18514,3
HI,2005,1,622762,604494,18268,2.9
HI,2005,2,624809,606659,18150,2.9
HI,2005,3,625291,607686,17605,2.8
HI,2005,4,627392,610033,17359,2.8
HI,2005,5,627041,610040,17001,2.7
HI,2005,6,629222,612406,16816,2.7
HI,2005,7,631585,614634,16951,2.7
HI,2005,8,633604,616427,17177,2.7
HI,2005,9,635566,618250,17316,2.7
HI,2005,10,636410,619293,17117,2.7
HI,2005,11,636309,619507,16802,2.6
HI,2005,12,637490,621034,16456,2.6
HI,2006,1,637293,621564,15729,2.5
HI,2006,2,638988,622787,16201,2.5
HI,2006,3,640325,623137,17188,2.7
HI,2006,4,640989,623774,17215,2.7
HI,2006,5,641354,624347,17007,2.7
HI,2006,6,643299,626538,16761,2.6
HI,2006,7,643657,627536,16121,2.5
HI,2006,8,644497,629209,15288,2.4
HI,2006,9,646186,631170,15016,2.3
HI,2006,10,645244,630469,14775,2.3
HI,2006,11,646675,632153,14522,2.2
HI,2006,12,646193,632017,14176,2.2
HI,2007,1,646406,631166,15240,2.4
HI,2007,2,646487,630895,15592,2.4
HI,2007,3,647139,630833,16306,2.5
HI,2007,4,645272,629468,15804,2.4
HI,2007,5,645770,629667,16103,2.5
HI,2007,6,645844,629453,16391,2.5
HI,2007,7,644356,627489,16867,2.6
HI,2007,8,643523,626269,17254,2.7
HI,2007,9,646194,628196,17998,2.8
HI,2007,10,645697,627489,18208,2.8
HI,2007,11,646171,627317,18854,2.9
HI,2007,12,648515,628588,19927,3.1
HI,2008,1,649463,629728,19735,3
HI,2008,2,649807,629457,20350,3.1
HI,2008,3,651683,631227,20456,3.1
HI,2008,4,653835,631071,22764,3.5
HI,2008,5,654451,630677,23774,3.6
HI,2008,6,654621,629325,25296,3.9
HI,2008,7,654853,628746,26107,4
HI,2008,8,655049,627836,27213,4.2
HI,2008,9,656014,626939,29075,4.4
HI,2008,10,656594,626694,29900,4.6
HI,2008,11,657186,625275,31911,4.9
HI,2008,12,657584,624175,33409,5.1
HI,2009,1,648682,609132,39550,6.1
ID,1976,1,365313,346082,19231,5.3
ID,1976,2,365980,346552,19428,5.3
ID,1976,3,366463,346848,19615,5.4
ID,1976,4,367446,347651,19795,5.4
ID,1976,5,368732,348755,19977,5.4
ID,1976,6,369762,349600,20162,5.5
ID,1976,7,372394,352045,20349,5.5
ID,1976,8,373845,353305,20540,5.5
ID,1976,9,374824,354094,20730,5.5
ID,1976,10,377918,356998,20920,5.5
ID,1976,11,379677,358575,21102,5.6
ID,1976,12,382267,360998,21269,5.6
ID,1977,1,383934,362515,21419,5.6
ID,1977,2,385758,364191,21567,5.6
ID,1977,3,387312,365602,21710,5.6
ID,1977,4,389646,367800,21846,5.6
ID,1977,5,391642,369669,21973,5.6
ID,1977,6,394213,372129,22084,5.6
ID,1977,7,396530,374356,22174,5.6
ID,1977,8,399170,376930,22240,5.6
ID,1977,9,401782,379495,22287,5.5
ID,1977,10,404686,382365,22321,5.5
ID,1977,11,406171,383821,22350,5.5
ID,1977,12,408411,386027,22384,5.5
ID,1978,1,407965,385532,22433,5.5
ID,1978,2,409655,387165,22490,5.5
ID,1978,3,410586,388029,22557,5.5
ID,1978,4,413189,390557,22632,5.5
ID,1978,5,413368,390652,22716,5.5
ID,1978,6,415125,392318,22807,5.5
ID,1978,7,415761,392859,22902,5.5
ID,1978,8,416625,393624,23001,5.5
ID,1978,9,415757,392656,23101,5.6
ID,1978,10,416382,393184,23198,5.6
ID,1978,11,416727,393436,23291,5.6
ID,1978,12,418304,394923,23381,5.6
ID,1979,1,420782,397313,23469,5.6
ID,1979,2,421213,397626,23587,5.6
ID,1979,3,423619,399884,23735,5.6
ID,1979,4,423968,400050,23918,5.6
ID,1979,5,427815,403675,24140,5.6
ID,1979,6,429277,404869,24408,5.7
ID,1979,7,427964,403237,24727,5.8
ID,1979,8,428332,403236,25096,5.9
ID,1979,9,431174,405659,25515,5.9
ID,1979,10,432534,406546,25988,6
ID,1979,11,433991,407476,26515,6.1
ID,1979,12,431880,404781,27099,6.3
ID,1980,1,430419,402689,27730,6.4
ID,1980,2,429903,401564,28339,6.6
ID,1980,3,427812,398897,28915,6.8
ID,1980,4,426749,397306,29443,6.9
ID,1980,5,425806,395894,29912,7
ID,1980,6,423491,393178,30313,7.2
ID,1980,7,424158,393515,30643,7.2
ID,1980,8,423302,392399,30903,7.3
ID,1980,9,425195,394104,31091,7.3
ID,1980,10,425422,394212,31210,7.3
ID,1980,11,426320,395058,31262,7.3
ID,1980,12,427819,396565,31254,7.3
ID,1981,1,430657,399458,31199,7.2
ID,1981,2,430398,399198,31200,7.2
ID,1981,3,431308,400043,31265,7.2
ID,1981,4,431112,399709,31403,7.3
ID,1981,5,431136,399519,31617,7.3
ID,1981,6,428992,397082,31910,7.4
ID,1981,7,430701,398423,32278,7.5
ID,1981,8,431167,398443,32724,7.6
ID,1981,9,430683,397437,33246,7.7
ID,1981,10,430342,396500,33842,7.9
ID,1981,11,431016,396503,34513,8
ID,1981,12,431964,396705,35259,8.2
ID,1982,1,432192,396117,36075,8.3
ID,1982,2,432893,396028,36865,8.5
ID,1982,3,434343,396721,37622,8.7
ID,1982,4,435087,396749,38338,8.8
ID,1982,5,436458,397456,39002,8.9
ID,1982,6,438180,398569,39611,9
ID,1982,7,439489,399329,40160,9.1
ID,1982,8,440578,399936,40642,9.2
ID,1982,9,442509,401461,41048,9.3
ID,1982,10,441984,400615,41369,9.4
ID,1982,11,443118,401521,41597,9.4
ID,1982,12,443350,401624,41726,9.4
ID,1983,1,444265,402517,41748,9.4
ID,1983,2,445560,403899,41661,9.4
ID,1983,3,446412,404942,41470,9.3
ID,1983,4,447701,406522,41179,9.2
ID,1983,5,447409,406612,40797,9.1
ID,1983,6,450236,409904,40332,9
ID,1983,7,450361,410560,39801,8.8
ID,1983,8,451516,412303,39213,8.7
ID,1983,9,452953,414371,38582,8.5
ID,1983,10,456187,418268,37919,8.3
ID,1983,11,457019,419782,37237,8.1
ID,1983,12,458694,422145,36549,8
ID,1984,1,460156,424291,35865,7.8
ID,1984,2,461645,426374,35271,7.6
ID,1984,3,461201,426433,34768,7.5
ID,1984,4,461405,427047,34358,7.4
ID,1984,5,462460,428418,34042,7.4
ID,1984,6,464706,430882,33824,7.3
ID,1984,7,463841,430135,33706,7.3
ID,1984,8,463695,430013,33682,7.3
ID,1984,9,464563,430818,33745,7.3
ID,1984,10,465434,431541,33893,7.3
ID,1984,11,464257,430136,34121,7.3
ID,1984,12,463813,429388,34425,7.4
ID,1985,1,464621,429823,34798,7.5
ID,1985,2,464469,429306,35163,7.6
ID,1985,3,464351,428833,35518,7.6
ID,1985,4,464616,428755,35861,7.7
ID,1985,5,465326,429140,36186,7.8
ID,1985,6,464849,428354,36495,7.9
ID,1985,7,465254,428474,36780,7.9
ID,1985,8,466165,429123,37042,7.9
ID,1985,9,465734,428458,37276,8
ID,1985,10,466645,429166,37479,8
ID,1985,11,465870,428228,37642,8.1
ID,1985,12,467319,429560,37759,8.1
ID,1986,1,467514,429685,37829,8.1
ID,1986,2,469096,431196,37900,8.1
ID,1986,3,470147,432177,37970,8.1
ID,1986,4,470668,432629,38039,8.1
ID,1986,5,470236,432135,38101,8.1
ID,1986,6,471532,433385,38147,8.1
ID,1986,7,471548,433371,38177,8.1
ID,1986,8,471010,432828,38182,8.1
ID,1986,9,470746,432587,38159,8.1
ID,1986,10,470078,431970,38108,8.1
ID,1986,11,470416,432390,38026,8.1
ID,1986,12,470891,432979,37912,8.1
ID,1987,1,470858,433092,37766,8
ID,1987,2,470721,433174,37547,8
ID,1987,3,470491,433234,37257,7.9
ID,1987,4,470799,433897,36902,7.8
ID,1987,5,471884,435398,36486,7.7
ID,1987,6,471223,435201,36022,7.6
ID,1987,7,471514,436002,35512,7.5
ID,1987,8,470797,435833,34964,7.4
ID,1987,9,471055,436670,34385,7.3
ID,1987,10,471408,437627,33781,7.2
ID,1987,11,471716,438560,33156,7
ID,1987,12,471010,438497,32513,6.9
ID,1988,1,471822,439966,31856,6.8
ID,1988,2,472595,441377,31218,6.6
ID,1988,3,472747,442140,30607,6.5
ID,1988,4,474360,444335,30025,6.3
ID,1988,5,475995,446521,29474,6.2
ID,1988,6,476930,447976,28954,6.1
ID,1988,7,478287,449818,28469,6
ID,1988,8,480068,452046,28022,5.8
ID,1988,9,480896,453281,27615,5.7
ID,1988,10,481583,454335,27248,5.7
ID,1988,11,483402,456479,26923,5.6
ID,1988,12,484634,457997,26637,5.5
ID,1989,1,484307,457914,26393,5.4
ID,1989,2,485968,459788,26180,5.4
ID,1989,3,486014,460011,26003,5.4
ID,1989,4,486438,460580,25858,5.3
ID,1989,5,485963,460218,25745,5.3
ID,1989,6,486415,460753,25662,5.3
ID,1989,7,486521,460912,25609,5.3
ID,1989,8,486974,461386,25588,5.3
ID,1989,9,488457,462860,25597,5.2
ID,1989,10,489269,463629,25640,5.2
ID,1989,11,490572,464857,25715,5.2
ID,1989,12,492205,466383,25822,5.2
ID,1990,1,493650,467691,25959,5.3
ID,1990,2,493211,467092,26119,5.3
ID,1990,3,493652,467362,26290,5.3
ID,1990,4,493362,466891,26471,5.4
ID,1990,5,492979,466318,26661,5.4
ID,1990,6,493550,466691,26859,5.4
ID,1990,7,492710,465640,27070,5.5
ID,1990,8,493466,466178,27288,5.5
ID,1990,9,494247,466732,27515,5.6
ID,1990,10,494901,467148,27753,5.6
ID,1990,11,496362,468363,27999,5.6
ID,1990,12,497365,469119,28246,5.7
ID,1991,1,497771,469281,28490,5.7
ID,1991,2,499694,470948,28746,5.8
ID,1991,3,501590,472576,29014,5.8
ID,1991,4,502351,473055,29296,5.8
ID,1991,5,503377,473789,29588,5.9
ID,1991,6,506059,476170,29889,5.9
ID,1991,7,508156,477955,30201,5.9
ID,1991,8,509605,479078,30527,6
ID,1991,9,510409,479537,30872,6
ID,1991,10,512410,481177,31233,6.1
ID,1991,11,513672,482058,31614,6.2
ID,1991,12,514761,482750,32011,6.2
ID,1992,1,517208,484788,32420,6.3
ID,1992,2,519617,486815,32802,6.3
ID,1992,3,521925,488773,33152,6.4
ID,1992,4,524397,490933,33464,6.4
ID,1992,5,526017,492281,33736,6.4
ID,1992,6,527456,493491,33965,6.4
ID,1992,7,529912,495763,34149,6.4
ID,1992,8,530788,496500,34288,6.5
ID,1992,9,531013,496635,34378,6.5
ID,1992,10,532976,498553,34423,6.5
ID,1992,11,534306,499880,34426,6.4
ID,1992,12,535174,500789,34385,6.4
ID,1993,1,536178,501879,34299,6.4
ID,1993,2,537352,503156,34196,6.4
ID,1993,3,537937,503863,34074,6.3
ID,1993,4,540086,506154,33932,6.3
ID,1993,5,543821,510050,33771,6.2
ID,1993,6,547135,513542,33593,6.1
ID,1993,7,550922,517517,33405,6.1
ID,1993,8,554481,521270,33211,6
ID,1993,9,557397,524379,33018,5.9
ID,1993,10,560989,528159,32830,5.9
ID,1993,11,563609,530956,32653,5.8
ID,1993,12,567245,534754,32491,5.7
ID,1994,1,571904,539560,32344,5.7
ID,1994,2,575864,543657,32207,5.6
ID,1994,3,578766,546687,32079,5.5
ID,1994,4,581686,549724,31962,5.5
ID,1994,5,583445,551588,31857,5.5
ID,1994,6,584859,553095,31764,5.4
ID,1994,7,585983,554303,31680,5.4
ID,1994,8,587360,555752,31608,5.4
ID,1994,9,588955,557411,31544,5.4
ID,1994,10,589165,557682,31483,5.3
ID,1994,11,590202,558784,31418,5.3
ID,1994,12,591351,560004,31347,5.3
ID,1995,1,592276,561006,31270,5.3
ID,1995,2,593686,562473,31213,5.3
ID,1995,3,596016,564841,31175,5.2
ID,1995,4,597212,566048,31164,5.2
ID,1995,5,597313,566133,31180,5.2
ID,1995,6,599053,567826,31227,5.2
ID,1995,7,599042,567737,31305,5.2
ID,1995,8,600867,569459,31408,5.2
ID,1995,9,601389,569851,31538,5.2
ID,1995,10,602724,571031,31693,5.3
ID,1995,11,603492,571621,31871,5.3
ID,1995,12,604742,572673,32069,5.3
ID,1996,1,606399,574109,32290,5.3
ID,1996,2,608026,575545,32481,5.3
ID,1996,3,608771,576129,32642,5.4
ID,1996,4,609803,577035,32768,5.4
ID,1996,5,610627,577768,32859,5.4
ID,1996,6,611782,578869,32913,5.4
ID,1996,7,613700,580772,32928,5.4
ID,1996,8,616741,583835,32906,5.3
ID,1996,9,617768,584925,32843,5.3
ID,1996,10,619281,586542,32739,5.3
ID,1996,11,620884,588290,32594,5.2
ID,1996,12,622875,590471,32404,5.2
ID,1997,1,624412,592245,32167,5.2
ID,1997,2,624316,592349,31967,5.1
ID,1997,3,625279,593473,31806,5.1
ID,1997,4,627116,595432,31684,5.1
ID,1997,5,628619,597012,31607,5
ID,1997,6,630166,598592,31574,5
ID,1997,7,631035,599449,31586,5
ID,1997,8,630592,598950,31642,5
ID,1997,9,632412,600672,31740,5
ID,1997,10,633391,601508,31883,5
ID,1997,11,634665,602597,32068,5.1
ID,1997,12,636065,603770,32295,5.1
ID,1998,1,638609,606048,32561,5.1
ID,1998,2,640606,607820,32786,5.1
ID,1998,3,642861,609890,32971,5.1
ID,1998,4,644524,611407,33117,5.1
ID,1998,5,646809,613583,33226,5.1
ID,1998,6,646986,613684,33302,5.1
ID,1998,7,648751,615406,33345,5.1
ID,1998,8,650348,616992,33356,5.1
ID,1998,9,652535,619203,33332,5.1
ID,1998,10,653120,619846,33274,5.1
ID,1998,11,655031,621851,33180,5.1
ID,1998,12,654297,621246,33051,5.1
ID,1999,1,652737,619850,32887,5
ID,1999,2,651692,618971,32721,5
ID,1999,3,651970,619415,32555,5
ID,1999,4,651185,618800,32385,5
ID,1999,5,651074,618862,32212,4.9
ID,1999,6,651120,619088,32032,4.9
ID,1999,7,653120,621277,31843,4.9
ID,1999,8,653000,621348,31652,4.8
ID,1999,9,654003,622540,31463,4.8
ID,1999,10,653968,622690,31278,4.8
ID,1999,11,655009,623909,31100,4.7
ID,1999,12,655730,624791,30939,4.7
ID,2000,1,658047,627367,30680,4.7
ID,2000,2,658208,627671,30537,4.6
ID,2000,3,659855,629430,30425,4.6
ID,2000,4,661003,630655,30348,4.6
ID,2000,5,662302,631998,30304,4.6
ID,2000,6,661950,631655,30295,4.6
ID,2000,7,663089,632769,30320,4.6
ID,2000,8,664261,633881,30380,4.6
ID,2000,9,665586,635113,30473,4.6
ID,2000,10,665500,634899,30601,4.6
ID,2000,11,667433,636672,30761,4.6
ID,2000,12,668251,637297,30954,4.6
ID,2001,1,670132,638951,31181,4.7
ID,2001,2,671578,640142,31436,4.7
ID,2001,3,674416,642696,31720,4.7
ID,2001,4,675849,643817,32032,4.7
ID,2001,5,677230,644861,32369,4.8
ID,2001,6,678335,645606,32729,4.8
ID,2001,7,679686,646573,33113,4.9
ID,2001,8,681654,648140,33514,4.9
ID,2001,9,681635,647701,33934,5
ID,2001,10,681358,646990,34368,5
ID,2001,11,681195,646385,34810,5.1
ID,2001,12,681185,645928,35257,5.2
ID,2002,1,680481,644832,35649,5.2
ID,2002,2,680671,644623,36048,5.3
ID,2002,3,680879,644471,36408,5.3
ID,2002,4,681919,645193,36726,5.4
ID,2002,5,682335,645333,37002,5.4
ID,2002,6,683466,646233,37233,5.4
ID,2002,7,683692,646276,37416,5.5
ID,2002,8,684503,646955,37548,5.5
ID,2002,9,684203,646574,37629,5.5
ID,2002,10,685041,647384,37657,5.5
ID,2002,11,684929,647295,37634,5.5
ID,2002,12,686090,648532,37558,5.5
ID,2003,1,686946,649694,37252,5.4
ID,2003,2,687142,650038,37104,5.4
ID,2003,3,687270,650332,36938,5.4
ID,2003,4,686914,650158,36756,5.4
ID,2003,5,687502,650944,36558,5.3
ID,2003,6,687735,651390,36345,5.3
ID,2003,7,687337,651220,36117,5.3
ID,2003,8,687615,651746,35869,5.2
ID,2003,9,688793,653193,35600,5.2
ID,2003,10,689785,654472,35313,5.1
ID,2003,11,690985,655974,35011,5.1
ID,2003,12,691461,656764,34697,5
ID,2004,1,689841,655723,34118,4.9
ID,2004,2,691117,657312,33805,4.9
ID,2004,3,693017,659545,33472,4.8
ID,2004,4,694413,661293,33120,4.8
ID,2004,5,695559,662810,32749,4.7
ID,2004,6,696914,664557,32357,4.6
ID,2004,7,698427,666485,31942,4.6
ID,2004,8,700066,668557,31509,4.5
ID,2004,9,701166,670106,31060,4.4
ID,2004,10,703452,672853,30599,4.3
ID,2004,11,705406,675276,30130,4.3
ID,2004,12,708105,678446,29659,4.2
ID,2005,1,711241,682045,29196,4.1
ID,2005,2,714470,685730,28740,4
ID,2005,3,715648,687356,28292,4
ID,2005,4,717292,689441,27851,3.9
ID,2005,5,718316,690897,27419,3.8
ID,2005,6,720150,693156,26994,3.7
ID,2005,7,721963,695391,26572,3.7
ID,2005,8,723043,696887,26156,3.6
ID,2005,9,724746,698998,25748,3.6
ID,2005,10,725689,700337,25352,3.5
ID,2005,11,726936,701972,24964,3.4
ID,2005,12,728583,703998,24585,3.4
ID,2006,1,730432,706216,24216,3.3
ID,2006,2,731607,707758,23849,3.3
ID,2006,3,732701,709218,23483,3.2
ID,2006,4,733997,710878,23119,3.1
ID,2006,5,734736,711976,22760,3.1
ID,2006,6,735676,713267,22409,3
ID,2006,7,736559,714490,22069,3
ID,2006,8,737445,715697,21748,2.9
ID,2006,9,738110,716656,21454,2.9
ID,2006,10,738406,717214,21192,2.9
ID,2006,11,739761,718788,20973,2.8
ID,2006,12,740877,720077,20800,2.8
ID,2007,1,742198,721513,20685,2.8
ID,2007,2,743633,722972,20661,2.8
ID,2007,3,745364,724630,20734,2.8
ID,2007,4,747344,726431,20913,2.8
ID,2007,5,748850,727644,21206,2.8
ID,2007,6,750019,728395,21624,2.9
ID,2007,7,750927,728763,22164,3
ID,2007,8,751246,728413,22833,3
ID,2007,9,751624,727993,23631,3.1
ID,2007,10,750600,726041,24559,3.3
ID,2007,11,751225,725612,25613,3.4
ID,2007,12,751483,724689,26794,3.6
ID,2008,1,750796,722694,28102,3.7
ID,2008,2,751005,721510,29495,3.9
ID,2008,3,751498,720532,30966,4.1
ID,2008,4,751203,718696,32507,4.3
ID,2008,5,752952,718843,34109,4.5
ID,2008,6,753655,717896,35759,4.7
ID,2008,7,755550,718104,37446,5
ID,2008,8,756755,717596,39159,5.2
ID,2008,9,757597,716713,40884,5.4
ID,2008,10,758904,716296,42608,5.6
ID,2008,11,759373,715049,44324,5.8
ID,2008,12,759249,713230,46019,6.1
ID,2009,1,752667,703362,49305,6.6
IL,1976,1,5107669,4782760,324909,6.4
IL,1976,2,5111761,4784487,327274,6.4
IL,1976,3,5115094,4791114,323980,6.3
IL,1976,4,5116903,4798247,318656,6.2
IL,1976,5,5108369,4785268,323101,6.3
IL,1976,6,5133538,4784109,349429,6.8
IL,1976,7,5145126,4793442,351684,6.8
IL,1976,8,5154847,4805623,349224,6.8
IL,1976,9,5155392,4806863,348529,6.8
IL,1976,10,5155929,4811344,344585,6.7
IL,1976,11,5174217,4834956,339261,6.6
IL,1976,12,5197795,4856988,340807,6.6
IL,1977,1,5169401,4860768,308633,6
IL,1977,2,5189611,4879734,309877,6
IL,1977,3,5211742,4901656,310086,5.9
IL,1977,4,5224655,4919742,304913,5.8
IL,1977,5,5245657,4938464,307193,5.9
IL,1977,6,5286251,4952213,334038,6.3
IL,1977,7,5294745,4960759,333986,6.3
IL,1977,8,5317906,4976920,340986,6.4
IL,1977,9,5332846,4989132,343714,6.4
IL,1977,10,5347369,5000620,346749,6.5
IL,1977,11,5349171,5003415,345756,6.5
IL,1977,12,5349669,5015161,334508,6.3
IL,1978,1,5384759,5036360,348399,6.5
IL,1978,2,5383380,5038636,344744,6.4
IL,1978,3,5386768,5047535,339233,6.3
IL,1978,4,5395555,5069222,326333,6
IL,1978,5,5410835,5074702,336133,6.2
IL,1978,6,5413899,5092070,321829,5.9
IL,1978,7,5436724,5108419,328305,6
IL,1978,8,5455637,5127753,327884,6
IL,1978,9,5446332,5128773,317559,5.8
IL,1978,10,5467977,5151630,316347,5.8
IL,1978,11,5468860,5161389,307471,5.6
IL,1978,12,5464294,5156936,307358,5.6
IL,1979,1,5440643,5150219,290424,5.3
IL,1979,2,5438217,5149571,288646,5.3
IL,1979,3,5450988,5159293,291695,5.4
IL,1979,4,5462062,5163428,298634,5.5
IL,1979,5,5446050,5161923,284127,5.2
IL,1979,6,5470092,5184386,285706,5.2
IL,1979,7,5492554,5209218,283336,5.2
IL,1979,8,5495540,5207417,288123,5.2
IL,1979,9,5485889,5175123,310766,5.7
IL,1979,10,5489811,5164867,324944,5.9
IL,1979,11,5501902,5160435,341467,6.2
IL,1979,12,5525812,5169339,356473,6.5
IL,1980,1,5521789,5148456,373333,6.8
IL,1980,2,5518785,5132568,386217,7
IL,1980,3,5517126,5118718,398408,7.2
IL,1980,4,5506554,5103658,402896,7.3
IL,1980,5,5538002,5092214,445788,8
IL,1980,6,5531966,5053946,478020,8.6
IL,1980,7,5540400,5040137,500263,9
IL,1980,8,5534150,5047389,486761,8.8
IL,1980,9,5536433,5049900,486533,8.8
IL,1980,10,5546062,5051988,494074,8.9
IL,1980,11,5557886,5071539,486347,8.8
IL,1980,12,5564791,5076735,488056,8.8
IL,1981,1,5564460,5077876,486584,8.7
IL,1981,2,5566570,5087590,478980,8.6
IL,1981,3,5579036,5095896,483140,8.7
IL,1981,4,5575678,5106385,469293,8.4
IL,1981,5,5584647,5113496,471151,8.4
IL,1981,6,5600341,5136641,463700,8.3
IL,1981,7,5599940,5141605,458335,8.2
IL,1981,8,5608029,5135273,472756,8.4
IL,1981,9,5608518,5132026,476492,8.5
IL,1981,10,5619562,5138879,480683,8.6
IL,1981,11,5615907,5117927,497980,8.9
IL,1981,12,5597607,5092192,505415,9
IL,1982,1,5605935,5068565,537370,9.6
IL,1982,2,5595688,5052099,543589,9.7
IL,1982,3,5587413,5023198,564215,10.1
IL,1982,4,5599982,5008555,591427,10.6
IL,1982,5,5587068,4981489,605579,10.8
IL,1982,6,5590968,4960722,630246,11.3
IL,1982,7,5600236,4945950,654286,11.7
IL,1982,8,5602099,4941402,660697,11.8
IL,1982,9,5605278,4922138,683140,12.2
IL,1982,10,5594963,4898426,696537,12.4
IL,1982,11,5596104,4884240,711864,12.7
IL,1982,12,5607672,4890420,717252,12.8
IL,1983,1,5615082,4896446,718636,12.8
IL,1983,2,5611690,4889794,721896,12.9
IL,1983,3,5619798,4907370,712428,12.7
IL,1983,4,5610531,4904474,706057,12.6
IL,1983,5,5607000,4917502,689498,12.3
IL,1983,6,5587522,4910922,676600,12.1
IL,1983,7,5586646,4933000,653646,11.7
IL,1983,8,5573793,4942066,631727,11.3
IL,1983,9,5576945,4973040,603905,10.8
IL,1983,10,5558139,4970018,588121,10.6
IL,1983,11,5574936,5000597,574339,10.3
IL,1983,12,5581760,5019996,561764,10.1
IL,1984,1,5600482,5045141,555341,9.9
IL,1984,2,5613533,5073532,540001,9.6
IL,1984,3,5607897,5072089,535808,9.6
IL,1984,4,5611007,5081915,529092,9.4
IL,1984,5,5614486,5103432,511054,9.1
IL,1984,6,5615164,5122471,492693,8.8
IL,1984,7,5606944,5118776,488168,8.7
IL,1984,8,5604092,5116638,487454,8.7
IL,1984,9,5616759,5123540,493219,8.8
IL,1984,10,5643162,5145180,497982,8.8
IL,1984,11,5649650,5156099,493551,8.7
IL,1984,12,5637243,5140375,496868,8.8
IL,1985,1,5665854,5161139,504715,8.9
IL,1985,2,5652800,5152322,500478,8.9
IL,1985,3,5654397,5161841,492556,8.7
IL,1985,4,5672852,5153241,519611,9.2
IL,1985,5,5674297,5151856,522441,9.2
IL,1985,6,5655265,5134204,521061,9.2
IL,1985,7,5642049,5126434,515615,9.1
IL,1985,8,5650955,5134521,516434,9.1
IL,1985,9,5662353,5139895,522458,9.2
IL,1985,10,5675035,5149144,525891,9.3
IL,1985,11,5671390,5149696,521694,9.2
IL,1985,12,5678324,5173388,504936,8.9
IL,1986,1,5682221,5185611,496610,8.7
IL,1986,2,5688819,5182499,506320,8.9
IL,1986,3,5690257,5193563,496694,8.7
IL,1986,4,5692449,5209987,482462,8.5
IL,1986,5,5694450,5213119,481331,8.5
IL,1986,6,5681568,5207811,473757,8.3
IL,1986,7,5685125,5221123,464002,8.2
IL,1986,8,5693933,5233211,460722,8.1
IL,1986,9,5708160,5249458,458702,8
IL,1986,10,5705605,5254690,450915,7.9
IL,1986,11,5696272,5258012,438260,7.7
IL,1986,12,5701004,5269460,431544,7.6
IL,1987,1,5718811,5283449,435362,7.6
IL,1987,2,5728671,5291697,436974,7.6
IL,1987,3,5733865,5293247,440618,7.7
IL,1987,4,5758149,5306356,451793,7.8
IL,1987,5,5773902,5321284,452618,7.8
IL,1987,6,5772276,5334830,437446,7.6
IL,1987,7,5780825,5355697,425128,7.4
IL,1987,8,5789126,5372214,416912,7.2
IL,1987,9,5784552,5373561,410991,7.1
IL,1987,10,5792778,5382571,410207,7.1
IL,1987,11,5770795,5365103,405692,7
IL,1987,12,5778989,5371210,407779,7.1
IL,1988,1,5808211,5399097,409114,7
IL,1988,2,5818996,5399075,419921,7.2
IL,1988,3,5819900,5402421,417479,7.2
IL,1988,4,5820496,5407356,413140,7.1
IL,1988,5,5831211,5423550,407661,7
IL,1988,6,5833467,5439351,394116,6.8
IL,1988,7,5846843,5459769,387074,6.6
IL,1988,8,5877788,5484748,393040,6.7
IL,1988,9,5873517,5497288,376229,6.4
IL,1988,10,5892263,5508764,383499,6.5
IL,1988,11,5932126,5547809,384317,6.5
IL,1988,12,5942764,5569302,373462,6.3
IL,1989,1,5957948,5601027,356921,6
IL,1989,2,5983735,5629127,354608,5.9
IL,1989,3,6003704,5644270,359434,6
IL,1989,4,6016602,5656865,359737,6
IL,1989,5,6026137,5662725,363412,6
IL,1989,6,6035656,5682274,353382,5.9
IL,1989,7,6018491,5666563,351928,5.8
IL,1989,8,6027067,5664859,362208,6
IL,1989,9,6032383,5662144,370239,6.1
IL,1989,10,6013623,5631763,381860,6.3
IL,1989,11,6008363,5624075,384288,6.4
IL,1989,12,5993645,5611812,381833,6.4
IL,1990,1,5964864,5592128,372736,6.2
IL,1990,2,5943414,5579767,363647,6.1
IL,1990,3,5934454,5574374,360080,6.1
IL,1990,4,5937951,5564678,373273,6.3
IL,1990,5,5920276,5558597,361679,6.1
IL,1990,6,5917711,5555275,362436,6.1
IL,1990,7,5939709,5566008,373701,6.3
IL,1990,8,5930237,5552516,377721,6.4
IL,1990,9,5931794,5546317,385477,6.5
IL,1990,10,5923781,5548855,374926,6.3
IL,1990,11,5918923,5545555,373368,6.3
IL,1990,12,5916301,5542499,373802,6.3
IL,1991,1,5906692,5522727,383965,6.5
IL,1991,2,5908691,5523632,385059,6.5
IL,1991,3,5918027,5514568,403459,6.8
IL,1991,4,5914591,5512528,402063,6.8
IL,1991,5,5898612,5501762,396850,6.7
IL,1991,6,5902674,5493869,408805,6.9
IL,1991,7,5909955,5493191,416764,7.1
IL,1991,8,5919351,5483766,435585,7.4
IL,1991,9,5927506,5484885,442621,7.5
IL,1991,10,5936174,5468289,467885,7.9
IL,1991,11,5957242,5460075,497167,8.3
IL,1991,12,5981397,5463356,518041,8.7
IL,1992,1,6001773,5490206,511567,8.5
IL,1992,2,6004324,5493792,510532,8.5
IL,1992,3,6003014,5499736,503278,8.4
IL,1992,4,6006122,5505927,500195,8.3
IL,1992,5,6030255,5533405,496850,8.2
IL,1992,6,6035141,5543093,492048,8.2
IL,1992,7,6019888,5550096,469792,7.8
IL,1992,8,6013789,5566457,447332,7.4
IL,1992,9,6020368,5587343,433025,7.2
IL,1992,10,6016410,5598849,417561,6.9
IL,1992,11,6027123,5593983,433140,7.2
IL,1992,12,6039572,5597771,441801,7.3
IL,1993,1,6037592,5594252,443340,7.3
IL,1993,2,6040127,5585456,454671,7.5
IL,1993,3,6051100,5579376,471724,7.8
IL,1993,4,6065038,5588641,476397,7.9
IL,1993,5,6080571,5605168,475403,7.8
IL,1993,6,6074773,5605532,469241,7.7
IL,1993,7,6080157,5630538,449619,7.4
IL,1993,8,6084316,5633605,450711,7.4
IL,1993,9,6086890,5631386,455504,7.5
IL,1993,10,6090167,5655466,434701,7.1
IL,1993,11,6088653,5685606,403047,6.6
IL,1993,12,6104226,5706209,398017,6.5
IL,1994,1,6096062,5699586,396476,6.5
IL,1994,2,6106859,5713076,393783,6.4
IL,1994,3,6115837,5734764,381073,6.2
IL,1994,4,6121915,5756359,365556,6
IL,1994,5,6129868,5766306,363562,5.9
IL,1994,6,6128991,5778514,350477,5.7
IL,1994,7,6121903,5774867,347036,5.7
IL,1994,8,6126071,5784734,341337,5.6
IL,1994,9,6129205,5789444,339761,5.5
IL,1994,10,6134809,5790124,344685,5.6
IL,1994,11,6122934,5802603,320331,5.2
IL,1994,12,6120965,5809679,311286,5.1
IL,1995,1,6146296,5827413,318883,5.2
IL,1995,2,6173640,5850785,322855,5.2
IL,1995,3,6173462,5863464,309998,5
IL,1995,4,6193437,5859664,333773,5.4
IL,1995,5,6175878,5844519,331359,5.4
IL,1995,6,6166070,5860582,305488,5
IL,1995,7,6161041,5847302,313739,5.1
IL,1995,8,6173590,5842776,330814,5.4
IL,1995,9,6194474,5869740,324734,5.2
IL,1995,10,6195562,5877155,318407,5.1
IL,1995,11,6193464,5879222,314242,5.1
IL,1995,12,6198377,5869507,328870,5.3
IL,1996,1,6208002,5874625,333377,5.4
IL,1996,2,6213818,5882963,330855,5.3
IL,1996,3,6219800,5887040,332760,5.4
IL,1996,4,6229940,5889351,340589,5.5
IL,1996,5,6234384,5892841,341543,5.5
IL,1996,6,6242085,5903325,338760,5.4
IL,1996,7,6241677,5906372,335305,5.4
IL,1996,8,6251131,5915789,335342,5.4
IL,1996,9,6238102,5908188,329914,5.3
IL,1996,10,6249494,5926129,323365,5.2
IL,1996,11,6263698,5946927,316771,5.1
IL,1996,12,6276199,5953781,322418,5.1
IL,1997,1,6272933,5952504,320429,5.1
IL,1997,2,6275324,5960606,314718,5
IL,1997,3,6284424,5972384,312040,5
IL,1997,4,6282426,5977576,304850,4.9
IL,1997,5,6278211,5989805,288406,4.6
IL,1997,6,6281573,5994699,286874,4.6
IL,1997,7,6288289,5993482,294807,4.7
IL,1997,8,6290524,5997725,292799,4.7
IL,1997,9,6289761,5993153,296608,4.7
IL,1997,10,6299595,6002685,296910,4.7
IL,1997,11,6319153,6011388,307765,4.9
IL,1997,12,6327076,6013542,313534,5
IL,1998,1,6329737,6019825,309912,4.9
IL,1998,2,6316667,6024286,292381,4.6
IL,1998,3,6311738,6023584,288154,4.6
IL,1998,4,6293526,6021331,272195,4.3
IL,1998,5,6296842,6030788,266054,4.2
IL,1998,6,6313070,6031011,282059,4.5
IL,1998,7,6327867,6047662,280205,4.4
IL,1998,8,6327001,6049877,277124,4.4
IL,1998,9,6355586,6064963,290623,4.6
IL,1998,10,6361717,6075533,286184,4.5
IL,1998,11,6365257,6079917,285340,4.5
IL,1998,12,6368978,6095826,273152,4.3
IL,1999,1,6363372,6090671,272701,4.3
IL,1999,2,6373072,6107204,265868,4.2
IL,1999,3,6387650,6125767,261883,4.1
IL,1999,4,6403437,6131120,272317,4.3
IL,1999,5,6424507,6129464,295043,4.6
IL,1999,6,6438577,6140716,297861,4.6
IL,1999,7,6462672,6156894,305778,4.7
IL,1999,8,6451735,6147484,304251,4.7
IL,1999,9,6450060,6155584,294476,4.6
IL,1999,10,6460969,6169082,291887,4.5
IL,1999,11,6465677,6177986,287691,4.4
IL,1999,12,6471866,6185593,286273,4.4
IL,2000,1,6474435,6192004,282431,4.4
IL,2000,2,6477018,6187994,289024,4.5
IL,2000,3,6470599,6186628,283971,4.4
IL,2000,4,6472026,6192285,279741,4.3
IL,2000,5,6471362,6187121,284241,4.4
IL,2000,6,6474110,6190249,283861,4.4
IL,2000,7,6456993,6169290,287703,4.5
IL,2000,8,6466125,6175092,291033,4.5
IL,2000,9,6470603,6176889,293714,4.5
IL,2000,10,6461082,6174972,286110,4.4
IL,2000,11,6464789,6155159,309630,4.8
IL,2000,12,6453151,6134356,318795,4.9
IL,2001,1,6454028,6127798,326230,5.1
IL,2001,2,6474060,6141130,332930,5.1
IL,2001,3,6481480,6140309,341171,5.3
IL,2001,4,6481316,6139962,341354,5.3
IL,2001,5,6483799,6143991,339808,5.2
IL,2001,6,6492903,6147933,344970,5.3
IL,2001,7,6473199,6123424,349775,5.4
IL,2001,8,6454382,6099435,354947,5.5
IL,2001,9,6460315,6105125,355190,5.5
IL,2001,10,6446040,6083745,362295,5.6
IL,2001,11,6438728,6060342,378386,5.9
IL,2001,12,6433884,6049240,384644,6
IL,2002,1,6432501,6035276,397225,6.2
IL,2002,2,6433277,6031522,401755,6.2
IL,2002,3,6419269,6007160,412109,6.4
IL,2002,4,6405992,5985296,420696,6.6
IL,2002,5,6396257,5976803,419454,6.6
IL,2002,6,6385417,5960318,425099,6.7
IL,2002,7,6375485,5944699,430786,6.8
IL,2002,8,6361683,5947544,414139,6.5
IL,2002,9,6357310,5940250,417060,6.6
IL,2002,10,6362108,5932715,429393,6.7
IL,2002,11,6365066,5939030,426036,6.7
IL,2002,12,6350664,5932104,418560,6.6
IL,2003,1,6322511,5901378,421133,6.7
IL,2003,2,6320488,5895743,424745,6.7
IL,2003,3,6327591,5900318,427273,6.8
IL,2003,4,6317497,5902504,414993,6.6
IL,2003,5,6326060,5913761,412299,6.5
IL,2003,6,6346572,5919454,427118,6.7
IL,2003,7,6356776,5921284,435492,6.9
IL,2003,8,6360388,5919765,440623,6.9
IL,2003,9,6362702,5923099,439603,6.9
IL,2003,10,6363853,5937301,426552,6.7
IL,2003,11,6360636,5931339,429297,6.7
IL,2003,12,6354198,5936014,418184,6.6
IL,2004,1,6348350,5936503,411847,6.5
IL,2004,2,6348940,5938856,410084,6.5
IL,2004,3,6345552,5942505,403047,6.4
IL,2004,4,6343793,5947835,395958,6.2
IL,2004,5,6357025,5957939,399086,6.3
IL,2004,6,6349701,5961600,388101,6.1
IL,2004,7,6365803,5970794,395009,6.2
IL,2004,8,6368396,5972733,395663,6.2
IL,2004,9,6380234,5989637,390597,6.1
IL,2004,10,6392113,5996452,395661,6.2
IL,2004,11,6389597,5995615,393982,6.2
IL,2004,12,6395944,6012264,383680,6
IL,2005,1,6405557,6025195,380362,5.9
IL,2005,2,6403268,6022902,380366,5.9
IL,2005,3,6404798,6022509,382289,6
IL,2005,4,6419929,6037146,382783,6
IL,2005,5,6422869,6039449,383420,6
IL,2005,6,6415776,6031554,384222,6
IL,2005,7,6431530,6051295,380235,5.9
IL,2005,8,6442156,6070454,371702,5.8
IL,2005,9,6454118,6087125,366993,5.7
IL,2005,10,6453118,6099069,354049,5.5
IL,2005,11,6464006,6120384,343622,5.3
IL,2005,12,6480297,6128682,351615,5.4
IL,2006,1,6498004,6158215,339789,5.2
IL,2006,2,6505147,6184885,320262,4.9
IL,2006,3,6518551,6196789,321762,4.9
IL,2006,4,6521753,6214481,307272,4.7
IL,2006,5,6528896,6230685,298211,4.6
IL,2006,6,6547207,6253270,293937,4.5
IL,2006,7,6559928,6267634,292294,4.5
IL,2006,8,6588564,6288839,299725,4.5
IL,2006,9,6595993,6301951,294042,4.5
IL,2006,10,6598604,6312914,285690,4.3
IL,2006,11,6604672,6320660,284012,4.3
IL,2006,12,6628182,6331698,296484,4.5
IL,2007,1,6637196,6326300,310896,4.7
IL,2007,2,6641811,6317251,324560,4.9
IL,2007,3,6642308,6331951,310357,4.7
IL,2007,4,6661297,6336010,325287,4.9
IL,2007,5,6674537,6345817,328720,4.9
IL,2007,6,6701820,6362549,339271,5.1
IL,2007,7,6709841,6365197,344644,5.1
IL,2007,8,6709689,6359423,350266,5.2
IL,2007,9,6717553,6364417,353136,5.3
IL,2007,10,6720068,6355621,364447,5.4
IL,2007,11,6728642,6362991,365651,5.4
IL,2007,12,6730873,6356276,374597,5.6
IL,2008,1,6740603,6350005,390598,5.8
IL,2008,2,6738121,6341942,396179,5.9
IL,2008,3,6726327,6325805,400522,6
IL,2008,4,6727466,6311645,415821,6.2
IL,2008,5,6721065,6292004,429061,6.4
IL,2008,6,6700653,6259890,440763,6.6
IL,2008,7,6694696,6247683,447013,6.7
IL,2008,8,6682289,6236603,445686,6.7
IL,2008,9,6671152,6226522,444630,6.7
IL,2008,10,6654479,6203249,451230,6.8
IL,2008,11,6652844,6190642,462202,6.9
IL,2008,12,6658332,6177826,480506,7.2
IL,2009,1,6601436,6082800,518636,7.9
IN,1976,1,2423556,2256087,167469,6.9
IN,1976,2,2420139,2262444,157695,6.5
IN,1976,3,2424416,2267548,156868,6.5
IN,1976,4,2420352,2271290,149062,6.2
IN,1976,5,2418096,2275227,142869,5.9
IN,1976,6,2423119,2283359,139760,5.8
IN,1976,7,2432809,2292773,140036,5.8
IN,1976,8,2439277,2295725,143552,5.9
IN,1976,9,2445122,2300938,144184,5.9
IN,1976,10,2451000,2301245,149755,6.1
IN,1976,11,2447422,2301821,145601,5.9
IN,1976,12,2445164,2306976,138188,5.7
IN,1977,1,2445390,2309423,135967,5.6
IN,1977,2,2470990,2314741,156249,6.3
IN,1977,3,2459328,2322468,136860,5.6
IN,1977,4,2465950,2332422,133528,5.4
IN,1977,5,2484865,2343463,141402,5.7
IN,1977,6,2499041,2356012,143029,5.7
IN,1977,7,2504974,2359478,145496,5.8
IN,1977,8,2509730,2363742,145988,5.8
IN,1977,9,2518165,2369968,148197,5.9
IN,1977,10,2520262,2376371,143891,5.7
IN,1977,11,2528023,2384506,143517,5.7
IN,1977,12,2533583,2385519,148064,5.8
IN,1978,1,2540785,2397209,143576,5.7
IN,1978,2,2551453,2403708,147745,5.8
IN,1978,3,2558448,2409288,149160,5.8
IN,1978,4,2572656,2424465,148191,5.8
IN,1978,5,2579525,2437578,141947,5.5
IN,1978,6,2590923,2447325,143598,5.5
IN,1978,7,2605400,2462448,142952,5.5
IN,1978,8,2612934,2470796,142138,5.4
IN,1978,9,2618170,2473072,145098,5.5
IN,1978,10,2619198,2477238,141960,5.4
IN,1978,11,2621401,2482115,139286,5.3
IN,1978,12,2628420,2488011,140409,5.3
IN,1979,1,2626781,2488582,138199,5.3
IN,1979,2,2635472,2489965,145507,5.5
IN,1979,3,2639852,2493952,145900,5.5
IN,1979,4,2645083,2490069,155014,5.9
IN,1979,5,2649428,2494521,154907,5.8
IN,1979,6,2645728,2486414,159314,6
IN,1979,7,2653454,2480091,173363,6.5
IN,1979,8,2659315,2472138,187177,7
IN,1979,9,2652093,2465846,186247,7
IN,1979,10,2648721,2458850,189871,7.2
IN,1979,11,2640184,2448985,191199,7.2
IN,1979,12,2647596,2436732,210864,8
IN,1980,1,2636488,2423530,212958,8.1
IN,1980,2,2636290,2412726,223564,8.5
IN,1980,3,2632400,2399800,232600,8.8
IN,1980,4,2627731,2383499,244232,9.3
IN,1980,5,2640645,2369648,270997,10.3
IN,1980,6,2656908,2362157,294751,11.1
IN,1980,7,2637661,2349333,288328,10.9
IN,1980,8,2625313,2348779,276534,10.5
IN,1980,9,2611834,2348279,263555,10.1
IN,1980,10,2602201,2355824,246377,9.5
IN,1980,11,2602464,2362897,239567,9.2
IN,1980,12,2610274,2369235,241039,9.2
IN,1981,1,2620019,2375565,244454,9.3
IN,1981,2,2623073,2377401,245672,9.4
IN,1981,3,2624616,2379636,244980,9.3
IN,1981,4,2625646,2379915,245731,9.4
IN,1981,5,2620482,2374984,245498,9.4
IN,1981,6,2614406,2371939,242467,9.3
IN,1981,7,2613088,2369969,243119,9.3
IN,1981,8,2613096,2368341,244755,9.4
IN,1981,9,2611830,2363551,248279,9.5
IN,1981,10,2615315,2355007,260308,10
IN,1981,11,2618671,2343355,275316,10.5
IN,1981,12,2626518,2329698,296820,11.3
IN,1982,1,2629990,2319930,310060,11.8
IN,1982,2,2616185,2312957,303228,11.6
IN,1982,3,2615724,2305397,310327,11.9
IN,1982,4,2609850,2299190,310660,11.9
IN,1982,5,2595880,2295835,300045,11.6
IN,1982,6,2584301,2287992,296309,11.5
IN,1982,7,2578379,2282238,296141,11.5
IN,1982,8,2573531,2276083,297448,11.6
IN,1982,9,2582181,2274982,307199,11.9
IN,1982,10,2591355,2270751,320604,12.4
IN,1982,11,2599474,2265474,334000,12.8
IN,1982,12,2591045,2266585,324460,12.5
IN,1983,1,2595035,2266565,328470,12.7
IN,1983,2,2589218,2268724,320494,12.4
IN,1983,3,2583406,2271560,311846,12.1
IN,1983,4,2572570,2270349,302221,11.7
IN,1983,5,2566095,2275178,290917,11.3
IN,1983,6,2564583,2283857,280726,10.9
IN,1983,7,2570376,2296232,274144,10.7
IN,1983,8,2575913,2303302,272611,10.6
IN,1983,9,2585193,2317944,267249,10.3
IN,1983,10,2594331,2327572,266759,10.3
IN,1983,11,2598369,2337646,260723,10
IN,1983,12,2597962,2347582,250380,9.6
IN,1984,1,2613435,2362678,250757,9.6
IN,1984,2,2610753,2377086,233667,9
IN,1984,3,2614358,2382818,231540,8.9
IN,1984,4,2622507,2395340,227167,8.7
IN,1984,5,2625311,2404692,220619,8.4
IN,1984,6,2622507,2412890,209617,8
IN,1984,7,2621134,2415423,205711,7.8
IN,1984,8,2626160,2422088,204072,7.8
IN,1984,9,2639764,2423427,216337,8.2
IN,1984,10,2644577,2430348,214229,8.1
IN,1984,11,2655820,2436524,219296,8.3
IN,1984,12,2661328,2442958,218370,8.2
IN,1985,1,2662976,2446217,216759,8.1
IN,1985,2,2672536,2447790,224746,8.4
IN,1985,3,2673441,2458328,215113,8
IN,1985,4,2675390,2465567,209823,7.8
IN,1985,5,2678176,2468955,209221,7.8
IN,1985,6,2678459,2468961,209498,7.8
IN,1985,7,2671912,2473846,198066,7.4
IN,1985,8,2681095,2479102,201993,7.5
IN,1985,9,2685133,2484520,200613,7.5
IN,1985,10,2686806,2490680,196126,7.3
IN,1985,11,2694796,2497579,197217,7.3
IN,1985,12,2698717,2503102,195615,7.2
IN,1986,1,2702900,2511916,190984,7.1
IN,1986,2,2706799,2518744,188055,6.9
IN,1986,3,2713940,2522634,191306,7
IN,1986,4,2713859,2525183,188676,7
IN,1986,5,2714849,2526927,187922,6.9
IN,1986,6,2710529,2531489,179040,6.6
IN,1986,7,2708568,2537563,171005,6.3
IN,1986,8,2720160,2542320,177840,6.5
IN,1986,9,2728832,2545217,183615,6.7
IN,1986,10,2734103,2550406,183697,6.7
IN,1986,11,2735985,2552561,183424,6.7
IN,1986,12,2734789,2555062,179727,6.6
IN,1987,1,2738209,2556182,182027,6.6
IN,1987,2,2735973,2560990,174983,6.4
IN,1987,3,2738177,2565297,172880,6.3
IN,1987,4,2747018,2573187,173831,6.3
IN,1987,5,2749163,2577215,171948,6.3
IN,1987,6,2748519,2580149,168370,6.1
IN,1987,7,2745904,2581916,163988,6
IN,1987,8,2752228,2587824,164404,6
IN,1987,9,2758394,2594963,163431,5.9
IN,1987,10,2759940,2600188,159752,5.8
IN,1987,11,2759762,2606345,153417,5.6
IN,1987,12,2763518,2614094,149424,5.4
IN,1988,1,2767007,2621031,145976,5.3
IN,1988,2,2770441,2624101,146340,5.3
IN,1988,3,2776796,2629138,147658,5.3
IN,1988,4,2778754,2636316,142438,5.1
IN,1988,5,2785868,2643369,142499,5.1
IN,1988,6,2791279,2651031,140248,5
IN,1988,7,2801117,2657023,144094,5.1
IN,1988,8,2808632,2663065,145567,5.2
IN,1988,9,2819149,2672571,146578,5.2
IN,1988,10,2826698,2680857,145841,5.2
IN,1988,11,2832493,2690078,142415,5
IN,1988,12,2836990,2697702,139288,4.9
IN,1989,1,2836094,2704312,131782,4.6
IN,1989,2,2840767,2711725,129042,4.5
IN,1989,3,2842569,2717613,124956,4.4
IN,1989,4,2851878,2724249,127629,4.5
IN,1989,5,2856123,2726950,129173,4.5
IN,1989,6,2863850,2733464,130386,4.6
IN,1989,7,2867029,2730195,136834,4.8
IN,1989,8,2864632,2727480,137152,4.8
IN,1989,9,2858882,2718984,139898,4.9
IN,1989,10,2858522,2714681,143841,5
IN,1989,11,2853712,2712659,141053,4.9
IN,1989,12,2847647,2709071,138576,4.9
IN,1990,1,2848043,2707701,140342,4.9
IN,1990,2,2844361,2705066,139295,4.9
IN,1990,3,2841790,2700228,141562,5
IN,1990,4,2835734,2688982,146752,5.2
IN,1990,5,2830340,2688260,142080,5
IN,1990,6,2826475,2688381,138094,4.9
IN,1990,7,2827975,2691665,136310,4.8
IN,1990,8,2829442,2688827,140615,5
IN,1990,9,2823665,2685534,138131,4.9
IN,1990,10,2817658,2679506,138152,4.9
IN,1990,11,2822315,2672807,149508,5.3
IN,1990,12,2818811,2669333,149478,5.3
IN,1991,1,2816772,2660724,156048,5.5
IN,1991,2,2820663,2654696,165967,5.9
IN,1991,3,2829113,2651228,177885,6.3
IN,1991,4,2814205,2653987,160218,5.7
IN,1991,5,2815208,2655128,160080,5.7
IN,1991,6,2812991,2655349,157642,5.6
IN,1991,7,2808639,2654678,153961,5.5
IN,1991,8,2808664,2658543,150121,5.3
IN,1991,9,2809895,2660258,149637,5.3
IN,1991,10,2814020,2660809,153211,5.4
IN,1991,11,2819709,2664431,155278,5.5
IN,1991,12,2825105,2665655,159450,5.6
IN,1992,1,2835923,2670630,165293,5.8
IN,1992,2,2843060,2675886,167174,5.9
IN,1992,3,2851993,2680109,171884,6
IN,1992,4,2865059,2688181,176878,6.2
IN,1992,5,2875976,2694854,181122,6.3
IN,1992,6,2882538,2701065,181473,6.3
IN,1992,7,2888845,2709206,179639,6.2
IN,1992,8,2892319,2713363,178956,6.2
IN,1992,9,2895475,2717067,178408,6.2
IN,1992,10,2896254,2724556,171698,5.9
IN,1992,11,2899968,2728807,171161,5.9
IN,1992,12,2905860,2737114,168746,5.8
IN,1993,1,2911494,2748664,162830,5.6
IN,1993,2,2917696,2756765,160931,5.5
IN,1993,3,2929149,2764782,164367,5.6
IN,1993,4,2950222,2775865,174357,5.9
IN,1993,5,2962561,2783035,179526,6.1
IN,1993,6,2977593,2796100,181493,6.1
IN,1993,7,2923482,2808360,115122,3.9
IN,1993,8,2934569,2815818,118751,4
IN,1993,9,2944505,2821923,122582,4.2
IN,1993,10,2962468,2835912,126556,4.3
IN,1993,11,2975018,2845929,129089,4.3
IN,1993,12,2991212,2855714,135498,4.5
IN,1994,1,2995722,2864156,131566,4.4
IN,1994,2,3010478,2875001,135477,4.5
IN,1994,3,3020104,2884122,135982,4.5
IN,1994,4,3025730,2887963,137767,4.6
IN,1994,5,3036318,2896556,139762,4.6
IN,1994,6,3044606,2904374,140232,4.6
IN,1994,7,3059782,2913447,146335,4.8
IN,1994,8,3066869,2924104,142765,4.7
IN,1994,9,3077392,2936264,141128,4.6
IN,1994,10,3080675,2940649,140026,4.5
IN,1994,11,3086260,2952275,133985,4.3
IN,1994,12,3094621,2962464,132157,4.3
IN,1995,1,3097347,2970713,126634,4.1
IN,1995,2,3103665,2974659,129006,4.2
IN,1995,3,3110287,2978663,131624,4.2
IN,1995,4,3116381,2977038,139343,4.5
IN,1995,5,3114542,2974839,139703,4.5
IN,1995,6,3115753,2974680,141073,4.5
IN,1995,7,3114140,2974602,139538,4.5
IN,1995,8,3113070,2977465,135605,4.4
IN,1995,9,3116150,2983615,132535,4.3
IN,1995,10,3117990,2982278,135712,4.4
IN,1995,11,3116931,2980317,136614,4.4
IN,1995,12,3111175,2980413,130762,4.2
IN,1996,1,3105158,2974097,131061,4.2
IN,1996,2,3105579,2976746,128833,4.1
IN,1996,3,3102606,2975451,127155,4.1
IN,1996,4,3105867,2977248,128619,4.1
IN,1996,5,3105654,2979581,126073,4.1
IN,1996,6,3103705,2978493,125212,4
IN,1996,7,3096441,2976520,119921,3.9
IN,1996,8,3099485,2982669,116816,3.8
IN,1996,9,3103404,2986522,116882,3.8
IN,1996,10,3103823,2991346,112477,3.6
IN,1996,11,3103401,2996030,107371,3.5
IN,1996,12,3100748,2998292,102456,3.3
IN,1997,1,3098831,3002243,96588,3.1
IN,1997,2,3102738,3006387,96351,3.1
IN,1997,3,3110991,3011315,99676,3.2
IN,1997,4,3117094,3013672,103422,3.3
IN,1997,5,3119944,3015144,104800,3.4
IN,1997,6,3120398,3013939,106459,3.4
IN,1997,7,3125790,3018988,106802,3.4
IN,1997,8,3125404,3015298,110106,3.5
IN,1997,9,3124409,3016179,108230,3.5
IN,1997,10,3126385,3018523,107862,3.5
IN,1997,11,3121095,3019957,101138,3.2
IN,1997,12,3122139,3022345,99794,3.2
IN,1998,1,3119519,3028630,90889,2.9
IN,1998,2,3118596,3029154,89442,2.9
IN,1998,3,3121258,3029553,91705,2.9
IN,1998,4,3119248,3031855,87393,2.8
IN,1998,5,3120489,3032126,88363,2.8
IN,1998,6,3120937,3032510,88427,2.8
IN,1998,7,3126270,3026796,99474,3.2
IN,1998,8,3123971,3030496,93475,3
IN,1998,9,3128658,3032075,96583,3.1
IN,1998,10,3128241,3037987,90254,2.9
IN,1998,11,3133664,3043673,89991,2.9
IN,1998,12,3133247,3046467,86780,2.8
IN,1999,1,3131113,3044400,86713,2.8
IN,1999,2,3124831,3044299,80532,2.6
IN,1999,3,3127155,3045444,81711,2.6
IN,1999,4,3131155,3048799,82356,2.6
IN,1999,5,3137251,3047494,89757,2.9
IN,1999,6,3138165,3047400,90765,2.9
IN,1999,7,3133738,3046968,86770,2.8
IN,1999,8,3137040,3041805,95235,3
IN,1999,9,3141110,3043431,97679,3.1
IN,1999,10,3144148,3048157,95991,3.1
IN,1999,11,3146105,3050654,95451,3
IN,1999,12,3147165,3054216,92949,3
IN,2000,1,3143996,3055358,88638,2.8
IN,2000,2,3147257,3055020,92237,2.9
IN,2000,3,3146469,3057062,89407,2.8
IN,2000,4,3148909,3056542,92367,2.9
IN,2000,5,3152047,3058701,93346,3
IN,2000,6,3152333,3055105,97228,3.1
IN,2000,7,3148427,3054466,93961,3
IN,2000,8,3146794,3052983,93811,3
IN,2000,9,3138737,3053196,85541,2.7
IN,2000,10,3133244,3047075,86169,2.8
IN,2000,11,3136060,3044374,91686,2.9
IN,2000,12,3138277,3042746,95531,3
IN,2001,1,3151366,3038823,112543,3.6
IN,2001,2,3144245,3037760,106485,3.4
IN,2001,3,3151645,3038261,113384,3.6
IN,2001,4,3149892,3034407,115485,3.7
IN,2001,5,3147626,3027479,120147,3.8
IN,2001,6,3149919,3021389,128530,4.1
IN,2001,7,3152379,3017964,134415,4.3
IN,2001,8,3153762,3017906,135856,4.3
IN,2001,9,3151814,3012715,139099,4.4
IN,2001,10,3156738,3006256,150482,4.8
IN,2001,11,3158757,3001876,156881,5
IN,2001,12,3157475,2996980,160495,5.1
IN,2002,1,3170230,3002669,167561,5.3
IN,2002,2,3169331,3001952,167379,5.3
IN,2002,3,3164203,2998343,165860,5.2
IN,2002,4,3168409,2998019,170390,5.4
IN,2002,5,3164015,3000188,163827,5.2
IN,2002,6,3168181,3002385,165796,5.2
IN,2002,7,3164457,3004378,160079,5.1
IN,2002,8,3168081,3006564,161517,5.1
IN,2002,9,3163324,3003882,159442,5
IN,2002,10,3161406,3001200,160206,5.1
IN,2002,11,3162961,3003701,159260,5
IN,2002,12,3164617,3006904,157713,5
IN,2003,1,3156803,2999081,157722,5
IN,2003,2,3159144,2997211,161933,5.1
IN,2003,3,3160004,2995618,164386,5.2
IN,2003,4,3163933,2994319,169614,5.4
IN,2003,5,3163402,2997376,166026,5.2
IN,2003,6,3166614,2997049,169565,5.4
IN,2003,7,3182112,2997331,184781,5.8
IN,2003,8,3175616,3001176,174440,5.5
IN,2003,9,3167221,2997880,169341,5.3
IN,2003,10,3168009,3000596,167413,5.3
IN,2003,11,3164132,2998655,165477,5.2
IN,2003,12,3164745,2997874,166871,5.3
IN,2004,1,3162980,2996567,166413,5.3
IN,2004,2,3160123,2991917,168206,5.3
IN,2004,3,3160515,2994552,165963,5.3
IN,2004,4,3158209,2997050,161159,5.1
IN,2004,5,3158227,2994637,163590,5.2
IN,2004,6,3161784,2996867,164917,5.2
IN,2004,7,3173093,3000333,172760,5.4
IN,2004,8,3164880,2996986,167894,5.3
IN,2004,9,3166772,2998526,168246,5.3
IN,2004,10,3172094,3000474,171620,5.4
IN,2004,11,3171869,3002131,169738,5.4
IN,2004,12,3173058,3003563,169495,5.3
IN,2005,1,3182494,3004234,178260,5.6
IN,2005,2,3186318,3010134,176184,5.5
IN,2005,3,3187765,3012385,175380,5.5
IN,2005,4,3185899,3019139,166760,5.2
IN,2005,5,3186882,3020846,166036,5.2
IN,2005,6,3193372,3021833,171539,5.4
IN,2005,7,3202297,3028302,173995,5.4
IN,2005,8,3206564,3031139,175425,5.5
IN,2005,9,3214240,3041545,172695,5.4
IN,2005,10,3216743,3045331,171412,5.3
IN,2005,11,3216793,3051673,165120,5.1
IN,2005,12,3221865,3055073,166792,5.2
IN,2006,1,3226107,3064521,161586,5
IN,2006,2,3234514,3070041,164473,5.1
IN,2006,3,3233580,3072797,160783,5
IN,2006,4,3230376,3072534,157842,4.9
IN,2006,5,3238673,3073438,165235,5.1
IN,2006,6,3240485,3075487,164998,5.1
IN,2006,7,3238959,3074129,164830,5.1
IN,2006,8,3237685,3075214,162471,5
IN,2006,9,3237262,3078177,159085,4.9
IN,2006,10,3236293,3078979,157314,4.9
IN,2006,11,3232061,3079992,152069,4.7
IN,2006,12,3235579,3083810,151769,4.7
IN,2007,1,3234782,3080762,154020,4.8
IN,2007,2,3232101,3077067,155034,4.8
IN,2007,3,3229451,3080615,148836,4.6
IN,2007,4,3223948,3077044,146904,4.6
IN,2007,5,3216360,3074007,142353,4.4
IN,2007,6,3219997,3075136,144861,4.5
IN,2007,7,3213280,3072222,141058,4.4
IN,2007,8,3217342,3072330,145012,4.5
IN,2007,9,3216425,3070992,145433,4.5
IN,2007,10,3213689,3067336,146353,4.6
IN,2007,11,3218352,3070394,147958,4.6
IN,2007,12,3216920,3071042,145878,4.5
IN,2008,1,3222717,3067978,154739,4.8
IN,2008,2,3226342,3064044,162298,5
IN,2008,3,3226776,3055878,170898,5.3
IN,2008,4,3225319,3052329,172990,5.4
IN,2008,5,3224739,3052322,172417,5.3
IN,2008,6,3226402,3045208,181194,5.6
IN,2008,7,3234314,3041313,193001,6
IN,2008,8,3232172,3038298,193874,6
IN,2008,9,3228958,3030805,198153,6.1
IN,2008,10,3232075,3025564,206511,6.4
IN,2008,11,3236966,3010540,226426,7
IN,2008,12,3247625,2993265,254360,7.8
IN,2009,1,3251063,2950371,300692,9.2
IA,1976,1,1327591,1273812,53779,4.1
IA,1976,2,1328236,1274185,54051,4.1
IA,1976,3,1330327,1276060,54267,4.1
IA,1976,4,1330916,1276484,54432,4.1
IA,1976,5,1331097,1276545,54552,4.1
IA,1976,6,1334059,1279426,54633,4.1
IA,1976,7,1338699,1284015,54684,4.1
IA,1976,8,1343409,1288697,54712,4.1
IA,1976,9,1344960,1290233,54727,4.1
IA,1976,10,1347328,1292599,54729,4.1
IA,1976,11,1351512,1296793,54719,4
IA,1976,12,1356064,1301371,54693,4
IA,1977,1,1362323,1307678,54645,4
IA,1977,2,1367345,1312729,54616,4
IA,1977,3,1370931,1316329,54602,4
IA,1977,4,1372265,1317671,54594,4
IA,1977,5,1374320,1319733,54587,4
IA,1977,6,1380323,1325745,54578,4
IA,1977,7,1384657,1330093,54564,3.9
IA,1977,8,1386892,1332349,54543,3.9
IA,1977,9,1390168,1335653,54515,3.9
IA,1977,10,1395088,1340597,54491,3.9
IA,1977,11,1400989,1346515,54474,3.9
IA,1977,12,1403602,1349124,54478,3.9
IA,1978,1,1403729,1349222,54507,3.9
IA,1978,2,1405080,1350533,54547,3.9
IA,1978,3,1408359,1353759,54600,3.9
IA,1978,4,1413717,1359046,54671,3.9
IA,1978,5,1416767,1361999,54768,3.9
IA,1978,6,1417500,1362599,54901,3.9
IA,1978,7,1418600,1363520,55080,3.9
IA,1978,8,1419849,1364543,55306,3.9
IA,1978,9,1420804,1365215,55589,3.9
IA,1978,10,1419139,1363211,55928,3.9
IA,1978,11,1415300,1358977,56323,4
IA,1978,12,1418265,1361500,56765,4
IA,1979,1,1419569,1362311,57258,4
IA,1979,2,1423285,1365430,57855,4.1
IA,1979,3,1423405,1364844,58561,4.1
IA,1979,4,1424500,1365122,59378,4.2
IA,1979,5,1427465,1367158,60307,4.2
IA,1979,6,1429111,1367759,61352,4.3
IA,1979,7,1429924,1367420,62504,4.4
IA,1979,8,1429395,1365633,63762,4.5
IA,1979,9,1432554,1367433,65121,4.5
IA,1979,10,1433953,1367370,66583,4.6
IA,1979,11,1434938,1366790,68148,4.7
IA,1979,12,1433010,1363202,69808,4.9
IA,1980,1,1434393,1362831,71562,5
IA,1980,2,1432948,1359620,73328,5.1
IA,1980,3,1434302,1359205,75097,5.2
IA,1980,4,1433261,1356396,76865,5.4
IA,1980,5,1432282,1353661,78621,5.5
IA,1980,6,1433087,1352737,80350,5.6
IA,1980,7,1434706,1352664,82042,5.7
IA,1980,8,1429415,1345723,83692,5.9
IA,1980,9,1429045,1343748,85297,6
IA,1980,10,1427512,1340660,86852,6.1
IA,1980,11,1426513,1338158,88355,6.2
IA,1980,12,1426105,1336303,89802,6.3
IA,1981,1,1425688,1334498,91190,6.4
IA,1981,2,1425532,1332926,92606,6.5
IA,1981,3,1428478,1334432,94046,6.6
IA,1981,4,1428020,1332512,95508,6.7
IA,1981,5,1425536,1328547,96989,6.8
IA,1981,6,1426821,1328334,98487,6.9
IA,1981,7,1427461,1327468,99993,7
IA,1981,8,1426377,1324878,101499,7.1
IA,1981,9,1424138,1321139,102999,7.2
IA,1981,10,1426986,1322499,104487,7.3
IA,1981,11,1424315,1318355,105960,7.4
IA,1981,12,1422389,1314977,107412,7.6
IA,1982,1,1421537,1312699,108838,7.7
IA,1982,2,1419843,1309633,110210,7.8
IA,1982,3,1415160,1303637,111523,7.9
IA,1982,4,1413110,1300340,112770,8
IA,1982,5,1412836,1298887,113949,8.1
IA,1982,6,1410958,1295902,115056,8.2
IA,1982,7,1411612,1295526,116086,8.2
IA,1982,8,1411730,1294690,117040,8.3
IA,1982,9,1413011,1295094,117917,8.3
IA,1982,10,1414685,1295976,118709,8.4
IA,1982,11,1417995,1298581,119414,8.4
IA,1982,12,1415235,1295205,120030,8.5
IA,1983,1,1414030,1293472,120558,8.5
IA,1983,2,1416599,1295743,120856,8.5
IA,1983,3,1416277,1295350,120927,8.5
IA,1983,4,1415232,1294455,120777,8.5
IA,1983,5,1415772,1295357,120415,8.5
IA,1983,6,1419851,1300002,119849,8.4
IA,1983,7,1421898,1302804,119094,8.4
IA,1983,8,1423517,1305355,118162,8.3
IA,1983,9,1424057,1306992,117065,8.2
IA,1983,10,1425895,1310083,115812,8.1
IA,1983,11,1422906,1308492,114414,8
IA,1983,12,1421600,1308723,112877,7.9
IA,1984,1,1423080,1311874,111206,7.8
IA,1984,2,1420076,1310502,109574,7.7
IA,1984,3,1420354,1312376,107978,7.6
IA,1984,4,1418445,1312024,106421,7.5
IA,1984,5,1420114,1315209,104905,7.4
IA,1984,6,1418154,1314721,103433,7.3
IA,1984,7,1419017,1317009,102008,7.2
IA,1984,8,1415435,1314803,100632,7.1
IA,1984,9,1414434,1315131,99303,7
IA,1984,10,1412287,1314268,98019,6.9
IA,1984,11,1411979,1315200,96779,6.9
IA,1984,12,1407265,1311685,95580,6.8
IA,1985,1,1431052,1310796,120256,8.4
IA,1985,2,1430665,1311576,119089,8.3
IA,1985,3,1430642,1312737,117905,8.2
IA,1985,4,1429533,1312830,116703,8.2
IA,1985,5,1427847,1312361,115486,8.1
IA,1985,6,1426578,1312316,114262,8
IA,1985,7,1427263,1314233,113030,7.9
IA,1985,8,1427171,1315378,111793,7.8
IA,1985,9,1427653,1317106,110547,7.7
IA,1985,10,1429519,1320230,109289,7.6
IA,1985,11,1430293,1322274,108019,7.6
IA,1985,12,1431109,1324380,106729,7.5
IA,1986,1,1432854,1327432,105422,7.4
IA,1986,2,1433632,1329510,104122,7.3
IA,1986,3,1433621,1330797,102824,7.2
IA,1986,4,1438231,1336703,101528,7.1
IA,1986,5,1440996,1340762,100234,7
IA,1986,6,1443443,1344500,98943,6.9
IA,1986,7,1444646,1346991,97655,6.8
IA,1986,8,1448106,1351728,96378,6.7
IA,1986,9,1451958,1356841,95117,6.6
IA,1986,10,1452845,1358962,93883,6.5
IA,1986,11,1455032,1362347,92685,6.4
IA,1986,12,1455805,1364274,91531,6.3
IA,1987,1,1457995,1367564,90431,6.2
IA,1987,2,1458113,1368803,89310,6.1
IA,1987,3,1459326,1371154,88172,6
IA,1987,4,1457046,1370030,87016,6
IA,1987,5,1457222,1371381,85841,5.9
IA,1987,6,1455774,1371131,84643,5.8
IA,1987,7,1454114,1370696,83418,5.7
IA,1987,8,1455536,1373371,82165,5.6
IA,1987,9,1457693,1376808,80885,5.5
IA,1987,10,1459069,1379490,79579,5.5
IA,1987,11,1461315,1383063,78252,5.4
IA,1987,12,1465621,1388710,76911,5.2
IA,1988,1,1468179,1392616,75563,5.1
IA,1988,2,1469835,1395546,74289,5.1
IA,1988,3,1473847,1400761,73086,5
IA,1988,4,1480072,1408119,71953,4.9
IA,1988,5,1482557,1411664,70893,4.8
IA,1988,6,1488829,1418918,69911,4.7
IA,1988,7,1490784,1421774,69010,4.6
IA,1988,8,1493291,1425094,68197,4.6
IA,1988,9,1496738,1429265,67473,4.5
IA,1988,10,1498746,1431901,66845,4.5
IA,1988,11,1501385,1435075,66310,4.4
IA,1988,12,1504451,1438583,65868,4.4
IA,1989,1,1507669,1442148,65521,4.3
IA,1989,2,1507492,1442258,65234,4.3
IA,1989,3,1507451,1442442,65009,4.3
IA,1989,4,1508023,1443183,64840,4.3
IA,1989,5,1505060,1440337,64723,4.3
IA,1989,6,1500630,1435980,64650,4.3
IA,1989,7,1499311,1434701,64610,4.3
IA,1989,8,1497240,1432648,64592,4.3
IA,1989,9,1491854,1427262,64592,4.3
IA,1989,10,1489581,1424975,64606,4.3
IA,1989,11,1483895,1419264,64631,4.4
IA,1989,12,1479327,1414661,64666,4.4
IA,1990,1,1470560,1405846,64714,4.4
IA,1990,2,1466003,1401216,64787,4.4
IA,1990,3,1463425,1398538,64887,4.4
IA,1990,4,1461004,1395990,65014,4.4
IA,1990,5,1458096,1392928,65168,4.5
IA,1990,6,1456466,1391120,65346,4.5
IA,1990,7,1456131,1390580,65551,4.5
IA,1990,8,1454093,1388318,65775,4.5
IA,1990,9,1453418,1387408,66010,4.5
IA,1990,10,1453875,1387628,66247,4.6
IA,1990,11,1455427,1388948,66479,4.6
IA,1990,12,1457804,1391107,66697,4.6
IA,1991,1,1460180,1393283,66897,4.6
IA,1991,2,1462960,1395876,67084,4.6
IA,1991,3,1465935,1398680,67255,4.6
IA,1991,4,1471760,1404347,67413,4.6
IA,1991,5,1472891,1405336,67555,4.6
IA,1991,6,1472696,1405015,67681,4.6
IA,1991,7,1475252,1407462,67790,4.6
IA,1991,8,1479719,1411832,67887,4.6
IA,1991,9,1481552,1413583,67969,4.6
IA,1991,10,1485195,1417156,68039,4.6
IA,1991,11,1491957,1423861,68096,4.6
IA,1991,12,1496465,1428328,68137,4.6
IA,1992,1,1498717,1430556,68161,4.5
IA,1992,2,1498518,1430355,68163,4.5
IA,1992,3,1500187,1432049,68138,4.5
IA,1992,4,1500908,1432825,68083,4.5
IA,1992,5,1501961,1433962,67999,4.5
IA,1992,6,1504377,1436486,67891,4.5
IA,1992,7,1509522,1441759,67763,4.5
IA,1992,8,1514073,1446450,67623,4.5
IA,1992,9,1515175,1447697,67478,4.5
IA,1992,10,1518164,1450841,67323,4.4
IA,1992,11,1522351,1455190,67161,4.4
IA,1992,12,1525800,1458797,67003,4.4
IA,1993,1,1529413,1462564,66849,4.4
IA,1993,2,1533139,1466499,66640,4.3
IA,1993,3,1536054,1469676,66378,4.3
IA,1993,4,1539159,1473093,66066,4.3
IA,1993,5,1542530,1476817,65713,4.3
IA,1993,6,1547180,1481865,65315,4.2
IA,1993,7,1546937,1482062,64875,4.2
IA,1993,8,1550754,1486364,64390,4.2
IA,1993,9,1551413,1487543,63870,4.1
IA,1993,10,1554743,1491425,63318,4.1
IA,1993,11,1555355,1492622,62733,4
IA,1993,12,1556591,1494476,62115,4
IA,1994,1,1558021,1496553,61468,3.9
IA,1994,2,1561777,1500925,60852,3.9
IA,1994,3,1561830,1501556,60274,3.9
IA,1994,4,1562725,1502985,59740,3.8
IA,1994,5,1567068,1507820,59248,3.8
IA,1994,6,1569525,1510723,58802,3.7
IA,1994,7,1572743,1514341,58402,3.7
IA,1994,8,1573526,1515470,58056,3.7
IA,1994,9,1575810,1518057,57753,3.7
IA,1994,10,1574685,1517193,57492,3.7
IA,1994,11,1576377,1519104,57273,3.6
IA,1994,12,1575410,1518316,57094,3.6
IA,1995,1,1578627,1521674,56953,3.6
IA,1995,2,1576833,1519969,56864,3.6
IA,1995,3,1578576,1521753,56823,3.6
IA,1995,4,1578720,1521887,56833,3.6
IA,1995,5,1580859,1523969,56890,3.6
IA,1995,6,1582816,1525821,56995,3.6
IA,1995,7,1582900,1525756,57144,3.6
IA,1995,8,1585471,1528134,57337,3.6
IA,1995,9,1589518,1531950,57568,3.6
IA,1995,10,1595126,1537297,57829,3.6
IA,1995,11,1596671,1538554,58117,3.6
IA,1995,12,1597327,1538898,58429,3.7
IA,1996,1,1600242,1541487,58755,3.7
IA,1996,2,1604938,1545958,58980,3.7
IA,1996,3,1605885,1546783,59102,3.7
IA,1996,4,1609299,1550179,59120,3.7
IA,1996,5,1612128,1553097,59031,3.7
IA,1996,6,1611965,1553131,58834,3.6
IA,1996,7,1610837,1552301,58536,3.6
IA,1996,8,1613031,1554900,58131,3.6
IA,1996,9,1612710,1555087,57623,3.6
IA,1996,10,1609237,1552230,57007,3.5
IA,1996,11,1610267,1553988,56279,3.5
IA,1996,12,1610696,1555255,55441,3.4
IA,1997,1,1609187,1554690,54497,3.4
IA,1997,2,1610155,1556561,53594,3.3
IA,1997,3,1611916,1559176,52740,3.3
IA,1997,4,1609371,1557428,51943,3.2
IA,1997,5,1609235,1558028,51207,3.2
IA,1997,6,1607913,1557374,50539,3.1
IA,1997,7,1605740,1555794,49946,3.1
IA,1997,8,1602653,1553219,49434,3.1
IA,1997,9,1603759,1554760,48999,3.1
IA,1997,10,1603095,1554459,48636,3
IA,1997,11,1601251,1552908,48343,3
IA,1997,12,1603771,1555653,48118,3
IA,1998,1,1605449,1557491,47958,3
IA,1998,2,1606003,1558237,47766,3
IA,1998,3,1605276,1557728,47548,3
IA,1998,4,1605247,1557940,47307,2.9
IA,1998,5,1605267,1558226,47041,2.9
IA,1998,6,1602508,1555762,46746,2.9
IA,1998,7,1600259,1553841,46418,2.9
IA,1998,8,1601303,1555251,46052,2.9
IA,1998,9,1602024,1556376,45648,2.8
IA,1998,10,1599501,1554295,45206,2.8
IA,1998,11,1600569,1555841,44728,2.8
IA,1998,12,1600977,1556759,44218,2.8
IA,1999,1,1602251,1558575,43676,2.7
IA,1999,2,1601859,1558691,43168,2.7
IA,1999,3,1601620,1558922,42698,2.7
IA,1999,4,1603203,1560935,42268,2.6
IA,1999,5,1602921,1561038,41883,2.6
IA,1999,6,1603883,1562332,41551,2.6
IA,1999,7,1603235,1561959,41276,2.6
IA,1999,8,1603596,1562529,41067,2.6
IA,1999,9,1602015,1561083,40932,2.6
IA,1999,10,1602293,1561407,40886,2.6
IA,1999,11,1601240,1560304,40936,2.6
IA,1999,12,1603491,1562406,41085,2.6
IA,2000,1,1597238,1555213,42025,2.6
IA,2000,2,1598533,1556148,42385,2.7
IA,2000,3,1599160,1556354,42806,2.7
IA,2000,4,1599422,1556144,43278,2.7
IA,2000,5,1599545,1555750,43795,2.7
IA,2000,6,1600006,1555653,44353,2.8
IA,2000,7,1601234,1556283,44951,2.8
IA,2000,8,1602271,1556691,45580,2.8
IA,2000,9,1603537,1557308,46229,2.9
IA,2000,10,1605010,1558121,46889,2.9
IA,2000,11,1608157,1560602,47555,3
IA,2000,12,1608928,1560706,48222,3
IA,2001,1,1613221,1564340,48881,3
IA,2001,2,1613585,1564001,49584,3.1
IA,2001,3,1615474,1565147,50327,3.1
IA,2001,4,1617361,1566259,51102,3.2
IA,2001,5,1618637,1566725,51912,3.2
IA,2001,6,1618791,1566038,52753,3.3
IA,2001,7,1621531,1567907,53624,3.3
IA,2001,8,1625467,1570941,54526,3.4
IA,2001,9,1627786,1572328,55458,3.4
IA,2001,10,1627929,1571503,56426,3.5
IA,2001,11,1629717,1572288,57429,3.5
IA,2001,12,1634643,1576179,58464,3.6
IA,2002,1,1626942,1567667,59275,3.6
IA,2002,2,1628995,1568673,60322,3.7
IA,2002,3,1629890,1568550,61340,3.8
IA,2002,4,1631883,1569559,62324,3.8
IA,2002,5,1636192,1572927,63265,3.9
IA,2002,6,1635722,1571560,64162,3.9
IA,2002,7,1635290,1570285,65005,4
IA,2002,8,1636142,1570355,65787,4
IA,2002,9,1635147,1568635,66512,4.1
IA,2002,10,1631595,1564420,67175,4.1
IA,2002,11,1629304,1561528,67776,4.2
IA,2002,12,1628188,1559875,68313,4.2
IA,2003,1,1617162,1548689,68473,4.2
IA,2003,2,1615159,1546230,68929,4.3
IA,2003,3,1612354,1542973,69381,4.3
IA,2003,4,1609033,1539204,69829,4.3
IA,2003,5,1605848,1535577,70271,4.4
IA,2003,6,1607802,1537096,70706,4.4
IA,2003,7,1605547,1534409,71138,4.4
IA,2003,8,1602816,1531253,71563,4.5
IA,2003,9,1603317,1531333,71984,4.5
IA,2003,10,1607008,1534602,72406,4.5
IA,2003,11,1606331,1533495,72836,4.5
IA,2003,12,1606503,1533224,73279,4.6
IA,2004,1,1607463,1533798,73665,4.6
IA,2004,2,1608285,1534222,74063,4.6
IA,2004,3,1607033,1532623,74410,4.6
IA,2004,4,1607753,1533049,74704,4.6
IA,2004,5,1609238,1534294,74944,4.7
IA,2004,6,1608787,1533666,75121,4.7
IA,2004,7,1608446,1533220,75226,4.7
IA,2004,8,1610129,1534875,75254,4.7
IA,2004,9,1609904,1534705,75199,4.7
IA,2004,10,1611408,1536353,75055,4.7
IA,2004,11,1612786,1537965,74821,4.6
IA,2004,12,1615615,1541116,74499,4.6
IA,2005,1,1616170,1542078,74092,4.6
IA,2005,2,1620504,1546896,73608,4.5
IA,2005,3,1624138,1551084,73054,4.5
IA,2005,4,1626253,1553815,72438,4.5
IA,2005,5,1625068,1553295,71773,4.4
IA,2005,6,1628003,1556946,71057,4.4
IA,2005,7,1632547,1562250,70297,4.3
IA,2005,8,1633047,1563546,69501,4.3
IA,2005,9,1634446,1565769,68677,4.2
IA,2005,10,1636580,1568752,67828,4.1
IA,2005,11,1641305,1574344,66961,4.1
IA,2005,12,1641968,1575881,66087,4
IA,2006,1,1646461,1581243,65218,4
IA,2006,2,1648259,1583847,64412,3.9
IA,2006,3,1650886,1587212,63674,3.9
IA,2006,4,1655056,1592039,63017,3.8
IA,2006,5,1658365,1595918,62447,3.8
IA,2006,6,1657636,1595675,61961,3.7
IA,2006,7,1658689,1597137,61552,3.7
IA,2006,8,1661079,1599859,61220,3.7
IA,2006,9,1663515,1602544,60971,3.7
IA,2006,10,1661068,1600261,60807,3.7
IA,2006,11,1661072,1600349,60723,3.7
IA,2006,12,1660180,1599456,60724,3.7
IA,2007,1,1659093,1598284,60809,3.7
IA,2007,2,1659278,1598330,60948,3.7
IA,2007,3,1659605,1598468,61137,3.7
IA,2007,4,1660234,1598862,61372,3.7
IA,2007,5,1663078,1601435,61643,3.7
IA,2007,6,1663634,1601690,61944,3.7
IA,2007,7,1664224,1601953,62271,3.7
IA,2007,8,1664744,1602119,62625,3.8
IA,2007,9,1667773,1604766,63007,3.8
IA,2007,10,1669589,1606168,63421,3.8
IA,2007,11,1669977,1606106,63871,3.8
IA,2007,12,1671944,1607583,64361,3.8
IA,2008,1,1674589,1609693,64896,3.9
IA,2008,2,1674591,1609100,65491,3.9
IA,2008,3,1675749,1609601,66148,3.9
IA,2008,4,1675337,1608475,66862,4
IA,2008,5,1676096,1608473,67623,4
IA,2008,6,1674500,1606076,68424,4.1
IA,2008,7,1676005,1606751,69254,4.1
IA,2008,8,1676460,1606355,70105,4.2
IA,2008,9,1677484,1606511,70973,4.2
IA,2008,10,1676807,1604947,71860,4.3
IA,2008,11,1677612,1604856,72756,4.3
IA,2008,12,1676531,1602869,73662,4.4
IA,2009,1,1672665,1592056,80609,4.8
KS,1976,1,1068879,1023495,45384,4.2
KS,1976,2,1066358,1023417,42941,4
KS,1976,3,1067754,1023258,44496,4.2
KS,1976,4,1069090,1024092,44998,4.2
KS,1976,5,1070476,1024655,45821,4.3
KS,1976,6,1072486,1026582,45904,4.3
KS,1976,7,1073812,1028313,45499,4.2
KS,1976,8,1077179,1031643,45536,4.2
KS,1976,9,1078248,1034007,44241,4.1
KS,1976,10,1081956,1037228,44728,4.1
KS,1976,11,1086237,1040407,45830,4.2
KS,1976,12,1092210,1044406,47804,4.4
KS,1977,1,1097772,1048567,49205,4.5
KS,1977,2,1098877,1052075,46802,4.3
KS,1977,3,1102792,1056423,46369,4.2
KS,1977,4,1104056,1059292,44764,4.1
KS,1977,5,1106958,1062302,44656,4
KS,1977,6,1109516,1065684,43832,4
KS,1977,7,1113166,1069058,44108,4
KS,1977,8,1113592,1071227,42365,3.8
KS,1977,9,1117375,1074604,42771,3.8
KS,1977,10,1119584,1078049,41535,3.7
KS,1977,11,1122296,1081042,41254,3.7
KS,1977,12,1123496,1084001,39495,3.5
KS,1978,1,1123684,1087038,36646,3.3
KS,1978,2,1130276,1089633,40643,3.6
KS,1978,3,1132108,1092741,39367,3.5
KS,1978,4,1130910,1095893,35017,3.1
KS,1978,5,1134063,1099426,34637,3.1
KS,1978,6,1137417,1103470,33947,3
KS,1978,7,1140661,1106656,34005,3
KS,1978,8,1145325,1109477,35848,3.1
KS,1978,9,1145226,1111219,34007,3
KS,1978,10,1147468,1113761,33707,2.9
KS,1978,11,1150765,1116409,34356,3
KS,1978,12,1152984,1118537,34447,3
KS,1979,1,1155760,1120607,35153,3
KS,1979,2,1159428,1122899,36529,3.2
KS,1979,3,1159769,1125039,34730,3
KS,1979,4,1161665,1126100,35565,3.1
KS,1979,5,1162870,1128097,34773,3
KS,1979,6,1165466,1130072,35394,3
KS,1979,7,1169125,1131384,37741,3.2
KS,1979,8,1170058,1133305,36753,3.1
KS,1979,9,1173595,1135589,38006,3.2
KS,1979,10,1174305,1136657,37648,3.2
KS,1979,11,1173858,1137393,36465,3.1
KS,1979,12,1175695,1137466,38229,3.3
KS,1980,1,1177147,1137598,39549,3.4
KS,1980,2,1181541,1137081,44460,3.8
KS,1980,3,1183673,1137013,46660,3.9
KS,1980,4,1190510,1136854,53656,4.5
KS,1980,5,1193758,1137140,56618,4.7
KS,1980,6,1197244,1137010,60234,5
KS,1980,7,1196595,1136732,59863,5
KS,1980,8,1195679,1135674,60005,5
KS,1980,9,1194232,1135612,58620,4.9
KS,1980,10,1191946,1135949,55997,4.7
KS,1980,11,1191363,1135813,55550,4.7
KS,1980,12,1190624,1136747,53877,4.5
KS,1981,1,1189330,1138758,50572,4.3
KS,1981,2,1191805,1139266,52539,4.4
KS,1981,3,1190776,1139788,50988,4.3
KS,1981,4,1190325,1140401,49924,4.2
KS,1981,5,1191434,1141399,50035,4.2
KS,1981,6,1191041,1141709,49332,4.1
KS,1981,7,1191249,1143115,48134,4
KS,1981,8,1192276,1143968,48308,4.1
KS,1981,9,1192545,1143420,49125,4.1
KS,1981,10,1195717,1143311,52406,4.4
KS,1981,11,1197590,1145100,52490,4.4
KS,1981,12,1200556,1145269,55287,4.6
KS,1982,1,1154637,1095724,58913,5.1
KS,1982,2,1158469,1096420,62049,5.4
KS,1982,3,1164206,1097810,66396,5.7
KS,1982,4,1169832,1099184,70648,6
KS,1982,5,1174109,1100749,73360,6.2
KS,1982,6,1180501,1101927,78574,6.7
KS,1982,7,1183860,1102304,81556,6.9
KS,1982,8,1192002,1103752,88250,7.4
KS,1982,9,1193422,1105688,87734,7.4
KS,1982,10,1193008,1108246,84762,7.1
KS,1982,11,1192841,1108386,84455,7.1
KS,1982,12,1193144,1109255,83889,7
KS,1983,1,1193108,1109657,83451,7
KS,1983,2,1192227,1110346,81881,6.9
KS,1983,3,1189806,1110160,79646,6.7
KS,1983,4,1187147,1110712,76435,6.4
KS,1983,5,1183471,1111728,71743,6.1
KS,1983,6,1182997,1113639,69358,5.9
KS,1983,7,1182745,1114838,67907,5.7
KS,1983,8,1180551,1115336,65215,5.5
KS,1983,9,1183097,1117170,65927,5.6
KS,1983,10,1183740,1118806,64934,5.5
KS,1983,11,1185800,1120254,65546,5.5
KS,1983,12,1186443,1122353,64090,5.4
KS,1984,1,1187378,1124396,62982,5.3
KS,1984,2,1185400,1127207,58193,4.9
KS,1984,3,1188969,1129712,59257,5
KS,1984,4,1195726,1133016,62710,5.2
KS,1984,5,1196296,1135724,60572,5.1
KS,1984,6,1196478,1138047,58431,4.9
KS,1984,7,1198480,1140644,57836,4.8
KS,1984,8,1202738,1142904,59834,5
KS,1984,9,1203007,1144919,58088,4.8
KS,1984,10,1206361,1146830,59531,4.9
KS,1984,11,1209267,1149639,59628,4.9
KS,1984,12,1210678,1151367,59311,4.9
KS,1985,1,1216252,1153674,62578,5.1
KS,1985,2,1221440,1155671,65769,5.4
KS,1985,3,1222191,1157973,64218,5.3
KS,1985,4,1220932,1158948,61984,5.1
KS,1985,5,1220534,1160061,60473,5
KS,1985,6,1221144,1160787,60357,4.9
KS,1985,7,1222960,1161868,61092,5
KS,1985,8,1224578,1162580,61998,5.1
KS,1985,9,1224992,1163291,61701,5
KS,1985,10,1227221,1163833,63388,5.2
KS,1985,11,1229380,1164131,65249,5.3
KS,1985,12,1234005,1165287,68718,5.6
KS,1986,1,1230662,1166330,64332,5.2
KS,1986,2,1235783,1167857,67926,5.5
KS,1986,3,1237091,1169058,68033,5.5
KS,1986,4,1237719,1171549,66170,5.3
KS,1986,5,1241838,1173189,68649,5.5
KS,1986,6,1241903,1175418,66485,5.4
KS,1986,7,1244448,1177048,67400,5.4
KS,1986,8,1244320,1178420,65900,5.3
KS,1986,9,1248215,1181230,66985,5.4
KS,1986,10,1250326,1183585,66741,5.3
KS,1986,11,1253798,1186041,67757,5.4
KS,1986,12,1255204,1187817,67387,5.4
KS,1987,1,1259011,1189781,69230,5.5
KS,1987,2,1256740,1191204,65536,5.2
KS,1987,3,1257164,1192554,64610,5.1
KS,1987,4,1256961,1194452,62509,5
KS,1987,5,1258490,1196388,62102,4.9
KS,1987,6,1259664,1197349,62315,4.9
KS,1987,7,1258358,1198160,60198,4.8
KS,1987,8,1259778,1200227,59551,4.7
KS,1987,9,1261295,1201480,59815,4.7
KS,1987,10,1262432,1202607,59825,4.7
KS,1987,11,1263010,1204271,58739,4.7
KS,1987,12,1264596,1206023,58573,4.6
KS,1988,1,1269879,1206995,62884,5
KS,1988,2,1270188,1208228,61960,4.9
KS,1988,3,1268785,1209539,59246,4.7
KS,1988,4,1267935,1210573,57362,4.5
KS,1988,5,1269237,1211825,57412,4.5
KS,1988,6,1269721,1213381,56340,4.4
KS,1988,7,1271032,1215310,55722,4.4
KS,1988,8,1274536,1217460,57076,4.5
KS,1988,9,1276179,1218933,57246,4.5
KS,1988,10,1278627,1221181,57446,4.5
KS,1988,11,1280251,1222864,57387,4.5
KS,1988,12,1281398,1224671,56727,4.4
KS,1989,1,1282660,1226968,55692,4.3
KS,1989,2,1286085,1228646,57439,4.5
KS,1989,3,1284511,1229659,54852,4.3
KS,1989,4,1284113,1230627,53486,4.2
KS,1989,5,1283474,1230369,53105,4.1
KS,1989,6,1284308,1230284,54024,4.2
KS,1989,7,1281790,1229934,51856,4
KS,1989,8,1281042,1228977,52065,4.1
KS,1989,9,1280533,1227165,53368,4.2
KS,1989,10,1281569,1225930,55639,4.3
KS,1989,11,1276690,1224305,52385,4.1
KS,1989,12,1275829,1222416,53413,4.2
KS,1990,1,1272418,1219214,53204,4.2
KS,1990,2,1269086,1217481,51605,4.1
KS,1990,3,1269930,1216166,53764,4.2
KS,1990,4,1268769,1214924,53845,4.2
KS,1990,5,1268195,1214309,53886,4.2
KS,1990,6,1267682,1214120,53562,4.2
KS,1990,7,1268033,1213559,54474,4.3
KS,1990,8,1269203,1213189,56014,4.4
KS,1990,9,1270382,1213739,56643,4.5
KS,1990,10,1271532,1214187,57345,4.5
KS,1990,11,1274704,1214980,59724,4.7
KS,1990,12,1274292,1215361,58931,4.6
KS,1991,1,1281270,1216971,64299,5
KS,1991,2,1282103,1218742,63361,4.9
KS,1991,3,1280991,1220154,60837,4.7
KS,1991,4,1280849,1220925,59924,4.7
KS,1991,5,1280561,1222591,57970,4.5
KS,1991,6,1280824,1223939,56885,4.4
KS,1991,7,1281592,1225222,56370,4.4
KS,1991,8,1281591,1226504,55087,4.3
KS,1991,9,1282533,1228552,53981,4.2
KS,1991,10,1284583,1229854,54729,4.3
KS,1991,11,1288883,1232064,56819,4.4
KS,1991,12,1291716,1234561,57155,4.4
KS,1992,1,1294147,1236566,57581,4.4
KS,1992,2,1294943,1238162,56781,4.4
KS,1992,3,1298460,1240529,57931,4.5
KS,1992,4,1300045,1241888,58157,4.5
KS,1992,5,1302495,1243298,59197,4.5
KS,1992,6,1305178,1243883,61295,4.7
KS,1992,7,1305904,1245546,60358,4.6
KS,1992,8,1309375,1246854,62521,4.8
KS,1992,9,1310766,1247875,62891,4.8
KS,1992,10,1310754,1248775,61979,4.7
KS,1992,11,1312679,1249572,63107,4.8
KS,1992,12,1314135,1250306,63829,4.9
KS,1993,1,1314661,1250535,64126,4.9
KS,1993,2,1314602,1251183,63419,4.8
KS,1993,3,1318226,1251673,66553,5
KS,1993,4,1319590,1252628,66962,5.1
KS,1993,5,1322930,1254218,68712,5.2
KS,1993,6,1323860,1256012,67848,5.1
KS,1993,7,1325833,1257881,67952,5.1
KS,1993,8,1327567,1259573,67994,5.1
KS,1993,9,1330213,1262204,68009,5.1
KS,1993,10,1333020,1263913,69107,5.2
KS,1993,11,1334577,1266337,68240,5.1
KS,1993,12,1335820,1268006,67814,5.1
KS,1994,1,1335636,1269841,65795,4.9
KS,1994,2,1338769,1271819,66950,5
KS,1994,3,1340843,1274044,66799,5
KS,1994,4,1343112,1276534,66578,5
KS,1994,5,1344137,1279109,65028,4.8
KS,1994,6,1343442,1279753,63689,4.7
KS,1994,7,1346129,1280667,65462,4.9
KS,1994,8,1347359,1281462,65897,4.9
KS,1994,9,1347222,1282070,65152,4.8
KS,1994,10,1347782,1283390,64392,4.8
KS,1994,11,1348559,1284707,63852,4.7
KS,1994,12,1350322,1285776,64546,4.8
KS,1995,1,1350632,1287797,62835,4.7
KS,1995,2,1349499,1289717,59782,4.4
KS,1995,3,1350956,1291249,59707,4.4
KS,1995,4,1353657,1292711,60946,4.5
KS,1995,5,1355203,1293648,61555,4.5
KS,1995,6,1355209,1295266,59943,4.4
KS,1995,7,1357699,1296841,60858,4.5
KS,1995,8,1357705,1298657,59048,4.3
KS,1995,9,1358348,1300059,58289,4.3
KS,1995,10,1359574,1301615,57959,4.3
KS,1995,11,1360615,1302888,57727,4.2
KS,1995,12,1361102,1303974,57128,4.2
KS,1996,1,1361063,1304871,56192,4.1
KS,1996,2,1363272,1306145,57127,4.2
KS,1996,3,1365690,1307199,58491,4.3
KS,1996,4,1368651,1308328,60323,4.4
KS,1996,5,1370530,1308733,61797,4.5
KS,1996,6,1371880,1310292,61588,4.5
KS,1996,7,1372586,1311853,60733,4.4
KS,1996,8,1374924,1313418,61506,4.5
KS,1996,9,1376790,1315224,61566,4.5
KS,1996,10,1378579,1317028,61551,4.5
KS,1996,11,1379587,1318623,60964,4.4
KS,1996,12,1379818,1320401,59417,4.3
KS,1997,1,1381192,1321698,59494,4.3
KS,1997,2,1379608,1322847,56761,4.1
KS,1997,3,1378035,1324343,53692,3.9
KS,1997,4,1381363,1325799,55564,4
KS,1997,5,1381214,1327123,54091,3.9
KS,1997,6,1381747,1328809,52938,3.8
KS,1997,7,1382049,1330751,51298,3.7
KS,1997,8,1383634,1332452,51182,3.7
KS,1997,9,1386108,1333835,52273,3.8
KS,1997,10,1386828,1335093,51735,3.7
KS,1997,11,1387698,1336522,51176,3.7
KS,1997,12,1392351,1338291,54060,3.9
KS,1998,1,1390514,1339634,50880,3.7
KS,1998,2,1390135,1341505,48630,3.5
KS,1998,3,1396424,1343267,53157,3.8
KS,1998,4,1396727,1345321,51406,3.7
KS,1998,5,1399678,1346728,52950,3.8
KS,1998,6,1402281,1348108,54173,3.9
KS,1998,7,1405003,1349672,55331,3.9
KS,1998,8,1405288,1351516,53772,3.8
KS,1998,9,1407503,1353070,54433,3.9
KS,1998,10,1408503,1354761,53742,3.8
KS,1998,11,1409093,1355517,53576,3.8
KS,1998,12,1407901,1356416,51485,3.7
KS,1999,1,1407265,1357607,49658,3.5
KS,1999,2,1406216,1358512,47704,3.4
KS,1999,3,1408433,1358799,49634,3.5
KS,1999,4,1408253,1359350,48903,3.5
KS,1999,5,1409320,1359930,49390,3.5
KS,1999,6,1409267,1360332,48935,3.5
KS,1999,7,1409250,1360485,48765,3.5
KS,1999,8,1410224,1360772,49452,3.5
KS,1999,9,1412510,1361038,51472,3.6
KS,1999,10,1411255,1361029,50226,3.6
KS,1999,11,1410993,1360491,50502,3.6
KS,1999,12,1411686,1360556,51130,3.6
KS,2000,1,1401971,1354652,47319,3.4
KS,2000,2,1403438,1354462,48976,3.5
KS,2000,3,1404995,1354113,50882,3.6
KS,2000,4,1406213,1353593,52620,3.7
KS,2000,5,1406716,1353138,53578,3.8
KS,2000,6,1406484,1353014,53470,3.8
KS,2000,7,1405357,1351883,53474,3.8
KS,2000,8,1405763,1351245,54518,3.9
KS,2000,9,1405659,1350178,55481,3.9
KS,2000,10,1405453,1349663,55790,4
KS,2000,11,1405372,1349221,56151,4
KS,2000,12,1403833,1348698,55135,3.9
KS,2001,1,1404766,1348057,56709,4
KS,2001,2,1405163,1348012,57151,4.1
KS,2001,3,1404768,1347818,56950,4.1
KS,2001,4,1404742,1347942,56800,4
KS,2001,5,1406015,1347370,58645,4.2
KS,2001,6,1406825,1346815,60010,4.3
KS,2001,7,1407271,1346942,60329,4.3
KS,2001,8,1408337,1347455,60882,4.3
KS,2001,9,1409501,1347708,61793,4.4
KS,2001,10,1411682,1347650,64032,4.5
KS,2001,11,1413588,1348056,65532,4.6
KS,2001,12,1414580,1348756,65824,4.7
KS,2002,1,1417061,1345652,71409,5
KS,2002,2,1417594,1346335,71259,5
KS,2002,3,1418774,1346935,71839,5.1
KS,2002,4,1420845,1347821,73024,5.1
KS,2002,5,1421864,1349023,72841,5.1
KS,2002,6,1422500,1349580,72920,5.1
KS,2002,7,1426378,1351160,75218,5.3
KS,2002,8,1425735,1352422,73313,5.1
KS,2002,9,1428032,1353985,74047,5.2
KS,2002,10,1429781,1354979,74802,5.2
KS,2002,11,1430872,1356289,74583,5.2
KS,2002,12,1429211,1357338,71873,5
KS,2003,1,1434150,1359348,74802,5.2
KS,2003,2,1435804,1360336,75468,5.3
KS,2003,3,1438503,1361132,77371,5.4
KS,2003,4,1441823,1362031,79792,5.5
KS,2003,5,1441452,1362813,78639,5.5
KS,2003,6,1447797,1363715,84082,5.8
KS,2003,7,1450919,1365057,85862,5.9
KS,2003,8,1447820,1366571,81249,5.6
KS,2003,9,1448914,1367315,81599,5.6
KS,2003,10,1449760,1368075,81685,5.6
KS,2003,11,1452467,1369839,82628,5.7
KS,2003,12,1455201,1371206,83995,5.8
KS,2004,1,1455915,1374310,81605,5.6
KS,2004,2,1460794,1375733,85061,5.8
KS,2004,3,1460122,1377390,82732,5.7
KS,2004,4,1460083,1378680,81403,5.6
KS,2004,5,1461956,1380067,81889,5.6
KS,2004,6,1462514,1381334,81180,5.6
KS,2004,7,1463163,1382559,80604,5.5
KS,2004,8,1464336,1383700,80636,5.5
KS,2004,9,1464601,1384595,80006,5.5
KS,2004,10,1465078,1385131,79947,5.5
KS,2004,11,1464257,1385604,78653,5.4
KS,2004,12,1464512,1387019,77493,5.3
KS,2005,1,1467330,1387532,79798,5.4
KS,2005,2,1465637,1387837,77800,5.3
KS,2005,3,1465278,1389270,76008,5.2
KS,2005,4,1465384,1390271,75113,5.1
KS,2005,5,1466152,1391268,74884,5.1
KS,2005,6,1466639,1391985,74654,5.1
KS,2005,7,1468411,1393498,74913,5.1
KS,2005,8,1469248,1394332,74916,5.1
KS,2005,9,1469507,1396077,73430,5
KS,2005,10,1470410,1397577,72833,5
KS,2005,11,1470246,1398916,71330,4.9
KS,2005,12,1471969,1401261,70708,4.8
KS,2006,1,1467951,1402292,65659,4.5
KS,2006,2,1466833,1403508,63325,4.3
KS,2006,3,1468663,1404596,64067,4.4
KS,2006,4,1471418,1407223,64195,4.4
KS,2006,5,1473192,1408567,64625,4.4
KS,2006,6,1474026,1409447,64579,4.4
KS,2006,7,1474930,1410579,64351,4.4
KS,2006,8,1476959,1411909,65050,4.4
KS,2006,9,1477209,1413669,63540,4.3
KS,2006,10,1478314,1414835,63479,4.3
KS,2006,11,1479275,1416293,62982,4.3
KS,2006,12,1479757,1417653,62104,4.2
KS,2007,1,1478838,1420007,58831,4
KS,2007,2,1483320,1420987,62333,4.2
KS,2007,3,1480814,1422033,58781,4
KS,2007,4,1483761,1423346,60415,4.1
KS,2007,5,1486323,1424385,61938,4.2
KS,2007,6,1486438,1425558,60880,4.1
KS,2007,7,1485984,1425816,60168,4
KS,2007,8,1485392,1426650,58742,4
KS,2007,9,1487620,1427642,59978,4
KS,2007,10,1487545,1428541,59004,4
KS,2007,11,1487422,1427932,59490,4
KS,2007,12,1489381,1427687,61694,4.1
KS,2008,1,1486280,1428340,57940,3.9
KS,2008,2,1487658,1428744,58914,4
KS,2008,3,1489741,1428959,60782,4.1
KS,2008,4,1491656,1429035,62621,4.2
KS,2008,5,1494100,1429978,64122,4.3
KS,2008,6,1495091,1430771,64320,4.3
KS,2008,7,1496103,1431162,64941,4.3
KS,2008,8,1498691,1432084,66607,4.4
KS,2008,9,1501221,1432766,68455,4.6
KS,2008,10,1503780,1433592,70188,4.7
KS,2008,11,1507088,1434836,72252,4.8
KS,2008,12,1511906,1435815,76091,5
KS,2009,1,1508192,1420834,87358,5.8
KY,1976,1,1492418,1407711,84707,5.7
KY,1976,2,1487912,1408218,79694,5.4
KY,1976,3,1492033,1409558,82475,5.5
KY,1976,4,1493557,1410181,83376,5.6
KY,1976,5,1495747,1410720,85027,5.7
KY,1976,6,1495448,1412059,83389,5.6
KY,1976,7,1497105,1414825,82280,5.5
KY,1976,8,1500747,1416777,83970,5.6
KY,1976,9,1502307,1419183,83124,5.5
KY,1976,10,1503586,1422064,81522,5.4
KY,1976,11,1509307,1426463,82844,5.5
KY,1976,12,1509174,1431030,78144,5.2
KY,1977,1,1511277,1436639,74638,4.9
KY,1977,2,1523674,1441388,82286,5.4
KY,1977,3,1524083,1446695,77388,5.1
KY,1977,4,1525705,1450744,74961,4.9
KY,1977,5,1524660,1455190,69470,4.6
KY,1977,6,1528758,1458709,70049,4.6
KY,1977,7,1529219,1461329,67890,4.4
KY,1977,8,1541815,1464450,77365,5
KY,1977,9,1545524,1469089,76435,4.9
KY,1977,10,1550332,1473497,76835,5
KY,1977,11,1553467,1475742,77725,5
KY,1977,12,1557560,1477948,79612,5.1
KY,1978,1,1562752,1480282,82470,5.3
KY,1978,2,1567544,1483890,83654,5.3
KY,1978,3,1567853,1485600,82253,5.2
KY,1978,4,1566166,1487949,78217,5
KY,1978,5,1569035,1489431,79604,5.1
KY,1978,6,1572751,1492988,79763,5.1
KY,1978,7,1579043,1494375,84668,5.4
KY,1978,8,1581472,1496156,85316,5.4
KY,1978,9,1581762,1495807,85955,5.4
KY,1978,10,1582652,1497693,84959,5.4
KY,1978,11,1583683,1501147,82536,5.2
KY,1978,12,1585439,1501772,83667,5.3
KY,1979,1,1589085,1501390,87695,5.5
KY,1979,2,1589611,1503418,86193,5.4
KY,1979,3,1594214,1505849,88365,5.5
KY,1979,4,1596483,1507626,88857,5.6
KY,1979,5,1596961,1510301,86660,5.4
KY,1979,6,1600943,1513589,87354,5.5
KY,1979,7,1609273,1516914,92359,5.7
KY,1979,8,1612501,1518034,94467,5.9
KY,1979,9,1614676,1520527,94149,5.8
KY,1979,10,1617790,1521473,96317,6
KY,1979,11,1619999,1523055,96944,6
KY,1979,12,1624434,1523007,101427,6.2
KY,1980,1,1628029,1524553,103476,6.4
KY,1980,2,1638429,1523764,114665,7
KY,1980,3,1639715,1523956,115759,7.1
KY,1980,4,1645588,1523155,122433,7.4
KY,1980,5,1653624,1524006,129618,7.8
KY,1980,6,1665541,1524860,140681,8.4
KY,1980,7,1669916,1525303,144613,8.7
KY,1980,8,1671805,1525230,146575,8.8
KY,1980,9,1675393,1525356,150037,9
KY,1980,10,1673833,1524821,149012,8.9
KY,1980,11,1671734,1525209,146525,8.8
KY,1980,12,1669261,1526303,142958,8.6
KY,1981,1,1667778,1525480,142298,8.5
KY,1981,2,1662461,1525322,137139,8.2
KY,1981,3,1662124,1523680,138444,8.3
KY,1981,4,1662859,1522796,140063,8.4
KY,1981,5,1663704,1521474,142230,8.5
KY,1981,6,1659047,1519658,139389,8.4
KY,1981,7,1655646,1517079,138567,8.4
KY,1981,8,1658605,1515106,143499,8.7
KY,1981,9,1657077,1512999,144078,8.7
KY,1981,10,1660240,1510594,149646,9
KY,1981,11,1662460,1507892,154568,9.3
KY,1981,12,1665648,1506079,159569,9.6
KY,1982,1,1667017,1505524,161493,9.7
KY,1982,2,1667568,1504755,162813,9.8
KY,1982,3,1672522,1504024,168498,10.1
KY,1982,4,1682124,1503895,178229,10.6
KY,1982,5,1682338,1504353,177985,10.6
KY,1982,6,1684721,1504395,180326,10.7
KY,1982,7,1687645,1504845,182800,10.8
KY,1982,8,1688277,1505382,182895,10.8
KY,1982,9,1693623,1505453,188170,11.1
KY,1982,10,1699128,1504988,194140,11.4
KY,1982,11,1704895,1504661,200234,11.7
KY,1982,12,1711658,1504365,207293,12.1
KY,1983,1,1709567,1504323,205244,12
KY,1983,2,1710385,1505012,205373,12
KY,1983,3,1709317,1505957,203360,11.9
KY,1983,4,1707202,1506641,200561,11.7
KY,1983,5,1707252,1507306,199946,11.7
KY,1983,6,1708872,1509965,198907,11.6
KY,1983,7,1705261,1512195,193066,11.3
KY,1983,8,1704938,1515818,189120,11.1
KY,1983,9,1702906,1519559,183347,10.8
KY,1983,10,1704079,1523860,180219,10.6
KY,1983,11,1704977,1527485,177492,10.4
KY,1983,12,1704403,1532570,171833,10.1
KY,1984,1,1703612,1534983,168629,9.9
KY,1984,2,1700396,1537301,163095,9.6
KY,1984,3,1703581,1539720,163861,9.6
KY,1984,4,1705980,1542492,163488,9.6
KY,1984,5,1705624,1544598,161026,9.4
KY,1984,6,1702049,1547083,154966,9.1
KY,1984,7,1698823,1546603,152220,9
KY,1984,8,1695416,1548249,147167,8.7
KY,1984,9,1695576,1548328,147248,8.7
KY,1984,10,1695044,1549726,145318,8.6
KY,1984,11,1696614,1550296,146318,8.6
KY,1984,12,1696977,1549343,147634,8.7
KY,1985,1,1696938,1549258,147680,8.7
KY,1985,2,1701925,1549170,152755,9
KY,1985,3,1698170,1548848,149322,8.8
KY,1985,4,1697692,1548211,149481,8.8
KY,1985,5,1698712,1548089,150623,8.9
KY,1985,6,1701717,1547759,153958,9
KY,1985,7,1705021,1548940,156081,9.2
KY,1985,8,1705183,1549272,155911,9.1
KY,1985,9,1709564,1549618,159946,9.4
KY,1985,10,1710176,1549026,161150,9.4
KY,1985,11,1713403,1550315,163088,9.5
KY,1985,12,1714719,1551433,163286,9.5
KY,1986,1,1716057,1552421,163636,9.5
KY,1986,2,1717303,1552773,164530,9.6
KY,1986,3,1715611,1554080,161531,9.4
KY,1986,4,1713863,1556026,157837,9.2
KY,1986,5,1714994,1559335,155659,9.1
KY,1986,6,1715894,1560105,155789,9.1
KY,1986,7,1717270,1560272,156998,9.1
KY,1986,8,1716492,1561683,154809,9
KY,1986,9,1719518,1563413,156105,9.1
KY,1986,10,1720995,1563765,157230,9.1
KY,1986,11,1721830,1563992,157838,9.2
KY,1986,12,1722358,1564509,157849,9.2
KY,1987,1,1720963,1565764,155199,9
KY,1987,2,1719590,1566692,152898,8.9
KY,1987,3,1720245,1567491,152754,8.9
KY,1987,4,1716788,1569395,147393,8.6
KY,1987,5,1715730,1569747,145983,8.5
KY,1987,6,1713800,1570239,143561,8.4
KY,1987,7,1709159,1571889,137270,8
KY,1987,8,1708246,1573275,134971,7.9
KY,1987,9,1708563,1574086,134477,7.9
KY,1987,10,1712388,1576640,135748,7.9
KY,1987,11,1713325,1578172,135153,7.9
KY,1987,12,1715022,1580954,134068,7.8
KY,1988,1,1718572,1581679,136893,8
KY,1988,2,1720119,1583300,136819,8
KY,1988,3,1721110,1584146,136964,8
KY,1988,4,1721858,1587096,134762,7.8
KY,1988,5,1723192,1589373,133819,7.8
KY,1988,6,1723248,1591472,131776,7.6
KY,1988,7,1725719,1593622,132097,7.7
KY,1988,8,1727811,1596957,130854,7.6
KY,1988,9,1729045,1600047,128998,7.5
KY,1988,10,1730011,1602132,127879,7.4
KY,1988,11,1728499,1603846,124653,7.2
KY,1988,12,1728211,1606067,122144,7.1
KY,1989,1,1728389,1609446,118943,6.9
KY,1989,2,1732089,1612178,119911,6.9
KY,1989,3,1731086,1614549,116537,6.7
KY,1989,4,1733197,1617120,116077,6.7
KY,1989,5,1733931,1619781,114150,6.6
KY,1989,6,1735112,1621902,113210,6.5
KY,1989,7,1737307,1625204,112103,6.5
KY,1989,8,1737948,1628076,109872,6.3
KY,1989,9,1741432,1630045,111387,6.4
KY,1989,10,1738038,1632744,105294,6.1
KY,1989,11,1741034,1635526,105508,6.1
KY,1989,12,1742721,1637087,105634,6.1
KY,1990,1,1745477,1638400,107077,6.1
KY,1990,2,1740799,1639442,101357,5.8
KY,1990,3,1741876,1641623,100253,5.8
KY,1990,4,1743964,1641360,102604,5.9
KY,1990,5,1744128,1641196,102932,5.9
KY,1990,6,1747683,1642183,105500,6
KY,1990,7,1746159,1642760,103399,5.9
KY,1990,8,1745674,1641966,103708,5.9
KY,1990,9,1747668,1640995,106673,6.1
KY,1990,10,1751076,1641299,109777,6.3
KY,1990,11,1758177,1640058,118119,6.7
KY,1990,12,1758578,1639213,119365,6.8
KY,1991,1,1763006,1638182,124824,7.1
KY,1991,2,1769135,1638585,130550,7.4
KY,1991,3,1772125,1638179,133946,7.6
KY,1991,4,1773733,1638141,135592,7.6
KY,1991,5,1771300,1638438,132862,7.5
KY,1991,6,1769889,1639146,130743,7.4
KY,1991,7,1769554,1638008,131546,7.4
KY,1991,8,1769837,1638539,131298,7.4
KY,1991,9,1770537,1639613,130924,7.4
KY,1991,10,1771388,1641182,130206,7.4
KY,1991,11,1770959,1641416,129543,7.3
KY,1991,12,1772574,1642691,129883,7.3
KY,1992,1,1773151,1644648,128503,7.2
KY,1992,2,1772593,1646731,125862,7.1
KY,1992,3,1773178,1649261,123917,7
KY,1992,4,1773988,1652396,121592,6.9
KY,1992,5,1777570,1654938,122632,6.9
KY,1992,6,1780341,1656725,123616,6.9
KY,1992,7,1781250,1659253,121997,6.8
KY,1992,8,1786173,1661937,124236,7
KY,1992,9,1789663,1664532,125131,7
KY,1992,10,1792391,1667486,124905,7
KY,1992,11,1793143,1670803,122340,6.8
KY,1992,12,1795377,1673417,121960,6.8
KY,1993,1,1794133,1675267,118866,6.6
KY,1993,2,1793484,1678236,115248,6.4
KY,1993,3,1802422,1680473,121949,6.8
KY,1993,4,1806025,1682903,123122,6.8
KY,1993,5,1806747,1684672,122075,6.8
KY,1993,6,1806454,1687545,118909,6.6
KY,1993,7,1805184,1689940,115244,6.4
KY,1993,8,1807418,1692285,115133,6.4
KY,1993,9,1807030,1695006,112024,6.2
KY,1993,10,1806421,1697588,108833,6
KY,1993,11,1805789,1700776,105013,5.8
KY,1993,12,1806894,1704511,102383,5.7
KY,1994,1,1810272,1709052,101220,5.6
KY,1994,2,1816514,1712470,104044,5.7
KY,1994,3,1816653,1716549,100104,5.5
KY,1994,4,1820018,1720473,99545,5.5
KY,1994,5,1823093,1724844,98249,5.4
KY,1994,6,1826645,1727968,98677,5.4
KY,1994,7,1832058,1731842,100216,5.5
KY,1994,8,1835451,1736056,99395,5.4
KY,1994,9,1839532,1739102,100430,5.5
KY,1994,10,1843321,1742572,100749,5.5
KY,1994,11,1842414,1744892,97522,5.3
KY,1994,12,1845932,1747981,97951,5.3
KY,1995,1,1846992,1750236,96756,5.2
KY,1995,2,1853021,1752617,100404,5.4
KY,1995,3,1853726,1753280,100446,5.4
KY,1995,4,1856679,1754899,101780,5.5
KY,1995,5,1860225,1755607,104618,5.6
KY,1995,6,1862388,1757422,104966,5.6
KY,1995,7,1867359,1757979,109380,5.9
KY,1995,8,1867895,1758528,109367,5.9
KY,1995,9,1866856,1759263,107593,5.8
KY,1995,10,1865649,1760330,105319,5.6
KY,1995,11,1866282,1761927,104355,5.6
KY,1995,12,1863676,1763246,100430,5.4
KY,1996,1,1872595,1765167,107428,5.7
KY,1996,2,1868291,1766537,101754,5.4
KY,1996,3,1868044,1768145,99899,5.3
KY,1996,4,1870221,1769727,100494,5.4
KY,1996,5,1870742,1772180,98562,5.3
KY,1996,6,1873426,1774522,98904,5.3
KY,1996,7,1878363,1778186,100177,5.3
KY,1996,8,1879900,1780763,99137,5.3
KY,1996,9,1886199,1783854,102345,5.4
KY,1996,10,1892591,1786591,106000,5.6
KY,1996,11,1897821,1789135,108686,5.7
KY,1996,12,1905019,1792306,112713,5.9
KY,1997,1,1908310,1795611,112699,5.9
KY,1997,2,1908797,1797790,111007,5.8
KY,1997,3,1909552,1801283,108269,5.7
KY,1997,4,1910708,1804461,106247,5.6
KY,1997,5,1913074,1806486,106588,5.6
KY,1997,6,1913988,1809008,104980,5.5
KY,1997,7,1916080,1811619,104461,5.5
KY,1997,8,1915519,1813351,102168,5.3
KY,1997,9,1914708,1815628,99080,5.2
KY,1997,10,1913795,1818579,95216,5
KY,1997,11,1913433,1821076,92357,4.8
KY,1997,12,1913130,1822526,90604,4.7
KY,1998,1,1910314,1823504,86810,4.5
KY,1998,2,1910917,1826281,84636,4.4
KY,1998,3,1914633,1827734,86899,4.5
KY,1998,4,1913791,1829231,84560,4.4
KY,1998,5,1916645,1830237,86408,4.5
KY,1998,6,1919905,1831581,88324,4.6
KY,1998,7,1919851,1832901,86950,4.5
KY,1998,8,1924693,1835486,89207,4.6
KY,1998,9,1924412,1836374,88038,4.6
KY,1998,10,1926626,1837791,88835,4.6
KY,1998,11,1929710,1839862,89848,4.7
KY,1998,12,1932001,1842313,89688,4.6
KY,1999,1,1935147,1843733,91414,4.7
KY,1999,2,1934899,1845545,89354,4.6
KY,1999,3,1939046,1847334,91712,4.7
KY,1999,4,1940430,1849224,91206,4.7
KY,1999,5,1944679,1851245,93434,4.8
KY,1999,6,1947444,1853493,93951,4.8
KY,1999,7,1945894,1855452,90442,4.6
KY,1999,8,1949106,1856871,92235,4.7
KY,1999,9,1950012,1859459,90553,4.6
KY,1999,10,1949861,1861604,88257,4.5
KY,1999,11,1947603,1862671,84932,4.4
KY,1999,12,1948486,1864607,83879,4.3
KY,2000,1,1942662,1862469,80193,4.1
KY,2000,2,1947315,1864535,82780,4.3
KY,2000,3,1946964,1868294,78670,4
KY,2000,4,1945923,1866915,79008,4.1
KY,2000,5,1949190,1868452,80738,4.1
KY,2000,6,1946152,1866970,79182,4.1
KY,2000,7,1944668,1863637,81031,4.2
KY,2000,8,1947928,1865138,82790,4.3
KY,2000,9,1952758,1868032,84726,4.3
KY,2000,10,1954294,1867929,86365,4.4
KY,2000,11,1954633,1867327,87306,4.5
KY,2000,12,1955668,1866475,89193,4.6
KY,2001,1,1957279,1865436,91843,4.7
KY,2001,2,1955839,1863051,92788,4.7
KY,2001,3,1955200,1859163,96037,4.9
KY,2001,4,1955564,1857057,98507,5
KY,2001,5,1954538,1855701,98837,5.1
KY,2001,6,1953873,1853744,100129,5.1
KY,2001,7,1955195,1848535,106660,5.5
KY,2001,8,1954303,1849015,105288,5.4
KY,2001,9,1949575,1846346,103229,5.3
KY,2001,10,1953261,1843542,109719,5.6
KY,2001,11,1953739,1842666,111073,5.7
KY,2001,12,1951331,1840417,110914,5.7
KY,2002,1,1951174,1839882,111292,5.7
KY,2002,2,1946929,1838635,108294,5.6
KY,2002,3,1947027,1837258,109769,5.6
KY,2002,4,1947172,1836523,110649,5.7
KY,2002,5,1949704,1837030,112674,5.8
KY,2002,6,1947685,1836869,110816,5.7
KY,2002,7,1948143,1837835,110308,5.7
KY,2002,8,1949139,1837260,111879,5.7
KY,2002,9,1950301,1837710,112591,5.8
KY,2002,10,1951960,1839736,112224,5.7
KY,2002,11,1956945,1841262,115683,5.9
KY,2002,12,1959452,1841934,117518,6
KY,2003,1,1959480,1841052,118428,6
KY,2003,2,1964300,1841798,122502,6.2
KY,2003,3,1967395,1843791,123604,6.3
KY,2003,4,1971075,1844786,126289,6.4
KY,2003,5,1972965,1846637,126328,6.4
KY,2003,6,1975339,1847262,128077,6.5
KY,2003,7,1977601,1848292,129309,6.5
KY,2003,8,1975627,1850270,125357,6.3
KY,2003,9,1977536,1852284,125252,6.3
KY,2003,10,1974760,1853078,121682,6.2
KY,2003,11,1973179,1852959,120220,6.1
KY,2003,12,1971749,1854493,117256,5.9
KY,2004,1,1967333,1852943,114390,5.8
KY,2004,2,1967290,1852214,115076,5.8
KY,2004,3,1968122,1852882,115240,5.9
KY,2004,4,1966726,1853591,113135,5.8
KY,2004,5,1964811,1852316,112495,5.7
KY,2004,6,1964675,1852718,111957,5.7
KY,2004,7,1963674,1853976,109698,5.6
KY,2004,8,1960731,1854385,106346,5.4
KY,2004,9,1958232,1855985,102247,5.2
KY,2004,10,1960528,1857197,103331,5.3
KY,2004,11,1960691,1858631,102060,5.2
KY,2004,12,1963403,1859590,103813,5.3
KY,2005,1,1967883,1860215,107668,5.5
KY,2005,2,1973571,1862642,110929,5.6
KY,2005,3,1978587,1863480,115107,5.8
KY,2005,4,1983426,1866320,117106,5.9
KY,2005,5,1987098,1867106,119992,6
KY,2005,6,1992445,1869773,122672,6.2
KY,2005,7,1997226,1872162,125064,6.3
KY,2005,8,1998548,1875134,123414,6.2
KY,2005,9,2004493,1877931,126562,6.3
KY,2005,10,2006506,1879982,126524,6.3
KY,2005,11,2009949,1883243,126706,6.3
KY,2005,12,2011776,1885788,125988,6.3
KY,2006,1,2014581,1891369,123212,6.1
KY,2006,2,2018176,1895760,122416,6.1
KY,2006,3,2022052,1901277,120775,6
KY,2006,4,2022095,1902655,119440,5.9
KY,2006,5,2023224,1905175,118049,5.8
KY,2006,6,2026783,1907701,119082,5.9
KY,2006,7,2028736,1909825,118911,5.9
KY,2006,8,2031753,1913572,118181,5.8
KY,2006,9,2035734,1916276,119458,5.9
KY,2006,10,2035933,1917316,118617,5.8
KY,2006,11,2037268,1919958,117310,5.8
KY,2006,12,2037194,1924522,112672,5.5
KY,2007,1,2041135,1924559,116576,5.7
KY,2007,2,2041396,1924542,116854,5.7
KY,2007,3,2040643,1925994,114649,5.6
KY,2007,4,2038880,1925972,112908,5.5
KY,2007,5,2039963,1925687,114276,5.6
KY,2007,6,2039118,1926076,113042,5.5
KY,2007,7,2036890,1924027,112863,5.5
KY,2007,8,2034277,1921937,112340,5.5
KY,2007,9,2034046,1922045,112001,5.5
KY,2007,10,2032963,1920529,112434,5.5
KY,2007,11,2028005,1920986,107019,5.3
KY,2007,12,2030187,1919297,110890,5.5
KY,2008,1,2028208,1917659,110549,5.5
KY,2008,2,2029409,1916054,113355,5.6
KY,2008,3,2031400,1912291,119109,5.9
KY,2008,4,2036198,1911995,124203,6.1
KY,2008,5,2037985,1912632,125353,6.2
KY,2008,6,2040705,1910921,129784,6.4
KY,2008,7,2044027,1911137,132890,6.5
KY,2008,8,2048936,1910907,138029,6.7
KY,2008,9,2049254,1908129,141125,6.9
KY,2008,10,2051049,1909891,141158,6.9
KY,2008,11,2055583,1907832,147751,7.2
KY,2008,12,2062218,1905428,156790,7.6
KY,2009,1,2068495,1888102,180393,8.7
LA,1976,1,1502683,1413345,89338,5.9
LA,1976,2,1505256,1413560,91696,6.1
LA,1976,3,1509584,1414686,94898,6.3
LA,1976,4,1512725,1415223,97502,6.4
LA,1976,5,1513613,1417481,96132,6.4
LA,1976,6,1521197,1421211,99986,6.6
LA,1976,7,1534001,1430682,103319,6.7
LA,1976,8,1538991,1428289,110702,7.2
LA,1976,9,1537553,1435780,101773,6.6
LA,1976,10,1541692,1436762,104930,6.8
LA,1976,11,1545521,1439596,105925,6.9
LA,1976,12,1545687,1443966,101721,6.6
LA,1977,1,1553387,1444947,108440,7
LA,1977,2,1561087,1453535,107552,6.9
LA,1977,3,1572144,1459752,112392,7.1
LA,1977,4,1575341,1473450,101891,6.5
LA,1977,5,1584447,1483436,101011,6.4
LA,1977,6,1598826,1497265,101561,6.4
LA,1977,7,1606055,1500036,106019,6.6
LA,1977,8,1611360,1505460,105900,6.6
LA,1977,9,1615268,1503998,111270,6.9
LA,1977,10,1620791,1509146,111645,6.9
LA,1977,11,1629350,1513597,115753,7.1
LA,1977,12,1642129,1517282,124847,7.6
LA,1978,1,1657533,1529954,127579,7.7
LA,1978,2,1668079,1533733,134346,8.1
LA,1978,3,1670294,1541143,129151,7.7
LA,1978,4,1667477,1545671,121806,7.3
LA,1978,5,1668244,1550904,117340,7
LA,1978,6,1669015,1552347,116668,7
LA,1978,7,1670953,1565079,105874,6.3
LA,1978,8,1676213,1572424,103789,6.2
LA,1978,9,1677226,1572859,104367,6.2
LA,1978,10,1672217,1572928,99289,5.9
LA,1978,11,1674782,1577074,97708,5.8
LA,1978,12,1679295,1582842,96453,5.7
LA,1979,1,1679971,1584406,95565,5.7
LA,1979,2,1688485,1588708,99777,5.9
LA,1979,3,1696405,1593843,102562,6
LA,1979,4,1702327,1598672,103655,6.1
LA,1979,5,1709987,1603979,106008,6.2
LA,1979,6,1721736,1606892,114844,6.7
LA,1979,7,1719913,1605989,113924,6.6
LA,1979,8,1734904,1617646,117258,6.8
LA,1979,9,1739732,1620871,118861,6.8
LA,1979,10,1745213,1627270,117943,6.8
LA,1979,11,1754750,1632903,121847,6.9
LA,1979,12,1754493,1633315,121178,6.9
LA,1980,1,1752369,1633020,119349,6.8
LA,1980,2,1758892,1635060,123832,7
LA,1980,3,1754298,1637023,117275,6.7
LA,1980,4,1759964,1641564,118400,6.7
LA,1980,5,1761942,1639560,122382,6.9
LA,1980,6,1763149,1649659,113490,6.4
LA,1980,7,1769780,1659179,110601,6.2
LA,1980,8,1774705,1663628,111077,6.3
LA,1980,9,1792162,1667831,124331,6.9
LA,1980,10,1811460,1676001,135459,7.5
LA,1980,11,1812917,1679216,133701,7.4
LA,1980,12,1825781,1683989,141792,7.8
LA,1981,1,1833519,1685051,148468,8.1
LA,1981,2,1829558,1686837,142721,7.8
LA,1981,3,1837423,1686460,150963,8.2
LA,1981,4,1848112,1690809,157303,8.5
LA,1981,5,1846975,1693363,153612,8.3
LA,1981,6,1851353,1694484,156869,8.5
LA,1981,7,1861472,1699239,162233,8.7
LA,1981,8,1858691,1700329,158362,8.5
LA,1981,9,1856231,1703084,153147,8.3
LA,1981,10,1862299,1704574,157725,8.5
LA,1981,11,1865467,1701010,164457,8.8
LA,1981,12,1872138,1700500,171638,9.2
LA,1982,1,1870565,1692556,178009,9.5
LA,1982,2,1868579,1696078,172501,9.2
LA,1982,3,1872361,1696111,176250,9.4
LA,1982,4,1867042,1689012,178030,9.5
LA,1982,5,1868870,1686395,182475,9.8
LA,1982,6,1870843,1680836,190007,10.2
LA,1982,7,1866352,1677615,188737,10.1
LA,1982,8,1871389,1674813,196576,10.5
LA,1982,9,1873287,1670882,202405,10.8
LA,1982,10,1872286,1665214,207072,11.1
LA,1982,11,1878128,1667707,210421,11.2
LA,1982,12,1879460,1668763,210697,11.2
LA,1983,1,1889595,1669468,220127,11.6
LA,1983,2,1900649,1667649,233000,12.3
LA,1983,3,1908533,1668449,240084,12.6
LA,1983,4,1907871,1667456,240415,12.6
LA,1983,5,1912633,1671065,241568,12.6
LA,1983,6,1914105,1678421,235684,12.3
LA,1983,7,1917756,1686258,231498,12.1
LA,1983,8,1914216,1686060,228156,11.9
LA,1983,9,1916856,1699308,217548,11.3
LA,1983,10,1912067,1708905,203162,10.6
LA,1983,11,1912925,1712649,200276,10.5
LA,1983,12,1912473,1718088,194385,10.2
LA,1984,1,1914114,1725102,189012,9.9
LA,1984,2,1919715,1730890,188825,9.8
LA,1984,3,1915841,1733875,181966,9.5
LA,1984,4,1926915,1741616,185299,9.6
LA,1984,5,1933636,1747100,186536,9.6
LA,1984,6,1938098,1754230,183868,9.5
LA,1984,7,1936927,1752711,184216,9.5
LA,1984,8,1946286,1758305,187981,9.7
LA,1984,9,1948600,1756614,191986,9.9
LA,1984,10,1959265,1757338,201927,10.3
LA,1984,11,1965358,1759945,205413,10.5
LA,1984,12,1968490,1757294,211196,10.7
LA,1985,1,1979147,1762756,216391,10.9
LA,1985,2,1986732,1759666,227066,11.4
LA,1985,3,1992659,1764344,228315,11.5
LA,1985,4,1990063,1763940,226123,11.4
LA,1985,5,1991998,1766462,225536,11.3
LA,1985,6,1985922,1762901,223021,11.2
LA,1985,7,1988572,1759688,228884,11.5
LA,1985,8,1994108,1764302,229806,11.5
LA,1985,9,1993413,1763985,229428,11.5
LA,1985,10,1988750,1758246,230504,11.6
LA,1985,11,1989168,1755233,233935,11.8
LA,1985,12,1994456,1755512,238944,12
LA,1986,1,1994946,1756668,238278,11.9
LA,1986,2,1985672,1746846,238826,12
LA,1986,3,1975316,1742204,233112,11.8
LA,1986,4,1970627,1728254,242373,12.3
LA,1986,5,1966274,1721621,244653,12.4
LA,1986,6,1958693,1710348,248345,12.7
LA,1986,7,1953227,1706399,246828,12.6
LA,1986,8,1957509,1706514,250995,12.8
LA,1986,9,1960275,1708267,252008,12.9
LA,1986,10,1958222,1707784,250438,12.8
LA,1986,11,1958151,1708077,250074,12.8
LA,1986,12,1957677,1709424,248253,12.7
LA,1987,1,1958501,1711766,246735,12.6
LA,1987,2,1956276,1711419,244857,12.5
LA,1987,3,1952612,1709904,242708,12.4
LA,1987,4,1948213,1715163,233050,12
LA,1987,5,1946890,1716941,229949,11.8
LA,1987,6,1946116,1716329,229787,11.8
LA,1987,7,1947844,1721784,226060,11.6
LA,1987,8,1945295,1721470,223825,11.5
LA,1987,9,1943427,1721788,221639,11.4
LA,1987,10,1946795,1725559,221236,11.4
LA,1987,11,1944962,1725314,219648,11.3
LA,1987,12,1942569,1723290,219279,11.3
LA,1988,1,1941902,1722992,218910,11.3
LA,1988,2,1941060,1724327,216733,11.2
LA,1988,3,1937286,1724629,212657,11
LA,1988,4,1932714,1725482,207232,10.7
LA,1988,5,1929646,1724038,205608,10.7
LA,1988,6,1925622,1724573,201049,10.4
LA,1988,7,1927574,1725940,201634,10.5
LA,1988,8,1924900,1725576,199324,10.4
LA,1988,9,1925419,1727688,197731,10.3
LA,1988,10,1920688,1728381,192307,10
LA,1988,11,1915000,1727307,187693,9.8
LA,1988,12,1918902,1730309,188593,9.8
LA,1989,1,1912415,1726909,185506,9.7
LA,1989,2,1911142,1730892,180250,9.4
LA,1989,3,1903709,1735224,168485,8.9
LA,1989,4,1907028,1745184,161844,8.5
LA,1989,5,1900234,1745983,154251,8.1
LA,1989,6,1900501,1752927,147574,7.8
LA,1989,7,1887906,1747889,140017,7.4
LA,1989,8,1882876,1751014,131862,7
LA,1989,9,1875223,1750848,124375,6.6
LA,1989,10,1870378,1752379,117999,6.3
LA,1989,11,1868783,1753820,114963,6.2
LA,1989,12,1861056,1753550,107506,5.8
LA,1990,1,1865242,1757517,107725,5.8
LA,1990,2,1860509,1758998,101511,5.5
LA,1990,3,1860983,1760167,100816,5.4
LA,1990,4,1863368,1761970,101398,5.4
LA,1990,5,1866561,1767587,98974,5.3
LA,1990,6,1870882,1767520,103362,5.5
LA,1990,7,1877205,1771225,105980,5.6
LA,1990,8,1886992,1772731,114261,6.1
LA,1990,9,1889048,1769971,119077,6.3
LA,1990,10,1892468,1772715,119753,6.3
LA,1990,11,1895854,1774076,121778,6.4
LA,1990,12,1899546,1773200,126346,6.7
LA,1991,1,1904456,1775738,128718,6.8
LA,1991,2,1905499,1777707,127792,6.7
LA,1991,3,1906540,1780318,126222,6.6
LA,1991,4,1911769,1783220,128549,6.7
LA,1991,5,1921766,1788448,133318,6.9
LA,1991,6,1923303,1790306,132997,6.9
LA,1991,7,1927606,1791567,136039,7.1
LA,1991,8,1925516,1790385,135131,7
LA,1991,9,1928891,1794865,134026,6.9
LA,1991,10,1934967,1800983,133984,6.9
LA,1991,11,1934966,1801999,132967,6.9
LA,1991,12,1938990,1802018,136972,7.1
LA,1992,1,1944953,1803897,141056,7.3
LA,1992,2,1955675,1806374,149301,7.6
LA,1992,3,1959134,1809062,150072,7.7
LA,1992,4,1968575,1814967,153608,7.8
LA,1992,5,1970917,1818916,152001,7.7
LA,1992,6,1985577,1826094,159483,8
LA,1992,7,1927918,1765530,162388,8.4
LA,1992,8,1926243,1765942,160301,8.3
LA,1992,9,1929109,1767679,161430,8.4
LA,1992,10,1927633,1778032,149601,7.8
LA,1992,11,1927724,1782469,145255,7.5
LA,1992,12,1857495,1711528,145967,7.9
LA,1993,1,1857510,1716204,141306,7.6
LA,1993,2,1859781,1723787,135994,7.3
LA,1993,3,1863845,1725665,138180,7.4
LA,1993,4,1870385,1730528,139857,7.5
LA,1993,5,1872817,1734750,138067,7.4
LA,1993,6,1871500,1736223,135277,7.2
LA,1993,7,1875066,1739137,135929,7.2
LA,1993,8,1878919,1740145,138774,7.4
LA,1993,9,1881827,1744811,137016,7.3
LA,1993,10,1897018,1753480,143538,7.6
LA,1993,11,1904271,1756275,147996,7.8
LA,1993,12,1906356,1761838,144518,7.6
LA,1994,1,1913381,1764942,148439,7.8
LA,1994,2,1914836,1769186,145650,7.6
LA,1994,3,1921586,1774529,147057,7.7
LA,1994,4,1921628,1773652,147976,7.7
LA,1994,5,1923706,1775436,148270,7.7
LA,1994,6,1926284,1780069,146215,7.6
LA,1994,7,1936801,1789769,147032,7.6
LA,1994,8,1941571,1793912,147659,7.6
LA,1994,9,1943451,1799199,144252,7.4
LA,1994,10,1945767,1798876,146891,7.5
LA,1994,11,1945707,1803232,142475,7.3
LA,1994,12,1942498,1805048,137450,7.1
LA,1995,1,1940721,1807471,133250,6.9
LA,1995,2,1944492,1809944,134548,6.9
LA,1995,3,1949432,1812619,136813,7
LA,1995,4,1949217,1810723,138494,7.1
LA,1995,5,1949594,1815487,134107,6.9
LA,1995,6,1952057,1820777,131280,6.7
LA,1995,7,1952259,1822515,129744,6.6
LA,1995,8,1952284,1826200,126084,6.5
LA,1995,9,1956921,1831319,125602,6.4
LA,1995,10,1952859,1827200,125659,6.4
LA,1995,11,1955425,1829485,125940,6.4
LA,1995,12,1956233,1830565,125668,6.4
LA,1996,1,1961356,1834482,126874,6.5
LA,1996,2,1963333,1837750,125583,6.4
LA,1996,3,1969432,1842377,127055,6.5
LA,1996,4,1972414,1845361,127053,6.4
LA,1996,5,1978549,1851740,126809,6.4
LA,1996,6,1982411,1855309,127102,6.4
LA,1996,7,1985467,1857586,127881,6.4
LA,1996,8,1988016,1861857,126159,6.3
LA,1996,9,1993031,1867022,126009,6.3
LA,1996,10,1993136,1866256,126880,6.4
LA,1996,11,1989412,1872334,117078,5.9
LA,1996,12,1992016,1873616,118400,5.9
LA,1997,1,1987185,1873519,113666,5.7
LA,1997,2,1986969,1875275,111694,5.6
LA,1997,3,1996896,1880012,116884,5.9
LA,1997,4,1997852,1883250,114602,5.7
LA,1997,5,2004619,1882610,122009,6.1
LA,1997,6,2004546,1886080,118466,5.9
LA,1997,7,2008842,1892267,116575,5.8
LA,1997,8,2007968,1893167,114801,5.7
LA,1997,9,2010647,1897859,112788,5.6
LA,1997,10,2016210,1902029,114181,5.7
LA,1997,11,2018222,1904967,113255,5.6
LA,1997,12,2017547,1910188,107359,5.3
LA,1998,1,2008504,1907554,100950,5
LA,1998,2,2007367,1910128,97239,4.8
LA,1998,3,2014524,1910382,104142,5.2
LA,1998,4,2032067,1919643,112424,5.5
LA,1998,5,2033726,1923474,110252,5.4
LA,1998,6,2036587,1923735,112852,5.5
LA,1998,7,2042376,1922867,119509,5.9
LA,1998,8,2037587,1922634,114953,5.6
LA,1998,9,2036903,1923500,113403,5.6
LA,1998,10,2025787,1920073,105714,5.2
LA,1998,11,2024366,1919020,105346,5.2
LA,1998,12,2027387,1923874,103513,5.1
LA,1999,1,2023298,1924900,98398,4.9
LA,1999,2,2025748,1927590,98158,4.8
LA,1999,3,2022145,1926924,95221,4.7
LA,1999,4,2019659,1923269,96390,4.8
LA,1999,5,2009816,1918793,91023,4.5
LA,1999,6,2015928,1923837,92091,4.6
LA,1999,7,2022327,1926849,95478,4.7
LA,1999,8,2025235,1927121,98114,4.8
LA,1999,9,2028602,1928555,100047,4.9
LA,1999,10,2029821,1929941,99880,4.9
LA,1999,11,2024016,1931624,92392,4.6
LA,1999,12,2019354,1931387,87967,4.4
LA,2000,1,2030495,1939007,91488,4.5
LA,2000,2,2031627,1939339,92288,4.5
LA,2000,3,2034599,1940276,94323,4.6
LA,2000,4,2030509,1938623,91886,4.5
LA,2000,5,2040498,1942434,98064,4.8
LA,2000,6,2032010,1931690,100320,4.9
LA,2000,7,2024345,1924362,99983,4.9
LA,2000,8,2026384,1923707,102677,5.1
LA,2000,9,2025022,1920502,104520,5.2
LA,2000,10,2030418,1921468,108950,5.4
LA,2000,11,2032618,1919866,112752,5.5
LA,2000,12,2036971,1926667,110304,5.4
LA,2001,1,2039231,1928869,110362,5.4
LA,2001,2,2036036,1929953,106083,5.2
LA,2001,3,2037896,1931768,106128,5.2
LA,2001,4,2030977,1927308,103669,5.1
LA,2001,5,2031117,1927193,103924,5.1
LA,2001,6,2031139,1927507,103632,5.1
LA,2001,7,2023128,1919526,103602,5.1
LA,2001,8,2023822,1921611,102211,5.1
LA,2001,9,2029805,1919156,110649,5.5
LA,2001,10,2028291,1914003,114288,5.6
LA,2001,11,2030438,1910396,120042,5.9
LA,2001,12,2028766,1908027,120739,6
LA,2002,1,2013817,1896995,116822,5.8
LA,2002,2,2011453,1895295,116158,5.8
LA,2002,3,2006344,1893197,113147,5.6
LA,2002,4,2012378,1896969,115409,5.7
LA,2002,5,2013443,1894282,119161,5.9
LA,2002,6,2010858,1894113,116745,5.8
LA,2002,7,2005938,1891518,114420,5.7
LA,2002,8,2008944,1890419,118525,5.9
LA,2002,9,2008869,1888914,119955,6
LA,2002,10,2009003,1887828,121175,6
LA,2002,11,2014736,1891530,123206,6.1
LA,2002,12,2014421,1890574,123847,6.1
LA,2003,1,2016375,1898772,117603,5.8
LA,2003,2,2022849,1899464,123385,6.1
LA,2003,3,2026500,1897407,129093,6.4
LA,2003,4,2026249,1897358,128891,6.4
LA,2003,5,2029473,1898883,130590,6.4
LA,2003,6,2028421,1895330,133091,6.6
LA,2003,7,2028405,1893462,134943,6.7
LA,2003,8,2024477,1893972,130505,6.4
LA,2003,9,2019830,1897989,121841,6
LA,2003,10,2019972,1902410,117562,5.8
LA,2003,11,2022132,1904178,117954,5.8
LA,2003,12,2026606,1906726,119880,5.9
LA,2004,1,2029507,1911367,118140,5.8
LA,2004,2,2029991,1914958,115033,5.7
LA,2004,3,2029911,1917476,112435,5.5
LA,2004,4,2035483,1919236,116247,5.7
LA,2004,5,2037689,1920323,117366,5.8
LA,2004,6,2040170,1924485,115685,5.7
LA,2004,7,2041369,1928558,112811,5.5
LA,2004,8,2038633,1932527,106106,5.2
LA,2004,9,2044746,1936102,108644,5.3
LA,2004,10,2051301,1940879,110422,5.4
LA,2004,11,2054589,1945324,109265,5.3
LA,2004,12,2058121,1950333,107788,5.2
LA,2005,1,2064344,1955243,109101,5.3
LA,2005,2,2063500,1956801,106699,5.2
LA,2005,3,2062923,1960602,102321,5
LA,2005,4,2069402,1968206,101196,4.9
LA,2005,5,2072924,1970379,102545,4.9
LA,2005,6,2077621,1972837,104784,5
LA,2005,7,2078366,1973585,104781,5
LA,2005,8,2079846,1976722,103124,5
LA,2005,9,2113304,1879346,233958,11.1
LA,2005,10,2108137,1870709,237428,11.3
LA,2005,11,2118329,1876648,241681,11.4
LA,2005,12,2009284,1883034,126250,6.3
LA,2006,1,1978294,1888202,90092,4.6
LA,2006,2,1977825,1894033,83792,4.2
LA,2006,3,1977054,1896952,80102,4.1
LA,2006,4,1974580,1898433,76147,3.9
LA,2006,5,1977951,1901709,76242,3.9
LA,2006,6,1976751,1906030,70721,3.6
LA,2006,7,1971700,1909069,62631,3.2
LA,2006,8,1983908,1910760,73148,3.7
LA,2006,9,1992914,1916093,76821,3.9
LA,2006,10,2001541,1918428,83113,4.2
LA,2006,11,2005123,1922475,82648,4.1
LA,2006,12,2008020,1927399,80621,4
LA,2007,1,2007675,1931504,76171,3.8
LA,2007,2,2012144,1936282,75862,3.8
LA,2007,3,2020822,1942652,78170,3.9
LA,2007,4,2021047,1940605,80442,4
LA,2007,5,2023037,1941186,81851,4
LA,2007,6,2017256,1943431,73825,3.7
LA,2007,7,2021381,1947796,73585,3.6
LA,2007,8,2027429,1952591,74838,3.7
LA,2007,9,2029695,1954200,75495,3.7
LA,2007,10,2033809,1963023,70786,3.5
LA,2007,11,2043174,1967662,75512,3.7
LA,2007,12,2051852,1971878,79974,3.9
LA,2008,1,2048234,1971103,77131,3.8
LA,2008,2,2053380,1975147,78233,3.8
LA,2008,3,2061140,1974898,86242,4.2
LA,2008,4,2063334,1978822,84512,4.1
LA,2008,5,2063640,1979987,83653,4.1
LA,2008,6,2068099,1981839,86260,4.2
LA,2008,7,2073979,1983315,90664,4.4
LA,2008,8,2090398,1989563,100835,4.8
LA,2008,9,2101964,1984600,117364,5.6
LA,2008,10,2107103,1992264,114839,5.5
LA,2008,11,2105168,1992668,112500,5.3
LA,2008,12,2110784,1994434,116350,5.5
LA,2009,1,2090557,1983470,107087,5.1
ME,1976,1,476199,435220,40979,8.6
ME,1976,2,475279,434664,40615,8.5
ME,1976,3,474385,434780,39605,8.3
ME,1976,4,474273,435207,39066,8.2
ME,1976,5,474690,435718,38972,8.2
ME,1976,6,476094,436467,39627,8.3
ME,1976,7,474593,435536,39057,8.2
ME,1976,8,476149,435639,40510,8.5
ME,1976,9,476818,436166,40652,8.5
ME,1976,10,477779,436065,41714,8.7
ME,1976,11,478959,436441,42518,8.9
ME,1976,12,479966,437030,42936,8.9
ME,1977,1,480115,437197,42918,8.9
ME,1977,2,481191,437880,43311,9
ME,1977,3,482477,439087,43390,9
ME,1977,4,481644,440460,41184,8.6
ME,1977,5,481366,441694,39672,8.2
ME,1977,6,481659,440900,40759,8.5
ME,1977,7,483638,442713,40925,8.5
ME,1977,8,482713,443733,38980,8.1
ME,1977,9,482131,444281,37850,7.9
ME,1977,10,481090,444023,37067,7.7
ME,1977,11,481882,444667,37215,7.7
ME,1977,12,480595,445237,35358,7.4
ME,1978,1,481991,448263,33728,7
ME,1978,2,482675,450301,32374,6.7
ME,1978,3,482376,451209,31167,6.5
ME,1978,4,482474,452538,29936,6.2
ME,1978,5,483741,453693,30048,6.2
ME,1978,6,486234,456691,29543,6.1
ME,1978,7,488823,458613,30210,6.2
ME,1978,8,490636,458995,31641,6.4
ME,1978,9,490033,458815,31218,6.4
ME,1978,10,492429,461274,31155,6.3
ME,1978,11,492697,462412,30285,6.1
ME,1978,12,494904,463771,31133,6.3
ME,1979,1,494816,464486,30330,6.1
ME,1979,2,496913,464815,32098,6.5
ME,1979,3,498584,466126,32458,6.5
ME,1979,4,499259,466945,32314,6.5
ME,1979,5,499983,466825,33158,6.6
ME,1979,6,499822,467593,32229,6.4
ME,1979,7,500483,466891,33592,6.7
ME,1979,8,501012,467709,33303,6.6
ME,1979,9,503375,469218,34157,6.8
ME,1979,10,503344,469019,34325,6.8
ME,1979,11,503151,469637,33514,6.7
ME,1979,12,503747,470326,33421,6.6
ME,1980,1,505225,470856,34369,6.8
ME,1980,2,503819,470436,33383,6.6
ME,1980,3,503555,469892,33663,6.7
ME,1980,4,507730,469806,37924,7.5
ME,1980,5,507060,468814,38246,7.5
ME,1980,6,506464,467146,39318,7.8
ME,1980,7,506025,466529,39496,7.8
ME,1980,8,506396,465866,40530,8
ME,1980,9,505992,465876,40116,7.9
ME,1980,10,507029,468169,38860,7.7
ME,1980,11,506922,469049,37873,7.5
ME,1980,12,508522,470215,38307,7.5
ME,1981,1,508911,471015,37896,7.4
ME,1981,2,508319,472897,35422,7
ME,1981,3,509760,474372,35388,6.9
ME,1981,4,509398,475103,34295,6.7
ME,1981,5,509945,474607,35338,6.9
ME,1981,6,512631,475910,36721,7.2
ME,1981,7,513128,478539,34589,6.7
ME,1981,8,514554,478506,36048,7
ME,1981,9,514590,476986,37604,7.3
ME,1981,10,515467,478259,37208,7.2
ME,1981,11,517072,478228,38844,7.5
ME,1981,12,517691,478705,38986,7.5
ME,1982,1,516722,477071,39651,7.7
ME,1982,2,517566,476928,40638,7.9
ME,1982,3,519123,476623,42500,8.2
ME,1982,4,519336,476407,42929,8.3
ME,1982,5,520240,477123,43117,8.3
ME,1982,6,520712,477443,43269,8.3
ME,1982,7,522152,475968,46184,8.8
ME,1982,8,521323,478036,43287,8.3
ME,1982,9,522340,479635,42705,8.2
ME,1982,10,521726,477553,44173,8.5
ME,1982,11,522160,477658,44502,8.5
ME,1982,12,523294,479134,44160,8.4
ME,1983,1,525585,480656,44929,8.5
ME,1983,2,527192,481271,45921,8.7
ME,1983,3,527712,483038,44674,8.5
ME,1983,4,529334,484960,44374,8.4
ME,1983,5,531395,486119,45276,8.5
ME,1983,6,530995,487222,43773,8.2
ME,1983,7,535527,491380,44147,8.2
ME,1983,8,536661,494752,41909,7.8
ME,1983,9,535514,495726,39788,7.4
ME,1983,10,536466,497305,39161,7.3
ME,1983,11,537728,499979,37749,7
ME,1983,12,539614,501794,37820,7
ME,1984,1,541447,506061,35386,6.5
ME,1984,2,544366,509643,34723,6.4
ME,1984,3,545817,512072,33745,6.2
ME,1984,4,546941,513695,33246,6.1
ME,1984,5,548768,515205,33563,6.1
ME,1984,6,551321,518196,33125,6
ME,1984,7,553853,519786,34067,6.2
ME,1984,8,552633,519670,32963,6
ME,1984,9,550672,518654,32018,5.8
ME,1984,10,551282,520339,30943,5.6
ME,1984,11,551684,520561,31123,5.6
ME,1984,12,552429,521720,30709,5.6
ME,1985,1,553924,523036,30888,5.6
ME,1985,2,555125,523189,31936,5.8
ME,1985,3,554305,522888,31417,5.7
ME,1985,4,554242,522436,31806,5.7
ME,1985,5,554132,523624,30508,5.5
ME,1985,6,553607,523245,30362,5.5
ME,1985,7,551862,521384,30478,5.5
ME,1985,8,552355,522456,29899,5.4
ME,1985,9,554586,524417,30169,5.4
ME,1985,10,556987,526187,30800,5.5
ME,1985,11,557282,526358,30924,5.5
ME,1985,12,557830,527920,29910,5.4
ME,1986,1,559753,529539,30214,5.4
ME,1986,2,560083,531495,28588,5.1
ME,1986,3,560413,531692,28721,5.1
ME,1986,4,562151,532422,29729,5.3
ME,1986,5,562958,533621,29337,5.2
ME,1986,6,564595,535209,29386,5.2
ME,1986,7,566326,536317,30009,5.3
ME,1986,8,567037,536633,30404,5.4
ME,1986,9,568887,538186,30701,5.4
ME,1986,10,568643,538999,29644,5.2
ME,1986,11,569918,540897,29021,5.1
ME,1986,12,570219,542933,27286,4.8
ME,1987,1,570410,544891,25519,4.5
ME,1987,2,572021,546881,25140,4.4
ME,1987,3,574689,550310,24379,4.2
ME,1987,4,577656,552974,24682,4.3
ME,1987,5,580913,555417,25496,4.4
ME,1987,6,583187,556324,26863,4.6
ME,1987,7,583255,559633,23622,4.1
ME,1987,8,589162,562469,26693,4.5
ME,1987,9,591297,564028,27269,4.6
ME,1987,10,589371,563692,25679,4.4
ME,1987,11,588452,564463,23989,4.1
ME,1987,12,588350,566008,22342,3.8
ME,1988,1,587576,566475,21101,3.6
ME,1988,2,587457,567422,20035,3.4
ME,1988,3,588600,567926,20674,3.5
ME,1988,4,589181,569050,20131,3.4
ME,1988,5,590444,568564,21880,3.7
ME,1988,6,591763,569858,21905,3.7
ME,1988,7,594590,571617,22973,3.9
ME,1988,8,594963,571810,23153,3.9
ME,1988,9,596086,572937,23149,3.9
ME,1988,10,599285,576534,22751,3.8
ME,1988,11,599645,578099,21546,3.6
ME,1988,12,598932,578109,20823,3.5
ME,1989,1,598211,578129,20082,3.4
ME,1989,2,599179,579559,19620,3.3
ME,1989,3,600508,579832,20676,3.4
ME,1989,4,602747,580091,22656,3.8
ME,1989,5,605858,581160,24698,4.1
ME,1989,6,608572,583447,25125,4.1
ME,1989,7,610724,584206,26518,4.3
ME,1989,8,611939,585930,26009,4.3
ME,1989,9,613922,588221,25701,4.2
ME,1989,10,614250,587853,26397,4.3
ME,1989,11,616790,589898,26892,4.4
ME,1989,12,621089,593183,27906,4.5
ME,1990,1,623697,595302,28395,4.6
ME,1990,2,625015,595814,29201,4.7
ME,1990,3,628069,597896,30173,4.8
ME,1990,4,629221,599260,29961,4.8
ME,1990,5,631608,601255,30353,4.8
ME,1990,6,633214,601802,31412,5
ME,1990,7,632134,599548,32586,5.2
ME,1990,8,630172,597657,32515,5.2
ME,1990,9,631815,598216,33599,5.3
ME,1990,10,634271,597477,36794,5.8
ME,1990,11,636228,595364,40864,6.4
ME,1990,12,638319,595231,43088,6.8
ME,1991,1,642880,594894,47986,7.5
ME,1991,2,646699,592718,53981,8.3
ME,1991,3,646428,590386,56042,8.7
ME,1991,4,645673,589545,56128,8.7
ME,1991,5,639973,588572,51401,8
ME,1991,6,636583,588999,47584,7.5
ME,1991,7,634393,588892,45501,7.2
ME,1991,8,634112,590298,43814,6.9
ME,1991,9,632990,590072,42918,6.8
ME,1991,10,633250,590654,42596,6.7
ME,1991,11,634946,591156,43790,6.9
ME,1991,12,638505,591058,47447,7.4
ME,1992,1,641924,591311,50613,7.9
ME,1992,2,642024,591224,50800,7.9
ME,1992,3,642832,591883,50949,7.9
ME,1992,4,642184,593304,48880,7.6
ME,1992,5,641236,594416,46820,7.3
ME,1992,6,638944,594121,44823,7
ME,1992,7,639209,596507,42702,6.7
ME,1992,8,638461,596068,42393,6.6
ME,1992,9,637273,596129,41144,6.5
ME,1992,10,637570,595646,41924,6.6
ME,1992,11,637714,595031,42683,6.7
ME,1992,12,636087,593337,42750,6.7
ME,1993,1,632509,590935,41574,6.6
ME,1993,2,630646,589780,40866,6.5
ME,1993,3,631402,590009,41393,6.6
ME,1993,4,632134,590139,41995,6.6
ME,1993,5,632323,590030,42293,6.7
ME,1993,6,631520,589070,42450,6.7
ME,1993,7,629584,589493,40091,6.4
ME,1993,8,630686,589720,40966,6.5
ME,1993,9,630958,589364,41594,6.6
ME,1993,10,631949,590925,41024,6.5
ME,1993,11,631863,589422,42441,6.7
ME,1993,12,631275,588714,42561,6.7
ME,1994,1,630179,587902,42277,6.7
ME,1994,2,631482,588228,43254,6.8
ME,1994,3,631043,587971,43072,6.8
ME,1994,4,629980,587956,42024,6.7
ME,1994,5,629806,587419,42387,6.7
ME,1994,6,628282,587134,41148,6.5
ME,1994,7,628188,587686,40502,6.4
ME,1994,8,627160,587808,39352,6.3
ME,1994,9,628258,589656,38602,6.1
ME,1994,10,629251,590329,38922,6.2
ME,1994,11,630444,592730,37714,6
ME,1994,12,631974,594057,37917,6
ME,1995,1,633746,594512,39234,6.2
ME,1995,2,634891,596331,38560,6.1
ME,1995,3,635259,597144,38115,6
ME,1995,4,635586,597900,37686,5.9
ME,1995,5,637994,600868,37126,5.8
ME,1995,6,639100,601708,37392,5.9
ME,1995,7,637216,600508,36708,5.8
ME,1995,8,639861,603176,36685,5.7
ME,1995,9,641588,605306,36282,5.7
ME,1995,10,641951,606412,35539,5.5
ME,1995,11,643392,607176,36216,5.6
ME,1995,12,643747,607736,36011,5.6
ME,1996,1,646323,610613,35710,5.5
ME,1996,2,648070,611469,36601,5.6
ME,1996,3,648594,612777,35817,5.5
ME,1996,4,648889,613519,35370,5.5
ME,1996,5,648191,613957,34234,5.3
ME,1996,6,650059,616196,33863,5.2
ME,1996,7,652963,618935,34028,5.2
ME,1996,8,653976,620495,33481,5.1
ME,1996,9,654253,621224,33029,5
ME,1996,10,654542,621783,32759,5
ME,1996,11,656507,624160,32347,4.9
ME,1996,12,657669,624624,33045,5
ME,1997,1,658943,624318,34625,5.3
ME,1997,2,658879,623450,35429,5.4
ME,1997,3,659236,624256,34980,5.3
ME,1997,4,659527,623450,36077,5.5
ME,1997,5,658038,624138,33900,5.2
ME,1997,6,657607,624287,33320,5.1
ME,1997,7,657869,624447,33422,5.1
ME,1997,8,657779,625202,32577,5
ME,1997,9,657699,625160,32539,4.9
ME,1997,10,656762,624350,32412,4.9
ME,1997,11,656943,624732,32211,4.9
ME,1997,12,658552,625128,33424,5.1
ME,1998,1,657866,623586,34280,5.2
ME,1998,2,655621,625214,30407,4.6
ME,1998,3,654818,625123,29695,4.5
ME,1998,4,653833,626054,27779,4.2
ME,1998,5,654579,626826,27753,4.2
ME,1998,6,655438,626885,28553,4.4
ME,1998,7,656915,626571,30344,4.6
ME,1998,8,657693,627556,30137,4.6
ME,1998,9,658452,629148,29304,4.5
ME,1998,10,661304,631192,30112,4.6
ME,1998,11,661793,633138,28655,4.3
ME,1998,12,660675,633753,26922,4.1
ME,1999,1,659725,633544,26181,4
ME,1999,2,661810,635527,26283,4
ME,1999,3,662601,636967,25634,3.9
ME,1999,4,662059,637675,24384,3.7
ME,1999,5,664668,637746,26922,4.1
ME,1999,6,667431,639738,27693,4.1
ME,1999,7,668070,641872,26198,3.9
ME,1999,8,669985,642836,27149,4.1
ME,1999,9,673190,645758,27432,4.1
ME,1999,10,675809,648965,26844,4
ME,1999,11,673011,647436,25575,3.8
ME,1999,12,673722,648148,25574,3.8
ME,2000,1,673438,649804,23634,3.5
ME,2000,2,672598,650550,22048,3.3
ME,2000,3,673137,651765,21372,3.2
ME,2000,4,672865,651885,20980,3.1
ME,2000,5,674279,652290,21989,3.3
ME,2000,6,673232,651301,21931,3.3
ME,2000,7,672758,651332,21426,3.2
ME,2000,8,672190,650022,22168,3.3
ME,2000,9,671768,648754,23014,3.4
ME,2000,10,669705,647118,22587,3.4
ME,2000,11,671852,649610,22242,3.3
ME,2000,12,671456,650189,21267,3.2
ME,2001,1,671020,650977,20043,3
ME,2001,2,671592,650689,20903,3.1
ME,2001,3,671326,650701,20625,3.1
ME,2001,4,674679,650657,24022,3.6
ME,2001,5,676098,650684,25414,3.8
ME,2001,6,676795,651264,25531,3.8
ME,2001,7,676951,650576,26375,3.9
ME,2001,8,677483,650504,26979,4
ME,2001,9,679074,650837,28237,4.2
ME,2001,10,679569,650671,28898,4.3
ME,2001,11,679400,651070,28330,4.2
ME,2001,12,677786,649753,28033,4.1
ME,2002,1,674647,646938,27709,4.1
ME,2002,2,674724,647826,26898,4
ME,2002,3,677191,649002,28189,4.2
ME,2002,4,678703,649958,28745,4.2
ME,2002,5,679351,650623,28728,4.2
ME,2002,6,681584,651757,29827,4.4
ME,2002,7,682363,652499,29864,4.4
ME,2002,8,682266,652184,30082,4.4
ME,2002,9,682705,651983,30722,4.5
ME,2002,10,683876,653101,30775,4.5
ME,2002,11,684039,652239,31800,4.6
ME,2002,12,685379,653206,32173,4.7
ME,2003,1,681461,648771,32690,4.8
ME,2003,2,682546,649132,33414,4.9
ME,2003,3,682849,649011,33838,5
ME,2003,4,683960,648721,35239,5.2
ME,2003,5,683116,649230,33886,5
ME,2003,6,683270,649066,34204,5
ME,2003,7,685318,650233,35085,5.1
ME,2003,8,686125,651503,34622,5
ME,2003,9,687641,652207,35434,5.2
ME,2003,10,687055,652142,34913,5.1
ME,2003,11,686631,652720,33911,4.9
ME,2003,12,686294,652760,33534,4.9
ME,2004,1,683884,651889,31995,4.7
ME,2004,2,684440,652455,31985,4.7
ME,2004,3,683885,652360,31525,4.6
ME,2004,4,683270,652877,30393,4.4
ME,2004,5,683906,653641,30265,4.4
ME,2004,6,684605,653805,30800,4.5
ME,2004,7,685002,654047,30955,4.5
ME,2004,8,686570,654416,32154,4.7
ME,2004,9,687156,654395,32761,4.8
ME,2004,10,687517,654869,32648,4.7
ME,2004,11,688148,655796,32352,4.7
ME,2004,12,688026,655613,32413,4.7
ME,2005,1,688131,655762,32369,4.7
ME,2005,2,689360,656246,33114,4.8
ME,2005,3,689681,656241,33440,4.8
ME,2005,4,691623,658217,33406,4.8
ME,2005,5,693633,659409,34224,4.9
ME,2005,6,694028,660265,33763,4.9
ME,2005,7,695995,661579,34416,4.9
ME,2005,8,696876,661948,34928,5
ME,2005,9,697937,662925,35012,5
ME,2005,10,698059,663575,34484,4.9
ME,2005,11,697790,664692,33098,4.7
ME,2005,12,698304,665824,32480,4.7
ME,2006,1,697710,665855,31855,4.6
ME,2006,2,697517,666324,31193,4.5
ME,2006,3,698472,667518,30954,4.4
ME,2006,4,699607,669342,30265,4.3
ME,2006,5,700608,668473,32135,4.6
ME,2006,6,701800,668652,33148,4.7
ME,2006,7,701576,668108,33468,4.8
ME,2006,8,704190,670374,33816,4.8
ME,2006,9,703846,670221,33625,4.8
ME,2006,10,704122,670381,33741,4.8
ME,2006,11,704300,671190,33110,4.7
ME,2006,12,704308,672366,31942,4.5
ME,2007,1,703791,672752,31039,4.4
ME,2007,2,702658,671015,31643,4.5
ME,2007,3,702343,670696,31647,4.5
ME,2007,4,701451,669312,32139,4.6
ME,2007,5,701628,668948,32680,4.7
ME,2007,6,702002,669625,32377,4.6
ME,2007,7,701939,669073,32866,4.7
ME,2007,8,701750,668629,33121,4.7
ME,2007,9,702084,668483,33601,4.8
ME,2007,10,703535,669733,33802,4.8
ME,2007,11,703479,670329,33150,4.7
ME,2007,12,703928,670780,33148,4.7
ME,2008,1,704798,670856,33942,4.8
ME,2008,2,704859,670635,34224,4.9
ME,2008,3,705262,669929,35333,5
ME,2008,4,705846,670196,35650,5.1
ME,2008,5,706045,670064,35981,5.1
ME,2008,6,706095,669715,36380,5.2
ME,2008,7,707466,669601,37865,5.4
ME,2008,8,707143,668713,38430,5.4
ME,2008,9,707358,668087,39271,5.6
ME,2008,10,707347,667075,40272,5.7
ME,2008,11,709121,665474,43647,6.2
ME,2008,12,710603,664339,46264,6.5
ME,2009,1,710917,655394,55523,7.8
MD,1976,1,1902395,1772415,129980,6.8
MD,1976,2,1898711,1775713,122998,6.5
MD,1976,3,1904797,1777373,127424,6.7
MD,1976,4,1908017,1781593,126424,6.6
MD,1976,5,1907785,1784229,123556,6.5
MD,1976,6,1912371,1789825,122546,6.4
MD,1976,7,1916313,1791811,124502,6.5
MD,1976,8,1918765,1795755,123010,6.4
MD,1976,9,1926416,1796989,129427,6.7
MD,1976,10,1928123,1802714,125409,6.5
MD,1976,11,1937697,1807592,130105,6.7
MD,1976,12,1940510,1811503,129007,6.6
MD,1977,1,1949588,1816761,132827,6.8
MD,1977,2,1955530,1822591,132939,6.8
MD,1977,3,1961225,1829449,131776,6.7
MD,1977,4,1957027,1834196,122831,6.3
MD,1977,5,1960084,1840332,119752,6.1
MD,1977,6,1964892,1847619,117273,6
MD,1977,7,1969159,1854818,114341,5.8
MD,1977,8,1977599,1862210,115389,5.8
MD,1977,9,1981667,1868864,112803,5.7
MD,1977,10,1996416,1876473,119943,6
MD,1977,11,2001259,1884963,116296,5.8
MD,1977,12,2012612,1893261,119351,5.9
MD,1978,1,2019687,1900402,119285,5.9
MD,1978,2,2033478,1909774,123704,6.1
MD,1978,3,2039731,1914831,124900,6.1
MD,1978,4,2038187,1922324,115863,5.7
MD,1978,5,2041362,1927571,113791,5.6
MD,1978,6,2046202,1935126,111076,5.4
MD,1978,7,2051395,1937766,113629,5.5
MD,1978,8,2059196,1944530,114666,5.6
MD,1978,9,2063744,1950004,113740,5.5
MD,1978,10,2070576,1955456,115120,5.6
MD,1978,11,2075950,1960157,115793,5.6
MD,1978,12,2087228,1967496,119732,5.7
MD,1979,1,2089153,1971334,117819,5.6
MD,1979,2,2098114,1973650,124464,5.9
MD,1979,3,2098373,1977338,121035,5.8
MD,1979,4,2102244,1980710,121534,5.8
MD,1979,5,2105837,1985870,119967,5.7
MD,1979,6,2106324,1987222,119102,5.7
MD,1979,7,2111304,1990815,120489,5.7
MD,1979,8,2118623,1990977,127646,6
MD,1979,9,2115855,1992514,123341,5.8
MD,1979,10,2116064,1992508,123556,5.8
MD,1979,11,2120502,1994828,125674,5.9
MD,1979,12,2120786,1994942,125844,5.9
MD,1980,1,2124619,1993817,130802,6.2
MD,1980,2,2127770,1994810,132960,6.2
MD,1980,3,2131165,1996019,135146,6.3
MD,1980,4,2136470,1997802,138668,6.5
MD,1980,5,2139346,1998598,140748,6.6
MD,1980,6,2144687,2000185,144502,6.7
MD,1980,7,2148730,2000101,148629,6.9
MD,1980,8,2150201,2002926,147275,6.8
MD,1980,9,2149525,2003313,146212,6.8
MD,1980,10,2149016,2001969,147047,6.8
MD,1980,11,2147290,2001586,145704,6.8
MD,1980,12,2151376,2004056,147320,6.8
MD,1981,1,2154627,2005847,148780,6.9
MD,1981,2,2152195,2005864,146331,6.8
MD,1981,3,2151942,2007658,144284,6.7
MD,1981,4,2155620,2009263,146357,6.8
MD,1981,5,2158708,2010579,148129,6.9
MD,1981,6,2157663,2007072,150591,7
MD,1981,7,2160180,2007185,152995,7.1
MD,1981,8,2165824,2008154,157670,7.3
MD,1981,9,2167985,2007991,159994,7.4
MD,1981,10,2169958,2006619,163339,7.5
MD,1981,11,2177668,2008366,169302,7.8
MD,1981,12,2182186,2009018,173168,7.9
MD,1982,1,2189047,2006801,182246,8.3
MD,1982,2,2184958,2004487,180471,8.3
MD,1982,3,2184884,2004678,180206,8.2
MD,1982,4,2184255,2003297,180958,8.3
MD,1982,5,2180467,2000178,180289,8.3
MD,1982,6,2180724,2000452,180272,8.3
MD,1982,7,2179693,2001718,177975,8.2
MD,1982,8,2181331,1999561,181770,8.3
MD,1982,9,2175261,1996893,178368,8.2
MD,1982,10,2177539,1998826,178713,8.2
MD,1982,11,2179799,2000813,178986,8.2
MD,1982,12,2179461,2002476,176985,8.1
MD,1983,1,2181345,2004220,177125,8.1
MD,1983,2,2183351,2006984,176367,8.1
MD,1983,3,2186276,2011900,174376,8
MD,1983,4,2188590,2019225,169365,7.7
MD,1983,5,2191987,2026259,165728,7.6
MD,1983,6,2197082,2033985,163097,7.4
MD,1983,7,2200196,2042403,157793,7.2
MD,1983,8,2202595,2048643,153952,7
MD,1983,9,2208880,2057185,151695,6.9
MD,1983,10,2215006,2064368,150638,6.8
MD,1983,11,2218211,2070375,147836,6.7
MD,1983,12,2224322,2077425,146897,6.6
MD,1984,1,2203420,2087076,116344,5.3
MD,1984,2,2211362,2096689,114673,5.2
MD,1984,3,2218620,2104138,114482,5.2
MD,1984,4,2228165,2110542,117623,5.3
MD,1984,5,2233892,2116930,116962,5.2
MD,1984,6,2238436,2122989,115447,5.2
MD,1984,7,2240382,2126142,114240,5.1
MD,1984,8,2244556,2131418,113138,5
MD,1984,9,2250972,2137025,113947,5.1
MD,1984,10,2255020,2142328,112692,5
MD,1984,11,2256558,2143662,112896,5
MD,1984,12,2255849,2144397,111452,4.9
MD,1985,1,2253504,2145381,108123,4.8
MD,1985,2,2258064,2147443,110621,4.9
MD,1985,3,2255505,2149840,105665,4.7
MD,1985,4,2259150,2151304,107846,4.8
MD,1985,5,2262029,2155219,106810,4.7
MD,1985,6,2266697,2160390,106307,4.7
MD,1985,7,2269301,2164258,105043,4.6
MD,1985,8,2271393,2167910,103483,4.6
MD,1985,9,2278063,2173222,104841,4.6
MD,1985,10,2284244,2178053,106191,4.6
MD,1985,11,2290144,2184255,105889,4.6
MD,1985,12,2296199,2190994,105205,4.6
MD,1986,1,2301024,2199037,101987,4.4
MD,1986,2,2312455,2206368,106087,4.6
MD,1986,3,2323116,2215534,107582,4.6
MD,1986,4,2329023,2223551,105472,4.5
MD,1986,5,2336710,2230287,106423,4.6
MD,1986,6,2342940,2236417,106523,4.5
MD,1986,7,2352039,2244340,107699,4.6
MD,1986,8,2356603,2250092,106511,4.5
MD,1986,9,2366041,2255079,110962,4.7
MD,1986,10,2370116,2260298,109818,4.6
MD,1986,11,2377697,2268270,109427,4.6
MD,1986,12,2383025,2273850,109175,4.6
MD,1987,1,2383173,2279330,103843,4.4
MD,1987,2,2389016,2284168,104848,4.4
MD,1987,3,2392823,2288825,103998,4.3
MD,1987,4,2396575,2294158,102417,4.3
MD,1987,5,2399745,2295784,103961,4.3
MD,1987,6,2402334,2297694,104640,4.4
MD,1987,7,2405163,2302441,102722,4.3
MD,1987,8,2410936,2309749,101187,4.2
MD,1987,9,2419635,2315885,103750,4.3
MD,1987,10,2423232,2319702,103530,4.3
MD,1987,11,2425423,2322923,102500,4.2
MD,1987,12,2430630,2328977,101653,4.2
MD,1988,1,2439829,2334502,105327,4.3
MD,1988,2,2441427,2338107,103320,4.2
MD,1988,3,2443628,2343064,100564,4.1
MD,1988,4,2447634,2347550,100084,4.1
MD,1988,5,2455992,2353378,102614,4.2
MD,1988,6,2460942,2358862,102080,4.1
MD,1988,7,2464430,2363755,100675,4.1
MD,1988,8,2468146,2365931,102215,4.1
MD,1988,9,2471870,2369917,101953,4.1
MD,1988,10,2475141,2375235,99906,4
MD,1988,11,2477919,2381284,96635,3.9
MD,1988,12,2482653,2387191,95462,3.8
MD,1989,1,2485263,2392468,92795,3.7
MD,1989,2,2490265,2397047,93218,3.7
MD,1989,3,2497771,2403302,94469,3.8
MD,1989,4,2504671,2408763,95908,3.8
MD,1989,5,2510769,2414473,96296,3.8
MD,1989,6,2515101,2420313,94788,3.8
MD,1989,7,2521668,2427101,94567,3.8
MD,1989,8,2525838,2432599,93239,3.7
MD,1989,9,2532238,2437757,94481,3.7
MD,1989,10,2536563,2443146,93417,3.7
MD,1989,11,2542465,2449986,92479,3.6
MD,1989,12,2546456,2454320,92136,3.6
MD,1990,1,2559906,2459538,100368,3.9
MD,1990,2,2556193,2464434,91759,3.6
MD,1990,3,2557452,2467225,90227,3.5
MD,1990,4,2561263,2466614,94649,3.7
MD,1990,5,2565751,2468247,97504,3.8
MD,1990,6,2566433,2467214,99219,3.9
MD,1990,7,2600551,2466770,133781,5.1
MD,1990,8,2601557,2466682,134875,5.2
MD,1990,9,2603384,2466937,136447,5.2
MD,1990,10,2604053,2465374,138679,5.3
MD,1990,11,2608078,2462556,145522,5.6
MD,1990,12,2609299,2461397,147902,5.7
MD,1991,1,2615988,2461707,154281,5.9
MD,1991,2,2626597,2460578,166019,6.3
MD,1991,3,2628135,2461038,167097,6.4
MD,1991,4,2630837,2462761,168076,6.4
MD,1991,5,2627993,2463478,164515,6.3
MD,1991,6,2626432,2463484,162948,6.2
MD,1991,7,2627868,2466601,161267,6.1
MD,1991,8,2628062,2468779,159283,6.1
MD,1991,9,2630474,2471192,159282,6.1
MD,1991,10,2632879,2470761,162118,6.2
MD,1991,11,2637614,2472263,165351,6.3
MD,1991,12,2645712,2473899,171813,6.5
MD,1992,1,2652740,2476474,176266,6.6
MD,1992,2,2656611,2477451,179160,6.7
MD,1992,3,2662179,2479591,182588,6.9
MD,1992,4,2666567,2483835,182732,6.9
MD,1992,5,2664920,2485219,179701,6.7
MD,1992,6,2664065,2486824,177241,6.7
MD,1992,7,2661929,2488454,173475,6.5
MD,1992,8,2657417,2488407,169010,6.4
MD,1992,9,2658066,2486778,171288,6.4
MD,1992,10,2658812,2487538,171274,6.4
MD,1992,11,2656451,2488575,167876,6.3
MD,1992,12,2656139,2489768,166371,6.3
MD,1993,1,2652429,2489755,162674,6.1
MD,1993,2,2652257,2491478,160779,6.1
MD,1993,3,2657762,2492772,164990,6.2
MD,1993,4,2658563,2492805,165758,6.2
MD,1993,5,2656281,2493112,163169,6.1
MD,1993,6,2657109,2495295,161814,6.1
MD,1993,7,2658906,2498943,159963,6
MD,1993,8,2662367,2503647,158720,6
MD,1993,9,2663963,2508706,155257,5.8
MD,1993,10,2667485,2513020,154465,5.8
MD,1993,11,2669495,2517037,152458,5.7
MD,1993,12,2672920,2521609,151311,5.7
MD,1994,1,2668793,2525530,143263,5.4
MD,1994,2,2674121,2529531,144590,5.4
MD,1994,3,2676260,2531891,144369,5.4
MD,1994,4,2674935,2535460,139475,5.2
MD,1994,5,2680176,2539672,140504,5.2
MD,1994,6,2681920,2543560,138360,5.2
MD,1994,7,2685407,2547315,138092,5.1
MD,1994,8,2688313,2551410,136903,5.1
MD,1994,9,2691902,2555588,136314,5.1
MD,1994,10,2694262,2559166,135096,5
MD,1994,11,2695428,2562074,133354,4.9
MD,1994,12,2698478,2563760,134718,5
MD,1995,1,2696800,2563954,132846,4.9
MD,1995,2,2701066,2564641,136425,5.1
MD,1995,3,2701290,2565945,135345,5
MD,1995,4,2703444,2567600,135844,5
MD,1995,5,2706421,2568890,137531,5.1
MD,1995,6,2711437,2570817,140620,5.2
MD,1995,7,2709481,2572769,136712,5
MD,1995,8,2714521,2575505,139016,5.1
MD,1995,9,2715621,2577284,138337,5.1
MD,1995,10,2718078,2579176,138902,5.1
MD,1995,11,2719668,2581317,138351,5.1
MD,1995,12,2720964,2584599,136365,5
MD,1996,1,2736601,2588925,147676,5.4
MD,1996,2,2732932,2593597,139335,5.1
MD,1996,3,2735564,2597041,138523,5.1
MD,1996,4,2737779,2601357,136422,5
MD,1996,5,2743837,2608463,135374,4.9
MD,1996,6,2749866,2614742,135124,4.9
MD,1996,7,2755201,2619766,135435,4.9
MD,1996,8,2760369,2624882,135487,4.9
MD,1996,9,2765388,2630057,135331,4.9
MD,1996,10,2766713,2633969,132744,4.8
MD,1996,11,2768356,2636710,131646,4.8
MD,1996,12,2768256,2637505,130751,4.7
MD,1997,1,2770081,2638954,131127,4.7
MD,1997,2,2770673,2639939,130734,4.7
MD,1997,3,2772339,2642004,130335,4.7
MD,1997,4,2775697,2644242,131455,4.7
MD,1997,5,2778837,2646616,132221,4.8
MD,1997,6,2780993,2647000,133993,4.8
MD,1997,7,2781603,2647863,133740,4.8
MD,1997,8,2781426,2648370,133056,4.8
MD,1997,9,2785517,2648854,136663,4.9
MD,1997,10,2780640,2648745,131895,4.7
MD,1997,11,2781034,2650333,130701,4.7
MD,1997,12,2779581,2651474,128107,4.6
MD,1998,1,2778467,2652257,126210,4.5
MD,1998,2,2775880,2653233,122647,4.4
MD,1998,3,2776683,2655496,121187,4.4
MD,1998,4,2778949,2657542,121407,4.4
MD,1998,5,2778853,2657045,121808,4.4
MD,1998,6,2779800,2658726,121074,4.4
MD,1998,7,2783987,2660087,123900,4.5
MD,1998,8,2783261,2661993,121268,4.4
MD,1998,9,2779402,2663698,115704,4.2
MD,1998,10,2779998,2667617,112381,4
MD,1998,11,2781539,2670755,110784,4
MD,1998,12,2783289,2675856,107433,3.9
MD,1999,1,2780828,2677632,103196,3.7
MD,1999,2,2781111,2679750,101361,3.6
MD,1999,3,2783369,2682130,101239,3.6
MD,1999,4,2784378,2683915,100463,3.6
MD,1999,5,2786675,2686195,100480,3.6
MD,1999,6,2787752,2687134,100618,3.6
MD,1999,7,2790057,2688786,101271,3.6
MD,1999,8,2791220,2691018,100202,3.6
MD,1999,9,2792492,2693452,99040,3.5
MD,1999,10,2793028,2694381,98647,3.5
MD,1999,11,2791982,2694647,97335,3.5
MD,1999,12,2791556,2695081,96475,3.5
MD,2000,1,2796414,2702389,94025,3.4
MD,2000,2,2798440,2702720,95720,3.4
MD,2000,3,2802312,2709004,93308,3.3
MD,2000,4,2808947,2712097,96850,3.4
MD,2000,5,2813605,2714115,99490,3.5
MD,2000,6,2815534,2714994,100540,3.6
MD,2000,7,2812824,2711513,101311,3.6
MD,2000,8,2812598,2708768,103830,3.7
MD,2000,9,2815631,2711153,104478,3.7
MD,2000,10,2818753,2713849,104904,3.7
MD,2000,11,2821800,2717063,104737,3.7
MD,2000,12,2823021,2718912,104109,3.7
MD,2001,1,2817022,2716169,100853,3.6
MD,2001,2,2819908,2718433,101475,3.6
MD,2001,3,2817100,2715052,102048,3.6
MD,2001,4,2817195,2710237,106958,3.8
MD,2001,5,2822054,2709867,112187,4
MD,2001,6,2825195,2711488,113707,4
MD,2001,7,2822343,2704339,118004,4.2
MD,2001,8,2824564,2704586,119978,4.2
MD,2001,9,2830646,2708702,121944,4.3
MD,2001,10,2839930,2714158,125772,4.4
MD,2001,11,2844443,2716657,127786,4.5
MD,2001,12,2844164,2717527,126637,4.5
MD,2002,1,2851011,2721341,129670,4.5
MD,2002,2,2854455,2728747,125708,4.4
MD,2002,3,2859228,2732110,127118,4.4
MD,2002,4,2862008,2730893,131115,4.6
MD,2002,5,2862385,2733147,129238,4.5
MD,2002,6,2863431,2733168,130263,4.5
MD,2002,7,2859722,2730624,129098,4.5
MD,2002,8,2864369,2735072,129297,4.5
MD,2002,9,2866054,2738230,127824,4.5
MD,2002,10,2865858,2738697,127161,4.4
MD,2002,11,2865846,2738183,127663,4.5
MD,2002,12,2862675,2737018,125657,4.4
MD,2003,1,2857315,2734018,123297,4.3
MD,2003,2,2858080,2731787,126293,4.4
MD,2003,3,2862509,2731978,130531,4.6
MD,2003,4,2866842,2737693,129149,4.5
MD,2003,5,2869245,2740441,128804,4.5
MD,2003,6,2874233,2744312,129921,4.5
MD,2003,7,2882606,2750515,132091,4.6
MD,2003,8,2881050,2751623,129427,4.5
MD,2003,9,2874818,2744965,129853,4.5
MD,2003,10,2871508,2743013,128495,4.5
MD,2003,11,2869792,2742103,127689,4.4
MD,2003,12,2872318,2743447,128871,4.5
MD,2004,1,2876748,2752103,124645,4.3
MD,2004,2,2875653,2751978,123675,4.3
MD,2004,3,2875201,2753583,121618,4.2
MD,2004,4,2874871,2753331,121540,4.2
MD,2004,5,2878156,2756175,121981,4.2
MD,2004,6,2880064,2757120,122944,4.3
MD,2004,7,2887481,2762009,125472,4.3
MD,2004,8,2891408,2765125,126283,4.4
MD,2004,9,2893138,2767568,125570,4.3
MD,2004,10,2894674,2770555,124119,4.3
MD,2004,11,2898001,2774047,123954,4.3
MD,2004,12,2897492,2775405,122087,4.2
MD,2005,1,2900116,2778592,121524,4.2
MD,2005,2,2903725,2783228,120497,4.1
MD,2005,3,2907946,2785261,122685,4.2
MD,2005,4,2914438,2794325,120113,4.1
MD,2005,5,2924939,2802146,122793,4.2
MD,2005,6,2932393,2807928,124465,4.2
MD,2005,7,2938039,2814151,123888,4.2
MD,2005,8,2944925,2821831,123094,4.2
MD,2005,9,2949165,2828248,120917,4.1
MD,2005,10,2953193,2832459,120734,4.1
MD,2005,11,2953872,2836106,117766,4
MD,2005,12,2960612,2844707,115905,3.9
MD,2006,1,2963297,2851259,112038,3.8
MD,2006,2,2968603,2859547,109056,3.7
MD,2006,3,2972297,2864468,107829,3.6
MD,2006,4,2979693,2868470,111223,3.7
MD,2006,5,2982174,2868233,113941,3.8
MD,2006,6,2986851,2870989,115862,3.9
MD,2006,7,2990237,2873527,116710,3.9
MD,2006,8,2992341,2875490,116851,3.9
MD,2006,9,2991680,2876833,114847,3.8
MD,2006,10,2992867,2878694,114173,3.8
MD,2006,11,2993302,2881891,111411,3.7
MD,2006,12,2993900,2884708,109192,3.6
MD,2007,1,2989776,2883911,105865,3.5
MD,2007,2,2982670,2879448,103222,3.5
MD,2007,3,2985781,2883525,102256,3.4
MD,2007,4,2983537,2880989,102548,3.4
MD,2007,5,2984441,2881190,103251,3.5
MD,2007,6,2985646,2880921,104725,3.5
MD,2007,7,2989651,2883970,105681,3.5
MD,2007,8,2988468,2882815,105653,3.5
MD,2007,9,2990702,2883280,107422,3.6
MD,2007,10,2990601,2882747,107854,3.6
MD,2007,11,2991723,2884207,107516,3.6
MD,2007,12,2989384,2882367,107017,3.6
MD,2008,1,2988164,2880610,107554,3.6
MD,2008,2,2990060,2880408,109652,3.7
MD,2008,3,2989419,2875921,113498,3.8
MD,2008,4,2993399,2874969,118430,4
MD,2008,5,2995817,2872981,122836,4.1
MD,2008,6,2996130,2868523,127607,4.3
MD,2008,7,2998410,2867122,131288,4.4
MD,2008,8,3000814,2864989,135825,4.5
MD,2008,9,2998282,2859176,139106,4.6
MD,2008,10,3002801,2857290,145511,4.8
MD,2008,11,3006457,2852955,153502,5.1
MD,2008,12,3012756,2851189,161567,5.4
MD,2009,1,2979839,2794547,185292,6.2
MA,1976,1,2737851,2438310,299541,10.9
MA,1976,2,2732627,2439976,292651,10.7
MA,1976,3,2728307,2442115,286192,10.5
MA,1976,4,2724460,2444818,279642,10.3
MA,1976,5,2722136,2448162,273974,10.1
MA,1976,6,2719337,2452221,267116,9.8
MA,1976,7,2719382,2456952,262430,9.7
MA,1976,8,2719569,2462485,257084,9.5
MA,1976,9,2721592,2468640,252952,9.3
MA,1976,10,2724547,2475064,249483,9.2
MA,1976,11,2728096,2481811,246285,9
MA,1976,12,2733362,2489122,244240,8.9
MA,1977,1,2738656,2497185,241471,8.8
MA,1977,2,2742328,2505537,236791,8.6
MA,1977,3,2748017,2513971,234046,8.5
MA,1977,4,2752421,2522684,229737,8.3
MA,1977,5,2756006,2531271,224735,8.2
MA,1977,6,2760374,2539434,220940,8
MA,1977,7,2763227,2546987,216240,7.8
MA,1977,8,2766639,2553926,212713,7.7
MA,1977,9,2768399,2560525,207874,7.5
MA,1977,10,2770685,2567411,203274,7.3
MA,1977,11,2773762,2575036,198726,7.2
MA,1977,12,2777786,2583322,194464,7
MA,1978,1,2780855,2591830,189025,6.8
MA,1978,2,2786870,2599971,186899,6.7
MA,1978,3,2788918,2608233,180685,6.5
MA,1978,4,2792917,2616313,176604,6.3
MA,1978,5,2797676,2624310,173366,6.2
MA,1978,6,2803936,2632433,171503,6.1
MA,1978,7,2811292,2640765,170527,6.1
MA,1978,8,2817353,2648184,169169,6
MA,1978,9,2822041,2654885,167156,5.9
MA,1978,10,2826752,2661552,165200,5.8
MA,1978,11,2833450,2668104,165346,5.8
MA,1978,12,2840153,2674805,165348,5.8
MA,1979,1,2845915,2681892,164023,5.8
MA,1979,2,2851835,2688759,163076,5.7
MA,1979,3,2856328,2695095,161233,5.6
MA,1979,4,2859399,2700770,158629,5.5
MA,1979,5,2860982,2705580,155402,5.4
MA,1979,6,2863863,2709437,154426,5.4
MA,1979,7,2866112,2712203,153909,5.4
MA,1979,8,2867286,2714501,152785,5.3
MA,1979,9,2869858,2716493,153365,5.3
MA,1979,10,2870807,2718061,152746,5.3
MA,1979,11,2872500,2719325,153175,5.3
MA,1979,12,2873351,2720023,153328,5.3
MA,1980,1,2873377,2719892,153485,5.3
MA,1980,2,2873355,2719679,153676,5.3
MA,1980,3,2874365,2719039,155326,5.4
MA,1980,4,2877061,2718020,159041,5.5
MA,1980,5,2880610,2716998,163612,5.7
MA,1980,6,2883368,2716437,166931,5.8
MA,1980,7,2886035,2716973,169062,5.9
MA,1980,8,2888245,2718879,169366,5.9
MA,1980,9,2891337,2721835,169502,5.9
MA,1980,10,2895760,2725576,170184,5.9
MA,1980,11,2899383,2729724,169659,5.9
MA,1980,12,2903027,2734105,168922,5.8
MA,1981,1,2910725,2738844,171881,5.9
MA,1981,2,2915358,2743134,172224,5.9
MA,1981,3,2921030,2746887,174143,6
MA,1981,4,2926290,2749981,176309,6
MA,1981,5,2932821,2752199,180622,6.2
MA,1981,6,2938842,2753534,185308,6.3
MA,1981,7,2944211,2753963,190248,6.5
MA,1981,8,2948524,2753718,194806,6.6
MA,1981,9,2952278,2752564,199714,6.8
MA,1981,10,2953869,2750768,203101,6.9
MA,1981,11,2956645,2748174,208471,7.1
MA,1981,12,2959469,2744981,214488,7.2
MA,1982,1,2963193,2741283,221910,7.5
MA,1982,2,2963084,2737973,225111,7.6
MA,1982,3,2963123,2734960,228163,7.7
MA,1982,4,2964861,2732140,232721,7.8
MA,1982,5,2965382,2729742,235640,7.9
MA,1982,6,2966050,2727604,238446,8
MA,1982,7,2967060,2726053,241007,8.1
MA,1982,8,2967603,2725086,242517,8.2
MA,1982,9,2966153,2724545,241608,8.1
MA,1982,10,2967255,2723996,243259,8.2
MA,1982,11,2966390,2723865,242525,8.2
MA,1982,12,2967823,2724269,243554,8.2
MA,1983,1,2965001,2725453,239548,8.1
MA,1983,2,2962913,2728064,234849,7.9
MA,1983,3,2962001,2732205,229796,7.8
MA,1983,4,2960815,2737662,223153,7.5
MA,1983,5,2961752,2744321,217431,7.3
MA,1983,6,2963354,2752167,211187,7.1
MA,1983,7,2965372,2761102,204270,6.9
MA,1983,8,2970792,2771094,199698,6.7
MA,1983,9,2977685,2782534,195151,6.6
MA,1983,10,2984867,2794717,190150,6.4
MA,1983,11,2991480,2807518,183962,6.1
MA,1983,12,2999190,2820933,178257,5.9
MA,1984,1,3005922,2834811,171111,5.7
MA,1984,2,3011879,2847663,164216,5.5
MA,1984,3,3018442,2859401,159041,5.3
MA,1984,4,3025104,2870225,154879,5.1
MA,1984,5,3029052,2880215,148837,4.9
MA,1984,6,3033977,2889319,144658,4.8
MA,1984,7,3037765,2897276,140489,4.6
MA,1984,8,3042224,2904012,138212,4.5
MA,1984,9,3045035,2909399,135636,4.5
MA,1984,10,3045766,2913655,132111,4.3
MA,1984,11,3047349,2916773,130576,4.3
MA,1984,12,3046751,2918637,128114,4.2
MA,1985,1,3045213,2919274,125939,4.1
MA,1985,2,3044886,2919851,125035,4.1
MA,1985,3,3043675,2920468,123207,4
MA,1985,4,3045032,2921105,123927,4.1
MA,1985,5,3046277,2921788,124489,4.1
MA,1985,6,3047066,2922501,124565,4.1
MA,1985,7,3048384,2923331,125053,4.1
MA,1985,8,3049502,2924641,124861,4.1
MA,1985,9,3050889,2926448,124441,4.1
MA,1985,10,3054192,2928930,125262,4.1
MA,1985,11,3057443,2931903,125540,4.1
MA,1985,12,3059985,2935273,124712,4.1
MA,1986,1,3062434,2939012,123422,4
MA,1986,2,3065023,2942500,122523,4
MA,1986,3,3068398,2945805,122593,4
MA,1986,4,3072089,2948980,123109,4
MA,1986,5,3076400,2951922,124478,4
MA,1986,6,3079051,2954799,124252,4
MA,1986,7,3081348,2958005,123343,4
MA,1986,8,3086143,2961438,124705,4
MA,1986,9,3090065,2965094,124971,4
MA,1986,10,3091600,2969059,122541,4
MA,1986,11,3093462,2973335,120127,3.9
MA,1986,12,3094071,2977906,116165,3.8
MA,1987,1,3094734,2982787,111947,3.6
MA,1987,2,3099984,2987865,112119,3.6
MA,1987,3,3104099,2993142,110957,3.6
MA,1987,4,3108137,2998678,109459,3.5
MA,1987,5,3111204,3004036,107168,3.4
MA,1987,6,3113428,3009133,104295,3.3
MA,1987,7,3114578,3013861,100717,3.2
MA,1987,8,3118836,3018056,100780,3.2
MA,1987,9,3122648,3021943,100705,3.2
MA,1987,10,3125361,3025935,99426,3.2
MA,1987,11,3127680,3029831,97849,3.1
MA,1987,12,3131616,3033538,98078,3.1
MA,1988,1,3136484,3036954,99530,3.2
MA,1988,2,3141013,3040376,100637,3.2
MA,1988,3,3144837,3043606,101231,3.2
MA,1988,4,3147753,3046308,101445,3.2
MA,1988,5,3151233,3048739,102494,3.3
MA,1988,6,3155316,3051220,104096,3.3
MA,1988,7,3158540,3053591,104949,3.3
MA,1988,8,3160108,3055750,104358,3.3
MA,1988,9,3163730,3057749,105981,3.3
MA,1988,10,3166902,3059454,107448,3.4
MA,1988,11,3169709,3060817,108892,3.4
MA,1988,12,3172771,3061692,111079,3.5
MA,1989,1,3173220,3061865,111355,3.5
MA,1989,2,3176197,3061719,114478,3.6
MA,1989,3,3179929,3061250,118679,3.7
MA,1989,4,3182458,3060513,121945,3.8
MA,1989,5,3185057,3059706,125351,3.9
MA,1989,6,3187947,3058815,129132,4.1
MA,1989,7,3191325,3057433,133892,4.2
MA,1989,8,3193247,3055639,137608,4.3
MA,1989,9,3195220,3053748,141472,4.4
MA,1989,10,3198533,3052098,146435,4.6
MA,1989,11,3202589,3051051,151538,4.7
MA,1989,12,3207572,3050388,157184,4.9
MA,1990,1,3215412,3049734,165678,5.2
MA,1990,2,3221874,3048141,173733,5.4
MA,1990,3,3226386,3045578,180808,5.6
MA,1990,4,3229512,3042060,187452,5.8
MA,1990,5,3230954,3037837,193117,6
MA,1990,6,3231870,3032511,199359,6.2
MA,1990,7,3233081,3025964,207117,6.4
MA,1990,8,3230877,3018291,212586,6.6
MA,1990,9,3227565,3009217,218348,6.8
MA,1990,10,3225446,2998605,226841,7
MA,1990,11,3223712,2986798,236914,7.3
MA,1990,12,3219737,2973986,245751,7.6
MA,1991,1,3217511,2960469,257042,8
MA,1991,2,3216206,2947950,268256,8.3
MA,1991,3,3213356,2936853,276503,8.6
MA,1991,4,3208687,2927199,281488,8.8
MA,1991,5,3203674,2919046,284628,8.9
MA,1991,6,3199427,2912265,287162,9
MA,1991,7,3197395,2906645,290750,9.1
MA,1991,8,3192354,2902251,290103,9.1
MA,1991,9,3187955,2898837,289118,9.1
MA,1991,10,3185104,2896246,288858,9.1
MA,1991,11,3182933,2894392,288541,9.1
MA,1991,12,3182002,2893367,288635,9.1
MA,1992,1,3182845,2893190,289655,9.1
MA,1992,2,3183280,2893236,290044,9.1
MA,1992,3,3184039,2893426,290613,9.1
MA,1992,4,3183744,2893934,289810,9.1
MA,1992,5,3183066,2894937,288129,9.1
MA,1992,6,3182916,2896355,286561,9
MA,1992,7,3181397,2898307,283090,8.9
MA,1992,8,3180322,2900660,279662,8.8
MA,1992,9,3179320,2903445,275875,8.7
MA,1992,10,3177082,2906496,270586,8.5
MA,1992,11,3176395,2909611,266784,8.4
MA,1992,12,3174483,2913025,261458,8.2
MA,1993,1,3171153,2916954,254199,8
MA,1993,2,3170624,2920896,249728,7.9
MA,1993,3,3170910,2924970,245940,7.8
MA,1993,4,3171601,2929482,242119,7.6
MA,1993,5,3172252,2934063,238189,7.5
MA,1993,6,3172086,2938613,233473,7.4
MA,1993,7,3171281,2943165,228116,7.2
MA,1993,8,3172487,2947556,224931,7.1
MA,1993,9,3174519,2951808,222711,7
MA,1993,10,3175230,2955934,219296,6.9
MA,1993,11,3176072,2959816,216256,6.8
MA,1993,12,3176629,2963524,213105,6.7
MA,1994,1,3179345,2967177,212168,6.7
MA,1994,2,3180410,2970859,209551,6.6
MA,1994,3,3183091,2974708,208383,6.5
MA,1994,4,3183775,2978728,205047,6.4
MA,1994,5,3185091,2982831,202260,6.4
MA,1994,6,3186308,2987044,199264,6.3
MA,1994,7,3187731,2991317,196414,6.2
MA,1994,8,3189611,2995572,194039,6.1
MA,1994,9,3191228,2999722,191506,6
MA,1994,10,3194533,3003604,190929,6
MA,1994,11,3195349,3007284,188065,5.9
MA,1994,12,3197281,3010632,186649,5.8
MA,1995,1,3198934,3013575,185359,5.8
MA,1995,2,3200040,3016260,183780,5.7
MA,1995,3,3199658,3018752,180906,5.7
MA,1995,4,3200842,3021060,179782,5.6
MA,1995,5,3201589,3023441,178148,5.6
MA,1995,6,3203437,3026202,177235,5.5
MA,1995,7,3205165,3029427,175738,5.5
MA,1995,8,3206547,3033054,173493,5.4
MA,1995,9,3208116,3036888,171228,5.3
MA,1995,10,3210287,3040778,169509,5.3
MA,1995,11,3211778,3044579,167199,5.2
MA,1995,12,3212264,3048305,163959,5.1
MA,1996,1,3213736,3052120,161616,5
MA,1996,2,3214810,3056513,158297,4.9
MA,1996,3,3216414,3061325,155089,4.8
MA,1996,4,3219111,3066560,152551,4.7
MA,1996,5,3221671,3072262,149409,4.6
MA,1996,6,3225210,3078255,146955,4.6
MA,1996,7,3228729,3084572,144157,4.5
MA,1996,8,3233327,3091301,142026,4.4
MA,1996,9,3240148,3098284,141864,4.4
MA,1996,10,3246385,3105497,140888,4.3
MA,1996,11,3253071,3112929,140142,4.3
MA,1996,12,3260015,3120362,139653,4.3
MA,1997,1,3267651,3127868,139783,4.3
MA,1997,2,3273779,3134792,138987,4.2
MA,1997,3,3279867,3141177,138690,4.2
MA,1997,4,3286630,3146980,139650,4.2
MA,1997,5,3290496,3152406,138090,4.2
MA,1997,6,3294067,3157399,136668,4.1
MA,1997,7,3297348,3162092,135256,4.1
MA,1997,8,3301046,3166876,134170,4.1
MA,1997,9,3304044,3171839,132205,4
MA,1997,10,3306468,3176841,129627,3.9
MA,1997,11,3308870,3181669,127201,3.8
MA,1997,12,3310712,3186273,124439,3.8
MA,1998,1,3310197,3190355,119842,3.6
MA,1998,2,3310673,3194191,116482,3.5
MA,1998,3,3312083,3197703,114380,3.5
MA,1998,4,3312350,3200980,111370,3.4
MA,1998,5,3316532,3204150,112382,3.4
MA,1998,6,3318305,3207330,110975,3.3
MA,1998,7,3320344,3210635,109709,3.3
MA,1998,8,3323939,3213926,110013,3.3
MA,1998,9,3329179,3217191,111988,3.4
MA,1998,10,3332398,3220484,111914,3.4
MA,1998,11,3335100,3223803,111297,3.3
MA,1998,12,3338841,3227104,111737,3.3
MA,1999,1,3341999,3230371,111628,3.3
MA,1999,2,3344153,3233623,110530,3.3
MA,1999,3,3347826,3236772,111054,3.3
MA,1999,4,3350739,3239785,110954,3.3
MA,1999,5,3354693,3242469,112224,3.3
MA,1999,6,3356606,3245077,111529,3.3
MA,1999,7,3358585,3247556,111029,3.3
MA,1999,8,3360089,3249861,110228,3.3
MA,1999,9,3361466,3252188,109278,3.3
MA,1999,10,3362947,3254625,108322,3.2
MA,1999,11,3362498,3257113,105385,3.1
MA,1999,12,3362288,3259698,102590,3.1
MA,2000,1,3359020,3259062,99958,3
MA,2000,2,3358553,3261377,97176,2.9
MA,2000,3,3356783,3263830,92953,2.8
MA,2000,4,3358343,3266408,91935,2.7
MA,2000,5,3360110,3268984,91126,2.7
MA,2000,6,3362452,3271696,90756,2.7
MA,2000,7,3364484,3274474,90010,2.7
MA,2000,8,3366582,3277204,89378,2.7
MA,2000,9,3369901,3280134,89767,2.7
MA,2000,10,3373543,3283041,90502,2.7
MA,2000,11,3377364,3285608,91756,2.7
MA,2000,12,3379735,3287549,92186,2.7
MA,2001,1,3383159,3288583,94576,2.8
MA,2001,2,3386717,3288472,98245,2.9
MA,2001,3,3390677,3287150,103527,3.1
MA,2001,4,3394187,3284903,109284,3.2
MA,2001,5,3397772,3282109,115663,3.4
MA,2001,6,3400661,3278832,121829,3.6
MA,2001,7,3403693,3275051,128642,3.8
MA,2001,8,3406376,3271247,135129,4
MA,2001,9,3408414,3267291,141123,4.1
MA,2001,10,3411679,3263441,148238,4.3
MA,2001,11,3415383,3259974,155409,4.6
MA,2001,12,3417320,3257067,160253,4.7
MA,2002,1,3419795,3254272,165523,4.8
MA,2002,2,3422150,3252377,169773,5
MA,2002,3,3424240,3250706,173534,5.1
MA,2002,4,3425697,3249007,176690,5.2
MA,2002,5,3425148,3247328,177820,5.2
MA,2002,6,3426114,3245498,180616,5.3
MA,2002,7,3426797,3243542,183255,5.3
MA,2002,8,3427011,3241389,185622,5.4
MA,2002,9,3426157,3238903,187254,5.5
MA,2002,10,3425157,3236019,189138,5.5
MA,2002,11,3423495,3232762,190733,5.6
MA,2002,12,3421192,3229110,192082,5.6
MA,2003,1,3417076,3222407,194669,5.7
MA,2003,2,3415216,3218411,196805,5.8
MA,2003,3,3414083,3215011,199072,5.8
MA,2003,4,3412499,3212299,200200,5.9
MA,2003,5,3409799,3210087,199712,5.9
MA,2003,6,3407775,3208144,199631,5.9
MA,2003,7,3406382,3206567,199815,5.9
MA,2003,8,3404858,3205291,199567,5.9
MA,2003,9,3402523,3204178,198345,5.8
MA,2003,10,3399196,3203053,196143,5.8
MA,2003,11,3396340,3202027,194313,5.7
MA,2003,12,3394769,3201267,193502,5.7
MA,2004,1,3391922,3201160,190762,5.6
MA,2004,2,3389307,3201555,187752,5.5
MA,2004,3,3386628,3202265,184363,5.4
MA,2004,4,3383988,3203012,180976,5.3
MA,2004,5,3383000,3203671,179329,5.3
MA,2004,6,3381301,3204281,177020,5.2
MA,2004,7,3379683,3204798,174885,5.2
MA,2004,8,3377890,3205035,172855,5.1
MA,2004,9,3375490,3205124,170366,5
MA,2004,10,3374258,3205089,169169,5
MA,2004,11,3372748,3204938,167810,5
MA,2004,12,3371576,3204791,166785,4.9
MA,2005,1,3371399,3204693,166706,4.9
MA,2005,2,3371440,3205141,166299,4.9
MA,2005,3,3371589,3205978,165611,4.9
MA,2005,4,3370628,3207400,163228,4.8
MA,2005,5,3371431,3209022,162409,4.8
MA,2005,6,3372902,3210858,162044,4.8
MA,2005,7,3374379,3212946,161433,4.8
MA,2005,8,3376504,3215088,161416,4.8
MA,2005,9,3380043,3217335,162708,4.8
MA,2005,10,3383231,3219740,163491,4.8
MA,2005,11,3385961,3222603,163358,4.8
MA,2005,12,3389576,3225813,163763,4.8
MA,2006,1,3392757,3229315,163442,4.8
MA,2006,2,3396155,3232758,163397,4.8
MA,2006,3,3399201,3236154,163047,4.8
MA,2006,4,3401990,3239369,162621,4.8
MA,2006,5,3405948,3242418,163530,4.8
MA,2006,6,3408652,3245390,163262,4.8
MA,2006,7,3410632,3248059,162573,4.8
MA,2006,8,3413313,3250387,162926,4.8
MA,2006,9,3415489,3252452,163037,4.8
MA,2006,10,3416462,3254355,162107,4.7
MA,2006,11,3417372,3256114,161258,4.7
MA,2006,12,3417520,3257720,159800,4.7
MA,2007,1,3417116,3259036,158080,4.6
MA,2007,2,3416914,3260127,156787,4.6
MA,2007,3,3415829,3261172,154657,4.5
MA,2007,4,3416233,3262259,153974,4.5
MA,2007,5,3416411,3263400,153011,4.5
MA,2007,6,3415773,3264269,151504,4.4
MA,2007,7,3415287,3264593,150694,4.4
MA,2007,8,3414512,3264491,150021,4.4
MA,2007,9,3414515,3264060,150455,4.4
MA,2007,10,3414609,3263515,151094,4.4
MA,2007,11,3414879,3262863,152016,4.5
MA,2007,12,3415281,3261973,153308,4.5
MA,2008,1,3416862,3260798,156064,4.6
MA,2008,2,3417581,3259498,158083,4.6
MA,2008,3,3418593,3257905,160688,4.7
MA,2008,4,3420250,3255896,164354,4.8
MA,2008,5,3422272,3253392,168880,4.9
MA,2008,6,3424069,3250265,173804,5.1
MA,2008,7,3425606,3246458,179148,5.2
MA,2008,8,3426482,3241747,184735,5.4
MA,2008,9,3426740,3235995,190745,5.6
MA,2008,10,3427549,3229186,198363,5.8
MA,2008,11,3429595,3221304,208291,6.1
MA,2008,12,3432611,3212905,219706,6.4
MA,2009,1,3426548,3174140,252408,7.4
MI,1976,1,3929308,3545748,383560,9.8
MI,1976,2,3938613,3556726,381887,9.7
MI,1976,3,3951305,3564527,386778,9.8
MI,1976,4,3962296,3579831,382465,9.7
MI,1976,5,3967355,3585550,381805,9.6
MI,1976,6,3976966,3595883,381083,9.6
MI,1976,7,3986916,3603665,383251,9.6
MI,1976,8,3985223,3625372,359851,9
MI,1976,9,3996965,3628135,368830,9.2
MI,1976,10,4000154,3632481,367673,9.2
MI,1976,11,4017455,3651337,366118,9.1
MI,1976,12,4024737,3661990,362747,9
MI,1977,1,4034915,3678385,356530,8.8
MI,1977,2,4049970,3693125,356845,8.8
MI,1977,3,4060538,3707654,352884,8.7
MI,1977,4,4059275,3721481,337794,8.3
MI,1977,5,4079252,3743312,335940,8.2
MI,1977,6,4102783,3764941,337842,8.2
MI,1977,7,4124598,3787243,337355,8.2
MI,1977,8,4142837,3795333,347504,8.4
MI,1977,9,4146308,3811738,334570,8.1
MI,1977,10,4155800,3830970,324830,7.8
MI,1977,11,4160220,3839732,320488,7.7
MI,1977,12,4164762,3853982,310780,7.5
MI,1978,1,4171519,3869395,302124,7.2
MI,1978,2,4180419,3877796,302623,7.2
MI,1978,3,4183814,3890084,293730,7
MI,1978,4,4206225,3913294,292931,7
MI,1978,5,4215768,3923393,292375,6.9
MI,1978,6,4230001,3934854,295147,7
MI,1978,7,4239882,3940689,299193,7.1
MI,1978,8,4256242,3942319,313923,7.4
MI,1978,9,4261046,3965079,295967,6.9
MI,1978,10,4268728,3976937,291791,6.8
MI,1978,11,4287114,3987011,300103,7
MI,1978,12,4302365,3998596,303769,7.1
MI,1979,1,4304372,4004186,300186,7
MI,1979,2,4312260,4009463,302797,7
MI,1979,3,4324685,4013233,311452,7.2
MI,1979,4,4333473,4003926,329547,7.6
MI,1979,5,4337531,4020307,317224,7.3
MI,1979,6,4331561,4016041,315520,7.3
MI,1979,7,4336988,4008629,328359,7.6
MI,1979,8,4363365,3994153,369212,8.5
MI,1979,9,4352705,3989239,363466,8.4
MI,1979,10,4342322,3973367,368955,8.5
MI,1979,11,4334023,3950616,383407,8.8
MI,1979,12,4346342,3937437,408905,9.4
MI,1980,1,4346021,3907053,438968,10.1
MI,1980,2,4359351,3886915,472436,10.8
MI,1980,3,4345690,3857122,488568,11.2
MI,1980,4,4351467,3831794,519673,11.9
MI,1980,5,4339913,3792584,547329,12.6
MI,1980,6,4335700,3773293,562407,13
MI,1980,7,4330818,3757624,573194,13.2
MI,1980,8,4314257,3760154,554103,12.8
MI,1980,9,4309145,3756798,552347,12.8
MI,1980,10,4289424,3754979,534445,12.5
MI,1980,11,4291598,3766253,525345,12.2
MI,1980,12,4287987,3771297,516690,12
MI,1981,1,4304894,3774429,530465,12.3
MI,1981,2,4307092,3772530,534562,12.4
MI,1981,3,4315274,3782510,532764,12.3
MI,1981,4,4298017,3784512,513505,11.9
MI,1981,5,4295068,3782914,512154,11.9
MI,1981,6,4296882,3784343,512539,11.9
MI,1981,7,4282058,3765809,516249,12.1
MI,1981,8,4283673,3754368,529305,12.4
MI,1981,9,4282437,3748881,533556,12.5
MI,1981,10,4290745,3744475,546270,12.7
MI,1981,11,4293190,3716822,576368,13.4
MI,1981,12,4297539,3683802,613737,14.3
MI,1982,1,4303493,3668912,634581,14.7
MI,1982,2,4290386,3654277,636109,14.8
MI,1982,3,4280721,3637967,642754,15
MI,1982,4,4261691,3613434,648257,15.2
MI,1982,5,4252190,3612283,639907,15
MI,1982,6,4234160,3594962,639198,15.1
MI,1982,7,4236336,3592159,644177,15.2
MI,1982,8,4237413,3583389,654024,15.4
MI,1982,9,4232440,3562964,669476,15.8
MI,1982,10,4249209,3545748,703461,16.6
MI,1982,11,4255367,3535992,719375,16.9
MI,1982,12,4260545,3543051,717494,16.8
MI,1983,1,4264390,3562004,702386,16.5
MI,1983,2,4253263,3573130,680133,16
MI,1983,3,4249324,3577747,671577,15.8
MI,1983,4,4260931,3596384,664547,15.6
MI,1983,5,4262265,3608013,654252,15.3
MI,1983,6,4252905,3622193,630712,14.8
MI,1983,7,4243546,3640992,602554,14.2
MI,1983,8,4244865,3648539,596326,14
MI,1983,9,4264092,3675808,588284,13.8
MI,1983,10,4262460,3687539,574921,13.5
MI,1983,11,4261957,3708041,553916,13
MI,1983,12,4272816,3729174,543642,12.7
MI,1984,1,4267668,3749448,518220,12.1
MI,1984,2,4282838,3774068,508770,11.9
MI,1984,3,4293431,3791806,501625,11.7
MI,1984,4,4306260,3806875,499385,11.6
MI,1984,5,4315429,3815054,500375,11.6
MI,1984,6,4319684,3827237,492447,11.4
MI,1984,7,4320741,3840164,480577,11.1
MI,1984,8,4324516,3848153,476363,11
MI,1984,9,4332229,3855823,476406,11
MI,1984,10,4339104,3860757,478347,11
MI,1984,11,4340764,3860772,479992,11.1
MI,1984,12,4340595,3869240,471355,10.9
MI,1985,1,4348237,3893121,455116,10.5
MI,1985,2,4348101,3898803,449298,10.3
MI,1985,3,4354748,3903506,451242,10.4
MI,1985,4,4355089,3904250,450839,10.4
MI,1985,5,4355640,3908666,446974,10.3
MI,1985,6,4358536,3912092,446444,10.2
MI,1985,7,4360124,3921671,438453,10.1
MI,1985,8,4370773,3932948,437825,10
MI,1985,9,4378340,3939047,439293,10
MI,1985,10,4376205,3945578,430627,9.8
MI,1985,11,4380024,3960270,419754,9.6
MI,1985,12,4371661,3973695,397966,9.1
MI,1986,1,4374695,3979885,394810,9
MI,1986,2,4375395,3981671,393724,9
MI,1986,3,4381983,3987555,394428,9
MI,1986,4,4397897,4000256,397641,9
MI,1986,5,4406150,4001869,404281,9.2
MI,1986,6,4398650,4003157,395493,9
MI,1986,7,4402977,4014485,388492,8.8
MI,1986,8,4408131,4027769,380362,8.6
MI,1986,9,4424323,4032707,391616,8.9
MI,1986,10,4446717,4054303,392414,8.8
MI,1986,11,4453430,4072588,380842,8.6
MI,1986,12,4456051,4085176,370875,8.3
MI,1987,1,4460655,4097522,363133,8.1
MI,1987,2,4473538,4106136,367402,8.2
MI,1987,3,4482699,4113144,369555,8.2
MI,1987,4,4492509,4118629,373880,8.3
MI,1987,5,4498896,4119210,379686,8.4
MI,1987,6,4505075,4122659,382416,8.5
MI,1987,7,4523548,4127909,395639,8.7
MI,1987,8,4521815,4141589,380226,8.4
MI,1987,9,4515811,4142547,373264,8.3
MI,1987,10,4520768,4151922,368846,8.2
MI,1987,11,4524354,4154752,369602,8.2
MI,1987,12,4536399,4162784,373615,8.2
MI,1988,1,4538924,4159078,379846,8.4
MI,1988,2,4540325,4167289,373036,8.2
MI,1988,3,4540914,4178408,362506,8
MI,1988,4,4545778,4190998,354780,7.8
MI,1988,5,4540017,4197631,342386,7.5
MI,1988,6,4545742,4207705,338037,7.4
MI,1988,7,4553685,4219528,334157,7.3
MI,1988,8,4563063,4217865,345198,7.6
MI,1988,9,4571321,4234993,336328,7.4
MI,1988,10,4579914,4246411,333503,7.3
MI,1988,11,4597960,4272336,325624,7.1
MI,1988,12,4598366,4268829,329537,7.2
MI,1989,1,4587622,4276801,310821,6.8
MI,1989,2,4593648,4284729,308919,6.7
MI,1989,3,4599066,4286223,312843,6.8
MI,1989,4,4606917,4294582,312335,6.8
MI,1989,5,4610216,4290853,319363,6.9
MI,1989,6,4621712,4290993,330719,7.2
MI,1989,7,4629936,4292924,337012,7.3
MI,1989,8,4639992,4301080,338912,7.3
MI,1989,9,4648656,4296319,352337,7.6
MI,1989,10,4657775,4297924,359851,7.7
MI,1989,11,4650167,4296025,354142,7.6
MI,1989,12,4649104,4298589,350515,7.5
MI,1990,1,4673425,4287107,386318,8.3
MI,1990,2,4633981,4280454,353527,7.6
MI,1990,3,4623789,4281789,342000,7.4
MI,1990,4,4618765,4276230,342535,7.4
MI,1990,5,4626438,4279110,347328,7.5
MI,1990,6,4627205,4281996,345209,7.5
MI,1990,7,4621613,4277286,344327,7.5
MI,1990,8,4624915,4273583,351332,7.6
MI,1990,9,4608294,4256025,352269,7.6
MI,1990,10,4597153,4234481,362672,7.9
MI,1990,11,4595427,4214431,380996,8.3
MI,1990,12,4588849,4206414,382435,8.3
MI,1991,1,4575215,4182827,392388,8.6
MI,1991,2,4587065,4165360,421705,9.2
MI,1991,3,4591464,4155767,435697,9.5
MI,1991,4,4588749,4147987,440762,9.6
MI,1991,5,4577048,4150256,426792,9.3
MI,1991,6,4576155,4151271,424884,9.3
MI,1991,7,4567176,4155444,411732,9
MI,1991,8,4580502,4157631,422871,9.2
MI,1991,9,4594675,4162630,432045,9.4
MI,1991,10,4603257,4167789,435468,9.5
MI,1991,11,4610144,4172744,437400,9.5
MI,1991,12,4615116,4175177,439939,9.5
MI,1992,1,4626033,4177110,448923,9.7
MI,1992,2,4638569,4189115,449454,9.7
MI,1992,3,4649789,4198054,451735,9.7
MI,1992,4,4648605,4205823,442782,9.5
MI,1992,5,4655769,4218485,437284,9.4
MI,1992,6,4665204,4230486,434718,9.3
MI,1992,7,4677690,4244632,433058,9.3
MI,1992,8,4681134,4255080,426054,9.1
MI,1992,9,4680210,4258610,421600,9
MI,1992,10,4680574,4269971,410603,8.8
MI,1992,11,4671139,4280352,390787,8.4
MI,1992,12,4665641,4289680,375961,8.1
MI,1993,1,4659798,4308844,350954,7.5
MI,1993,2,4662144,4316478,345666,7.4
MI,1993,3,4661913,4321626,340287,7.3
MI,1993,4,4680233,4334940,345293,7.4
MI,1993,5,4695655,4345101,350554,7.5
MI,1993,6,4710323,4356324,353999,7.5
MI,1993,7,4716115,4371574,344541,7.3
MI,1993,8,4721929,4374429,347500,7.4
MI,1993,9,4737680,4388063,349617,7.4
MI,1993,10,4754735,4407227,347508,7.3
MI,1993,11,4761497,4416342,345155,7.2
MI,1993,12,4777156,4433597,343559,7.2
MI,1994,1,4785219,4453082,332137,6.9
MI,1994,2,4795118,4460757,334361,7
MI,1994,3,4793313,4475284,318029,6.6
MI,1994,4,4795469,4486851,308618,6.4
MI,1994,5,4793664,4492531,301133,6.3
MI,1994,6,4795476,4502633,292843,6.1
MI,1994,7,4809181,4516422,292759,6.1
MI,1994,8,4822301,4531317,290984,6
MI,1994,9,4827250,4541757,285493,5.9
MI,1994,10,4815628,4540115,275513,5.7
MI,1994,11,4811115,4551286,259829,5.4
MI,1994,12,4809820,4554761,255059,5.3
MI,1995,1,4816256,4557654,258602,5.4
MI,1995,2,4826145,4563121,263024,5.4
MI,1995,3,4831814,4568233,263581,5.5
MI,1995,4,4835310,4567449,267861,5.5
MI,1995,5,4838517,4570835,267682,5.5
MI,1995,6,4845611,4572845,272766,5.6
MI,1995,7,4837500,4571594,265906,5.5
MI,1995,8,4838281,4579516,258765,5.3
MI,1995,9,4839437,4586598,252839,5.2
MI,1995,10,4830426,4587053,243373,5
MI,1995,11,4835365,4589488,245877,5.1
MI,1995,12,4844595,4603859,240736,5
MI,1996,1,4843297,4606863,236434,4.9
MI,1996,2,4854691,4616580,238111,4.9
MI,1996,3,4863065,4617517,245548,5
MI,1996,4,4865337,4619652,245685,5
MI,1996,5,4877408,4631421,245987,5
MI,1996,6,4886522,4642573,243949,5
MI,1996,7,4885455,4644113,241342,4.9
MI,1996,8,4899540,4658053,241487,4.9
MI,1996,9,4907254,4664998,242256,4.9
MI,1996,10,4918005,4677161,240844,4.9
MI,1996,11,4926739,4690494,236245,4.8
MI,1996,12,4930986,4695965,235021,4.8
MI,1997,1,4937190,4706777,230413,4.7
MI,1997,2,4940208,4718512,221696,4.5
MI,1997,3,4946753,4732777,213976,4.3
MI,1997,4,4954455,4732752,221703,4.5
MI,1997,5,4952423,4742345,210078,4.2
MI,1997,6,4954130,4741558,212572,4.3
MI,1997,7,4967035,4752657,214378,4.3
MI,1997,8,4967553,4758273,209280,4.2
MI,1997,9,4979973,4765904,214069,4.3
MI,1997,10,4980975,4772129,208846,4.2
MI,1997,11,4985252,4776058,209194,4.2
MI,1997,12,4990975,4784548,206427,4.1
MI,1998,1,5002481,4801483,200998,4
MI,1998,2,5004861,4804518,200343,4
MI,1998,3,4998679,4805842,192837,3.9
MI,1998,4,4995681,4811052,184629,3.7
MI,1998,5,4999103,4811561,187542,3.8
MI,1998,6,5004489,4810548,193941,3.9
MI,1998,7,4962462,4734921,227541,4.6
MI,1998,8,5007617,4810679,196938,3.9
MI,1998,9,5014642,4816218,198424,4
MI,1998,10,5026885,4828082,198803,4
MI,1998,11,5032695,4836909,195786,3.9
MI,1998,12,5045839,4842222,203617,4
MI,1999,1,5046599,4845218,201381,4
MI,1999,2,5064237,4857531,206706,4.1
MI,1999,3,5066017,4867828,198189,3.9
MI,1999,4,5074604,4879525,195079,3.8
MI,1999,5,5079843,4886756,193087,3.8
MI,1999,6,5086433,4893658,192775,3.8
MI,1999,7,5093123,4909599,183524,3.6
MI,1999,8,5094436,4912449,181987,3.6
MI,1999,9,5102912,4915896,187016,3.7
MI,1999,10,5115559,4922352,193207,3.8
MI,1999,11,5122034,4932220,189814,3.7
MI,1999,12,5127250,4942693,184557,3.6
MI,2000,1,5117764,4950113,167651,3.3
MI,2000,2,5118974,4953788,165186,3.2
MI,2000,3,5127491,4960878,166613,3.2
MI,2000,4,5141253,4966314,174939,3.4
MI,2000,5,5145589,4962692,182897,3.6
MI,2000,6,5154480,4965231,189249,3.7
MI,2000,7,5158621,4958916,199705,3.9
MI,2000,8,5155333,4950645,204688,4
MI,2000,9,5149950,4945102,204848,4
MI,2000,10,5150211,4945896,204315,4
MI,2000,11,5154268,4943054,211214,4.1
MI,2000,12,5153060,4938426,214634,4.2
MI,2001,1,5174837,4931233,243604,4.7
MI,2001,2,5174577,4931003,243574,4.7
MI,2001,3,5172213,4927290,244923,4.7
MI,2001,4,5169246,4918882,250364,4.8
MI,2001,5,5166460,4906639,259821,5
MI,2001,6,5161606,4901376,260230,5
MI,2001,7,5145635,4885032,260603,5.1
MI,2001,8,5139754,4866397,273357,5.3
MI,2001,9,5117743,4843137,274606,5.4
MI,2001,10,5107625,4819518,288107,5.6
MI,2001,11,5105317,4800919,304398,6
MI,2001,12,5091410,4784632,306778,6
MI,2002,1,5071985,4756637,315348,6.2
MI,2002,2,5052422,4748333,304089,6
MI,2002,3,5060697,4740675,320022,6.3
MI,2002,4,5048301,4729399,318902,6.3
MI,2002,5,5043717,4725612,318105,6.3
MI,2002,6,5044772,4723546,321226,6.4
MI,2002,7,5036656,4723594,313062,6.2
MI,2002,8,5026093,4718317,307776,6.1
MI,2002,9,5021590,4714432,307158,6.1
MI,2002,10,5021813,4711366,310447,6.2
MI,2002,11,5023066,4708015,315051,6.3
MI,2002,12,5025751,4700052,325699,6.5
MI,2003,1,5020548,4684943,335605,6.7
MI,2003,2,5027311,4678038,349273,6.9
MI,2003,3,5026190,4672429,353761,7
MI,2003,4,5030437,4665089,365348,7.3
MI,2003,5,5038697,4674815,363882,7.2
MI,2003,6,5044355,4676871,367484,7.3
MI,2003,7,5036598,4667272,369326,7.3
MI,2003,8,5033047,4670951,362096,7.2
MI,2003,9,5034889,4672597,362292,7.2
MI,2003,10,5045676,4682374,363302,7.2
MI,2003,11,5030987,4681299,349688,7
MI,2003,12,5030954,4680123,350831,7
MI,2004,1,5027833,4680581,347252,6.9
MI,2004,2,5031192,4675548,355644,7.1
MI,2004,3,5035563,4677314,358249,7.1
MI,2004,4,5022775,4685801,336974,6.7
MI,2004,5,5037847,4685740,352107,7
MI,2004,6,5038291,4682063,356228,7.1
MI,2004,7,5042676,4679804,362872,7.2
MI,2004,8,5042100,4687462,354638,7
MI,2004,9,5050787,4694050,356737,7.1
MI,2004,10,5056022,4699302,356720,7.1
MI,2004,11,5063185,4698080,365105,7.2
MI,2004,12,5062981,4697694,365287,7.2
MI,2005,1,5053198,4694662,358536,7.1
MI,2005,2,5060896,4702267,358629,7.1
MI,2005,3,5065142,4705679,359463,7.1
MI,2005,4,5071117,4717769,353348,7
MI,2005,5,5069363,4717181,352182,6.9
MI,2005,6,5059387,4711910,347477,6.9
MI,2005,7,5064825,4717904,346921,6.8
MI,2005,8,5064260,4720449,343811,6.8
MI,2005,9,5067604,4732624,334980,6.6
MI,2005,10,5058609,4730221,328388,6.5
MI,2005,11,5070229,4733342,336887,6.6
MI,2005,12,5074704,4733006,341698,6.7
MI,2006,1,5077368,4732780,344588,6.8
MI,2006,2,5078791,4730488,348303,6.9
MI,2006,3,5080350,4733145,347205,6.8
MI,2006,4,5076194,4734441,341753,6.7
MI,2006,5,5062463,4727726,334737,6.6
MI,2006,6,5069606,4727082,342524,6.8
MI,2006,7,5063572,4712014,351558,6.9
MI,2006,8,5066165,4710509,355656,7
MI,2006,9,5069687,4711756,357931,7.1
MI,2006,10,5059839,4702199,357640,7.1
MI,2006,11,5054595,4700189,354406,7
MI,2006,12,5059519,4701780,357739,7.1
MI,2007,1,5049540,4696129,353411,7
MI,2007,2,5044997,4695249,349748,6.9
MI,2007,3,5041503,4692339,349164,6.9
MI,2007,4,5036410,4683124,353286,7
MI,2007,5,5034735,4683240,351495,7
MI,2007,6,5029575,4673883,355692,7.1
MI,2007,7,5024569,4671996,352573,7
MI,2007,8,5022526,4662876,359650,7.2
MI,2007,9,5013200,4650465,362735,7.2
MI,2007,10,5005804,4635017,370787,7.4
MI,2007,11,4995374,4630537,364837,7.3
MI,2007,12,4988684,4624946,363738,7.3
MI,2008,1,4981626,4618647,362979,7.3
MI,2008,2,4972864,4603515,369349,7.4
MI,2008,3,4960868,4584224,376644,7.6
MI,2008,4,4954978,4562400,392578,7.9
MI,2008,5,4954537,4546622,407915,8.2
MI,2008,6,4940602,4538091,402511,8.1
MI,2008,7,4927360,4519946,407414,8.3
MI,2008,8,4923796,4500405,423391,8.6
MI,2008,9,4913854,4478811,435043,8.9
MI,2008,10,4911650,4463132,448518,9.1
MI,2008,11,4900202,4429455,470747,9.6
MI,2008,12,4884676,4388469,496207,10.2
MI,2009,1,4864387,4299405,564982,11.6
MN,1976,1,1848378,1733834,114544,6.2
MN,1976,2,1840520,1732859,107661,5.8
MN,1976,3,1844156,1734192,109964,6
MN,1976,4,1850416,1744851,105565,5.7
MN,1976,5,1849697,1747893,101804,5.5
MN,1976,6,1848530,1743917,104613,5.7
MN,1976,7,1856964,1748939,108025,5.8
MN,1976,8,1861357,1752358,108999,5.9
MN,1976,9,1867546,1756014,111532,6
MN,1976,10,1872745,1761082,111663,6
MN,1976,11,1875258,1762695,112563,6
MN,1976,12,1880970,1768283,112687,6
MN,1977,1,1888675,1775108,113567,6
MN,1977,2,1898502,1784345,114157,6
MN,1977,3,1904155,1792951,111204,5.8
MN,1977,4,1913832,1804960,108872,5.7
MN,1977,5,1922294,1815750,106544,5.5
MN,1977,6,1930025,1827447,102578,5.3
MN,1977,7,1939295,1835448,103847,5.4
MN,1977,8,1935464,1834128,101336,5.2
MN,1977,9,1925171,1827870,97301,5.1
MN,1977,10,1926873,1831627,95246,4.9
MN,1977,11,1929402,1840071,89331,4.6
MN,1977,12,1940126,1849982,90144,4.6
MN,1978,1,1949297,1867416,81881,4.2
MN,1978,2,1951516,1871858,79658,4.1
MN,1978,3,1953343,1878790,74553,3.8
MN,1978,4,1956820,1882003,74817,3.8
MN,1978,5,1967082,1885685,81397,4.1
MN,1978,6,1974495,1895454,79041,4
MN,1978,7,1986593,1906301,80292,4
MN,1978,8,1994068,1914164,79904,4
MN,1978,9,1998098,1920148,77950,3.9
MN,1978,10,1997672,1919979,77693,3.9
MN,1978,11,1999514,1924451,75063,3.8
MN,1978,12,2004197,1925847,78350,3.9
MN,1979,1,2009783,1927891,81892,4.1
MN,1979,2,2010131,1932313,77818,3.9
MN,1979,3,2012537,1936169,76368,3.8
MN,1979,4,2022242,1935506,86736,4.3
MN,1979,5,2033109,1944957,88152,4.3
MN,1979,6,2044723,1961553,83170,4.1
MN,1979,7,2049232,1963805,85427,4.2
MN,1979,8,2055049,1967553,87496,4.3
MN,1979,9,2055979,1964886,91093,4.4
MN,1979,10,2068192,1974249,93943,4.5
MN,1979,11,2075464,1979554,95910,4.6
MN,1979,12,2082652,1980288,102364,4.9
MN,1980,1,2082905,1974187,108718,5.2
MN,1980,2,2092537,1977489,115048,5.5
MN,1980,3,2101158,1979336,121822,5.8
MN,1980,4,2099517,1974088,125429,6
MN,1980,5,2094652,1970620,124032,5.9
MN,1980,6,2095484,1962252,133232,6.4
MN,1980,7,2093346,1959948,133398,6.4
MN,1980,8,2094007,1964097,129910,6.2
MN,1980,9,2106234,1975047,131187,6.2
MN,1980,10,2108686,1983464,125222,5.9
MN,1980,11,2115683,1994167,121516,5.7
MN,1980,12,2122331,2000416,121915,5.7
MN,1981,1,2120665,2002591,118074,5.6
MN,1981,2,2121972,2001524,120448,5.7
MN,1981,3,2128340,2008504,119836,5.6
MN,1981,4,2123887,2011184,112703,5.3
MN,1981,5,2124992,2005781,119211,5.6
MN,1981,6,2128882,2004282,124600,5.9
MN,1981,7,2126035,2009067,116968,5.5
MN,1981,8,2136625,2018109,118516,5.5
MN,1981,9,2142502,2021717,120785,5.6
MN,1981,10,2140904,2013184,127720,6
MN,1981,11,2143924,2010762,133162,6.2
MN,1981,12,2154353,2016845,137508,6.4
MN,1982,1,2148015,2005468,142547,6.6
MN,1982,2,2155447,2008320,147127,6.8
MN,1982,3,2162655,2005945,156710,7.2
MN,1982,4,2161715,1996530,165185,7.6
MN,1982,5,2167309,1997635,169674,7.8
MN,1982,6,2168461,1993959,174502,8
MN,1982,7,2169916,1984307,185609,8.6
MN,1982,8,2177464,1984912,192552,8.8
MN,1982,9,2171958,1983789,188169,8.7
MN,1982,10,2171429,1979557,191872,8.8
MN,1982,11,2171013,1975170,195843,9
MN,1982,12,2169525,1979251,190274,8.8
MN,1983,1,2178498,1987531,190967,8.8
MN,1983,2,2178456,1986089,192367,8.8
MN,1983,3,2176872,1986022,190850,8.8
MN,1983,4,2176851,1991755,185096,8.5
MN,1983,5,2177136,1996792,180344,8.3
MN,1983,6,2175030,2000963,174067,8
MN,1983,7,2181531,2015149,166382,7.6
MN,1983,8,2177649,2011478,166171,7.6
MN,1983,9,2192291,2028287,164004,7.5
MN,1983,10,2198952,2036953,161999,7.4
MN,1983,11,2194192,2035929,158263,7.2
MN,1983,12,2194595,2037850,156745,7.1
MN,1984,1,2206681,2055291,151390,6.9
MN,1984,2,2206797,2062740,144057,6.5
MN,1984,3,2209072,2067276,141796,6.4
MN,1984,4,2225795,2082098,143697,6.5
MN,1984,5,2224003,2081940,142063,6.4
MN,1984,6,2226079,2085603,140476,6.3
MN,1984,7,2220233,2084673,135560,6.1
MN,1984,8,2226404,2092520,133884,6
MN,1984,9,2226789,2093235,133554,6
MN,1984,10,2231173,2098909,132264,5.9
MN,1984,11,2239943,2108013,131930,5.9
MN,1984,12,2236710,2099623,137087,6.1
MN,1985,1,2230567,2093304,137263,6.2
MN,1985,2,2229372,2095917,133455,6
MN,1985,3,2229463,2098290,131173,5.9
MN,1985,4,2228006,2095837,132169,5.9
MN,1985,5,2231657,2104343,127314,5.7
MN,1985,6,2234076,2105518,128558,5.8
MN,1985,7,2245591,2107866,137725,6.1
MN,1985,8,2250390,2118450,131940,5.9
MN,1985,9,2255018,2118764,136254,6
MN,1985,10,2252789,2116360,136429,6.1
MN,1985,11,2249510,2113197,136313,6.1
MN,1985,12,2254393,2112754,141639,6.3
MN,1986,1,2248800,2114140,134660,6
MN,1986,2,2251706,2117357,134349,6
MN,1986,3,2252521,2119183,133338,5.9
MN,1986,4,2253199,2123245,129954,5.8
MN,1986,5,2255627,2131561,124066,5.5
MN,1986,6,2258692,2135273,123419,5.5
MN,1986,7,2266497,2143691,122806,5.4
MN,1986,8,2265158,2145705,119453,5.3
MN,1986,9,2271204,2149980,121224,5.3
MN,1986,10,2268777,2147202,121575,5.4
MN,1986,11,2265714,2142490,123224,5.4
MN,1986,12,2266965,2143856,123109,5.4
MN,1987,1,2281232,2160032,121200,5.3
MN,1987,2,2289395,2166958,122437,5.3
MN,1987,3,2293617,2170815,122802,5.4
MN,1987,4,2289503,2174818,114685,5
MN,1987,5,2293020,2172603,120417,5.3
MN,1987,6,2295714,2173691,122023,5.3
MN,1987,7,2296852,2178796,118056,5.1
MN,1987,8,2301299,2182457,118842,5.2
MN,1987,9,2300868,2183397,117471,5.1
MN,1987,10,2310314,2195916,114398,5
MN,1987,11,2314530,2201363,113167,4.9
MN,1987,12,2319410,2209759,109651,4.7
MN,1988,1,2310465,2203986,106479,4.6
MN,1988,2,2314108,2207234,106874,4.6
MN,1988,3,2317160,2215586,101574,4.4
MN,1988,4,2314662,2218865,95797,4.1
MN,1988,5,2320405,2221093,99312,4.3
MN,1988,6,2326247,2227870,98377,4.2
MN,1988,7,2332099,2233662,98437,4.2
MN,1988,8,2331921,2230474,101447,4.4
MN,1988,9,2334907,2234807,100100,4.3
MN,1988,10,2339036,2238113,100923,4.3
MN,1988,11,2345410,2249125,96285,4.1
MN,1988,12,2350477,2254340,96137,4.1
MN,1989,1,2357118,2257820,99298,4.2
MN,1989,2,2360171,2261664,98507,4.2
MN,1989,3,2362153,2265043,97110,4.1
MN,1989,4,2370021,2265984,104037,4.4
MN,1989,5,2377052,2271873,105179,4.4
MN,1989,6,2383303,2280812,102491,4.3
MN,1989,7,2375652,2272231,103421,4.4
MN,1989,8,2374595,2269679,104916,4.4
MN,1989,9,2373340,2270483,102857,4.3
MN,1989,10,2374698,2271661,103037,4.3
MN,1989,11,2375278,2270603,104675,4.4
MN,1989,12,2378707,2267389,111318,4.7
MN,1990,1,2383507,2273013,110494,4.6
MN,1990,2,2386038,2275978,110060,4.6
MN,1990,3,2383112,2271396,111716,4.7
MN,1990,4,2379726,2266415,113311,4.8
MN,1990,5,2380383,2266487,113896,4.8
MN,1990,6,2380843,2267847,112996,4.7
MN,1990,7,2387699,2272626,115073,4.8
MN,1990,8,2390964,2277341,113623,4.8
MN,1990,9,2395215,2279921,115294,4.8
MN,1990,10,2397122,2280101,117021,4.9
MN,1990,11,2406499,2289650,116849,4.9
MN,1990,12,2409009,2289457,119552,5
MN,1991,1,2412559,2290864,121695,5
MN,1991,2,2415734,2287664,128070,5.3
MN,1991,3,2420908,2290133,130775,5.4
MN,1991,4,2420701,2289156,131545,5.4
MN,1991,5,2421717,2296034,125683,5.2
MN,1991,6,2424536,2300790,123746,5.1
MN,1991,7,2425974,2302416,123558,5.1
MN,1991,8,2432019,2309500,122519,5
MN,1991,9,2433657,2310018,123639,5.1
MN,1991,10,2437385,2312662,124723,5.1
MN,1991,11,2439189,2306930,132259,5.4
MN,1991,12,2440179,2313205,126974,5.2
MN,1992,1,2448388,2321503,126885,5.2
MN,1992,2,2450623,2323492,127131,5.2
MN,1992,3,2454895,2327089,127806,5.2
MN,1992,4,2457617,2336203,121414,4.9
MN,1992,5,2464335,2338274,126061,5.1
MN,1992,6,2460258,2334198,126060,5.1
MN,1992,7,2466687,2340185,126502,5.1
MN,1992,8,2471421,2341142,130279,5.3
MN,1992,9,2476147,2350176,125971,5.1
MN,1992,10,2482508,2357449,125059,5
MN,1992,11,2487118,2359410,127708,5.1
MN,1992,12,2486624,2363004,123620,5
MN,1993,1,2490629,2368579,122050,4.9
MN,1993,2,2495131,2372313,122818,4.9
MN,1993,3,2502251,2376983,125268,5
MN,1993,4,2511090,2381930,129160,5.1
MN,1993,5,2510352,2379755,130597,5.2
MN,1993,6,2505336,2377960,127376,5.1
MN,1993,7,2508901,2384950,123951,4.9
MN,1993,8,2511746,2386813,124933,5
MN,1993,9,2515212,2392437,122775,4.9
MN,1993,10,2537188,2414429,122759,4.8
MN,1993,11,2542749,2422901,119848,4.7
MN,1993,12,2550306,2433613,116693,4.6
MN,1994,1,2551403,2434746,116657,4.6
MN,1994,2,2557618,2442696,114922,4.5
MN,1994,3,2560335,2450041,110294,4.3
MN,1994,4,2569057,2462964,106093,4.1
MN,1994,5,2573110,2467562,105548,4.1
MN,1994,6,2577302,2473036,104266,4
MN,1994,7,2572083,2469745,102338,4
MN,1994,8,2579593,2475729,103864,4
MN,1994,9,2592527,2489998,102529,4
MN,1994,10,2588779,2486553,102226,3.9
MN,1994,11,2593777,2499046,94731,3.7
MN,1994,12,2602304,2506078,96226,3.7
MN,1995,1,2611678,2516655,95023,3.6
MN,1995,2,2620889,2523805,97084,3.7
MN,1995,3,2617791,2525398,92393,3.5
MN,1995,4,2617337,2519654,97683,3.7
MN,1995,5,2617728,2519062,98666,3.8
MN,1995,6,2623018,2526424,96594,3.7
MN,1995,7,2622638,2526938,95700,3.6
MN,1995,8,2626741,2531359,95382,3.6
MN,1995,9,2627618,2531198,96420,3.7
MN,1995,10,2639236,2538895,100341,3.8
MN,1995,11,2646710,2544418,102292,3.9
MN,1995,12,2652555,2549764,102791,3.9
MN,1996,1,2657105,2556473,100632,3.8
MN,1996,2,2658705,2556762,101943,3.8
MN,1996,3,2662967,2559180,103787,3.9
MN,1996,4,2666518,2556235,110283,4.1
MN,1996,5,2665526,2559843,105683,4
MN,1996,6,2669150,2561743,107407,4
MN,1996,7,2670708,2563920,106788,4
MN,1996,8,2676566,2569558,107008,4
MN,1996,9,2676306,2571446,104860,3.9
MN,1996,10,2677154,2572614,104540,3.9
MN,1996,11,2682483,2581225,101258,3.8
MN,1996,12,2678894,2580690,98204,3.7
MN,1997,1,2672430,2578211,94219,3.5
MN,1997,2,2674838,2585159,89679,3.4
MN,1997,3,2675638,2585733,89905,3.4
MN,1997,4,2680584,2582605,97979,3.7
MN,1997,5,2684051,2593722,90329,3.4
MN,1997,6,2688011,2599213,88798,3.3
MN,1997,7,2699500,2612078,87422,3.2
MN,1997,8,2702330,2614397,87933,3.3
MN,1997,9,2714144,2626376,87768,3.2
MN,1997,10,2713232,2626965,86267,3.2
MN,1997,11,2712071,2628643,83428,3.1
MN,1997,12,2715346,2634970,80376,3
MN,1998,1,2715531,2639632,75899,2.8
MN,1998,2,2716352,2641791,74561,2.7
MN,1998,3,2722611,2645090,77521,2.8
MN,1998,4,2729758,2659427,70331,2.6
MN,1998,5,2739345,2665836,73509,2.7
MN,1998,6,2738095,2664865,73230,2.7
MN,1998,7,2724721,2653586,71135,2.6
MN,1998,8,2731281,2658643,72638,2.7
MN,1998,9,2735447,2649326,86121,3.1
MN,1998,10,2736101,2659597,76504,2.8
MN,1998,11,2744969,2666933,78036,2.8
MN,1998,12,2746371,2675358,71013,2.6
MN,1999,1,2749732,2676436,73296,2.7
MN,1999,2,2746682,2675947,70735,2.6
MN,1999,3,2750759,2679856,70903,2.6
MN,1999,4,2750456,2682391,68065,2.5
MN,1999,5,2753490,2675325,78165,2.8
MN,1999,6,2755472,2677494,77978,2.8
MN,1999,7,2774613,2694469,80144,2.9
MN,1999,8,2771955,2691006,80949,2.9
MN,1999,9,2768987,2687274,81713,3
MN,1999,10,2779121,2697718,81403,2.9
MN,1999,11,2780736,2699884,80852,2.9
MN,1999,12,2783898,2705502,78396,2.8
MN,2000,1,2771970,2692652,79318,2.9
MN,2000,2,2780146,2700418,79728,2.9
MN,2000,3,2787757,2709510,78247,2.8
MN,2000,4,2789581,2712544,77037,2.8
MN,2000,5,2797022,2711749,85273,3
MN,2000,6,2803829,2718190,85639,3.1
MN,2000,7,2807205,2719250,87955,3.1
MN,2000,8,2820294,2727872,92422,3.3
MN,2000,9,2828405,2734750,93655,3.3
MN,2000,10,2826423,2733514,92909,3.3
MN,2000,11,2840223,2739699,100524,3.5
MN,2000,12,2839166,2745760,93406,3.3
MN,2001,1,2843650,2752203,91447,3.2
MN,2001,2,2855421,2759541,95880,3.4
MN,2001,3,2859736,2760786,98950,3.5
MN,2001,4,2859813,2751422,108391,3.8
MN,2001,5,2863516,2754947,108569,3.8
MN,2001,6,2870168,2758348,111820,3.9
MN,2001,7,2867499,2754207,113292,4
MN,2001,8,2867338,2755143,112195,3.9
MN,2001,9,2869728,2758427,111301,3.9
MN,2001,10,2877324,2757515,119809,4.2
MN,2001,11,2878994,2754857,124137,4.3
MN,2001,12,2879087,2752293,126794,4.4
MN,2002,1,2873631,2742039,131592,4.6
MN,2002,2,2875107,2738815,136292,4.7
MN,2002,3,2871287,2735270,136017,4.7
MN,2002,4,2875214,2734032,141182,4.9
MN,2002,5,2871626,2739621,132005,4.6
MN,2002,6,2878765,2748008,130757,4.5
MN,2002,7,2887985,2757227,130758,4.5
MN,2002,8,2884748,2757427,127321,4.4
MN,2002,9,2889654,2764438,125216,4.3
MN,2002,10,2883035,2757630,125405,4.3
MN,2002,11,2889085,2761496,127589,4.4
MN,2002,12,2883816,2758293,125523,4.4
MN,2003,1,2882192,2746064,136128,4.7
MN,2003,2,2885948,2747747,138201,4.8
MN,2003,3,2885291,2744476,140815,4.9
MN,2003,4,2893258,2749319,143939,5
MN,2003,5,2890427,2752959,137468,4.8
MN,2003,6,2893212,2750351,142861,4.9
MN,2003,7,2895644,2750281,145363,5
MN,2003,8,2898389,2758995,139394,4.8
MN,2003,9,2897819,2757885,139934,4.8
MN,2003,10,2894859,2754832,140027,4.8
MN,2003,11,2889811,2748501,141310,4.9
MN,2003,12,2893084,2749851,143233,5
MN,2004,1,2885583,2741251,144332,5
MN,2004,2,2887842,2742315,145527,5
MN,2004,3,2892426,2747077,145349,5
MN,2004,4,2879409,2749776,129633,4.5
MN,2004,5,2883299,2750585,132714,4.6
MN,2004,6,2884985,2750539,134446,4.7
MN,2004,7,2883429,2750799,132630,4.6
MN,2004,8,2883534,2749472,134062,4.6
MN,2004,9,2884272,2755437,128835,4.5
MN,2004,10,2892167,2764553,127614,4.4
MN,2004,11,2887011,2763446,123565,4.3
MN,2004,12,2887734,2763588,124146,4.3
MN,2005,1,2868822,2740085,128737,4.5
MN,2005,2,2863605,2738038,125567,4.4
MN,2005,3,2867698,2741451,126247,4.4
MN,2005,4,2890034,2769489,120545,4.2
MN,2005,5,2891000,2770466,120534,4.2
MN,2005,6,2876890,2761081,115809,4
MN,2005,7,2878891,2765919,112972,3.9
MN,2005,8,2880932,2764311,116621,4
MN,2005,9,2882781,2764559,118222,4.1
MN,2005,10,2882625,2764651,117974,4.1
MN,2005,11,2881248,2765281,115967,4
MN,2005,12,2891960,2768529,123431,4.3
MN,2006,1,2902370,2779111,123259,4.2
MN,2006,2,2898362,2776883,121479,4.2
MN,2006,3,2900613,2781275,119338,4.1
MN,2006,4,2885578,2770516,115062,4
MN,2006,5,2880841,2767452,113389,3.9
MN,2006,6,2891889,2780956,110933,3.8
MN,2006,7,2887179,2775331,111848,3.9
MN,2006,8,2887016,2773551,113465,3.9
MN,2006,9,2891048,2772287,118761,4.1
MN,2006,10,2887966,2767542,120424,4.2
MN,2006,11,2897045,2774088,122957,4.2
MN,2006,12,2907435,2780295,127140,4.4
MN,2007,1,2913623,2782197,131426,4.5
MN,2007,2,2915095,2780923,134172,4.6
MN,2007,3,2910311,2777081,133230,4.6
MN,2007,4,2911620,2773828,137792,4.7
MN,2007,5,2912373,2778065,134308,4.6
MN,2007,6,2914877,2782320,132557,4.5
MN,2007,7,2914145,2781793,132352,4.5
MN,2007,8,2909202,2775864,133338,4.6
MN,2007,9,2905698,2768861,136837,4.7
MN,2007,10,2903555,2768008,135547,4.7
MN,2007,11,2907529,2773868,133661,4.6
MN,2007,12,2911707,2772672,139035,4.8
MN,2008,1,2913119,2773056,140063,4.8
MN,2008,2,2920482,2775338,145144,5
MN,2008,3,2920559,2772902,147657,5.1
MN,2008,4,2926399,2768237,158162,5.4
MN,2008,5,2924896,2771160,153736,5.3
MN,2008,6,2926168,2771566,154602,5.3
MN,2008,7,2933841,2775902,157939,5.4
MN,2008,8,2941114,2782316,158798,5.4
MN,2008,9,2942133,2782001,160132,5.4
MN,2008,10,2948600,2782605,165995,5.6
MN,2008,11,2947270,2766228,181042,6.1
MN,2008,12,2950942,2756317,194625,6.6
MN,2009,1,2941313,2719124,222189,7.6
MS,1976,1,965285,897851,67434,7
MS,1976,2,963349,898265,65084,6.8
MS,1976,3,962394,899775,62619,6.5
MS,1976,4,961209,901752,59457,6.2
MS,1976,5,964212,903256,60956,6.3
MS,1976,6,966418,903152,63266,6.5
MS,1976,7,968485,905265,63220,6.5
MS,1976,8,969608,906414,63194,6.5
MS,1976,9,971966,907161,64805,6.7
MS,1976,10,976005,909259,66746,6.8
MS,1976,11,980534,909481,71053,7.2
MS,1976,12,981403,910875,70528,7.2
MS,1977,1,980054,913404,66650,6.8
MS,1977,2,986372,914213,72159,7.3
MS,1977,3,987475,915428,72047,7.3
MS,1977,4,991663,918227,73436,7.4
MS,1977,5,995896,919670,76226,7.7
MS,1977,6,1000226,922613,77613,7.8
MS,1977,7,1001448,925520,75928,7.6
MS,1977,8,1005034,927427,77607,7.7
MS,1977,9,1006539,928168,78371,7.8
MS,1977,10,1007841,929808,78033,7.7
MS,1977,11,1009391,931480,77911,7.7
MS,1977,12,1009538,932920,76618,7.6
MS,1978,1,1006153,931724,74429,7.4
MS,1978,2,1005449,933682,71767,7.1
MS,1978,3,1008347,935363,72984,7.2
MS,1978,4,1012652,936502,76150,7.5
MS,1978,5,1012802,937700,75102,7.4
MS,1978,6,1015471,942610,72861,7.2
MS,1978,7,1018684,943783,74901,7.4
MS,1978,8,1020175,947478,72697,7.1
MS,1978,9,1017196,948399,68797,6.8
MS,1978,10,1017210,950268,66942,6.6
MS,1978,11,1015619,951424,64195,6.3
MS,1978,12,1018587,952955,65632,6.4
MS,1979,1,1016762,954778,61984,6.1
MS,1979,2,1015117,957121,57996,5.7
MS,1979,3,1017016,958711,58305,5.7
MS,1979,4,1015265,959923,55342,5.5
MS,1979,5,1013817,962871,50946,5
MS,1979,6,1020414,965771,54643,5.4
MS,1979,7,1019838,965795,54043,5.3
MS,1979,8,1018040,964952,53088,5.2
MS,1979,9,1026017,965089,60928,5.9
MS,1979,10,1030944,967732,63212,6.1
MS,1979,11,1032306,967510,64796,6.3
MS,1979,12,1034070,969962,64108,6.2
MS,1980,1,1039563,971288,68275,6.6
MS,1980,2,1043023,973227,69796,6.7
MS,1980,3,1046000,973862,72138,6.9
MS,1980,4,1048144,973708,74436,7.1
MS,1980,5,1052006,972338,79668,7.6
MS,1980,6,1052916,970508,82408,7.8
MS,1980,7,1053395,969448,83947,8
MS,1980,8,1053811,968930,84881,8.1
MS,1980,9,1053931,968618,85313,8.1
MS,1980,10,1056417,967961,88456,8.4
MS,1980,11,1057670,968405,89265,8.4
MS,1980,12,1057282,966367,90915,8.6
MS,1981,1,1056216,968203,88013,8.3
MS,1981,2,1054017,966276,87741,8.3
MS,1981,3,1054343,964494,89849,8.5
MS,1981,4,1051554,963495,88059,8.4
MS,1981,5,1052059,964525,87534,8.3
MS,1981,6,1050356,962950,87406,8.3
MS,1981,7,1051883,963203,88680,8.4
MS,1981,8,1054920,961930,92990,8.8
MS,1981,9,1056805,962502,94303,8.9
MS,1981,10,1057396,962992,94404,8.9
MS,1981,11,1059866,961252,98614,9.3
MS,1981,12,1060882,960858,100024,9.4
MS,1982,1,1062073,957870,104203,9.8
MS,1982,2,1068934,957111,111823,10.5
MS,1982,3,1070842,956502,114340,10.7
MS,1982,4,1074518,954077,120441,11.2
MS,1982,5,1075325,951691,123634,11.5
MS,1982,6,1072043,947842,124201,11.6
MS,1982,7,1072982,947738,125244,11.7
MS,1982,8,1076242,946103,130139,12.1
MS,1982,9,1076413,944865,131548,12.2
MS,1982,10,1075983,944588,131395,12.2
MS,1982,11,1074172,944559,129613,12.1
MS,1982,12,1077476,943916,133560,12.4
MS,1983,1,1085089,943125,141964,13.1
MS,1983,2,1090837,942809,148028,13.6
MS,1983,3,1090932,943680,147252,13.5
MS,1983,4,1093238,943393,149845,13.7
MS,1983,5,1093016,943621,149395,13.7
MS,1983,6,1092506,945887,146619,13.4
MS,1983,7,1088612,949165,139447,12.8
MS,1983,8,1080599,948665,131934,12.2
MS,1983,9,1079790,951361,128429,11.9
MS,1983,10,1075313,951613,123700,11.5
MS,1983,11,1072024,953205,118819,11.1
MS,1983,12,1071573,954504,117069,10.9
MS,1984,1,1075835,959175,116660,10.8
MS,1984,2,1077318,962558,114760,10.7
MS,1984,3,1080050,964964,115086,10.7
MS,1984,4,1081486,967127,114359,10.6
MS,1984,5,1085748,970854,114894,10.6
MS,1984,6,1091285,973680,117605,10.8
MS,1984,7,1095109,974803,120306,11
MS,1984,8,1101039,977994,123045,11.2
MS,1984,9,1102293,980749,121544,11
MS,1984,10,1102775,983820,118955,10.8
MS,1984,11,1105945,986396,119549,10.8
MS,1984,12,1106639,989316,117323,10.6
MS,1985,1,1105710,990540,115170,10.4
MS,1985,2,1111837,992547,119290,10.7
MS,1985,3,1117234,995252,121982,10.9
MS,1985,4,1120043,999436,120607,10.8
MS,1985,5,1117464,1001533,115931,10.4
MS,1985,6,1120327,1002827,117500,10.5
MS,1985,7,1127415,1005236,122179,10.8
MS,1985,8,1130690,1007999,122691,10.9
MS,1985,9,1134380,1009556,124824,11
MS,1985,10,1133361,1010360,123001,10.9
MS,1985,11,1137222,1013204,124018,10.9
MS,1985,12,1142866,1014798,128068,11.2
MS,1986,1,1147454,1017742,129712,11.3
MS,1986,2,1150661,1017229,133432,11.6
MS,1986,3,1154614,1016066,138548,12
MS,1986,4,1158240,1015457,142783,12.3
MS,1986,5,1160526,1016297,144229,12.4
MS,1986,6,1162573,1017631,144942,12.5
MS,1986,7,1164571,1018427,146144,12.5
MS,1986,8,1164397,1018861,145536,12.5
MS,1986,9,1163953,1021554,142399,12.2
MS,1986,10,1162410,1022234,140176,12.1
MS,1986,11,1161476,1022705,138771,11.9
MS,1986,12,1160503,1023548,136955,11.8
MS,1987,1,1159958,1025951,134007,11.6
MS,1987,2,1157191,1027435,129756,11.2
MS,1987,3,1156093,1029058,127035,11
MS,1987,4,1152141,1030309,121832,10.6
MS,1987,5,1153299,1032327,120972,10.5
MS,1987,6,1153717,1032962,120755,10.5
MS,1987,7,1155324,1033910,121414,10.5
MS,1987,8,1157897,1036120,121777,10.5
MS,1987,9,1156035,1038972,117063,10.1
MS,1987,10,1155063,1040668,114395,9.9
MS,1987,11,1152765,1041964,110801,9.6
MS,1987,12,1151470,1044783,106687,9.3
MS,1988,1,1148000,1044249,103751,9
MS,1988,2,1145617,1045471,100146,8.7
MS,1988,3,1141960,1046713,95247,8.3
MS,1988,4,1140152,1047457,92695,8.1
MS,1988,5,1140690,1046297,94393,8.3
MS,1988,6,1142685,1046667,96018,8.4
MS,1988,7,1145223,1046843,98380,8.6
MS,1988,8,1146487,1047835,98652,8.6
MS,1988,9,1152025,1048264,103761,9
MS,1988,10,1157560,1050687,106873,9.2
MS,1988,11,1161389,1053963,107426,9.2
MS,1988,12,1159051,1054546,104505,9
MS,1989,1,1159751,1056268,103483,8.9
MS,1989,2,1160020,1059422,100598,8.7
MS,1989,3,1160067,1061060,99007,8.5
MS,1989,4,1162447,1063964,98483,8.5
MS,1989,5,1162218,1066550,95668,8.2
MS,1989,6,1161627,1070804,90823,7.8
MS,1989,7,1158536,1072040,86496,7.5
MS,1989,8,1158778,1073576,85202,7.4
MS,1989,9,1163973,1074711,89262,7.7
MS,1989,10,1166005,1076461,89544,7.7
MS,1989,11,1168980,1077588,91392,7.8
MS,1989,12,1171781,1080707,91074,7.8
MS,1990,1,1175912,1081538,94374,8
MS,1990,2,1174883,1082275,92608,7.9
MS,1990,3,1172710,1084116,88594,7.6
MS,1990,4,1173802,1085438,88364,7.5
MS,1990,5,1168669,1086594,82075,7
MS,1990,6,1169210,1085287,83923,7.2
MS,1990,7,1172240,1085174,87066,7.4
MS,1990,8,1172479,1085825,86654,7.4
MS,1990,9,1172750,1086644,86106,7.3
MS,1990,10,1178765,1087540,91225,7.7
MS,1990,11,1186336,1086922,99414,8.4
MS,1990,12,1191181,1087679,103502,8.7
MS,1991,1,1193711,1086346,107365,9
MS,1991,2,1198989,1085957,113032,9.4
MS,1991,3,1199177,1084568,114609,9.6
MS,1991,4,1198319,1084895,113424,9.5
MS,1991,5,1198714,1083280,115434,9.6
MS,1991,6,1196324,1083969,112355,9.4
MS,1991,7,1192386,1083979,108407,9.1
MS,1991,8,1186685,1083777,102908,8.7
MS,1991,9,1183325,1084758,98567,8.3
MS,1991,10,1179375,1085067,94308,8
MS,1991,11,1179570,1085530,94040,8
MS,1991,12,1182115,1084209,97906,8.3
MS,1992,1,1186555,1086232,100323,8.5
MS,1992,2,1189046,1088370,100676,8.5
MS,1992,3,1190282,1089932,100350,8.4
MS,1992,4,1192139,1091047,101092,8.5
MS,1992,5,1197016,1092927,104089,8.7
MS,1992,6,1202332,1095969,106363,8.8
MS,1992,7,1203126,1099152,103974,8.6
MS,1992,8,1206343,1101360,104983,8.7
MS,1992,9,1203750,1102739,101011,8.4
MS,1992,10,1202998,1105929,97069,8.1
MS,1992,11,1199490,1108563,90927,7.6
MS,1992,12,1198516,1109839,88677,7.4
MS,1993,1,1197774,1112409,85365,7.1
MS,1993,2,1202594,1115539,87055,7.2
MS,1993,3,1206266,1117702,88564,7.3
MS,1993,4,1209553,1120116,89437,7.4
MS,1993,5,1211410,1123449,87961,7.3
MS,1993,6,1210414,1125574,84840,7
MS,1993,7,1206865,1126920,79945,6.6
MS,1993,8,1212119,1129716,82403,6.8
MS,1993,9,1215355,1132669,82686,6.8
MS,1993,10,1217944,1136872,81072,6.7
MS,1993,11,1218915,1139493,79422,6.5
MS,1993,12,1224972,1142386,82586,6.7
MS,1994,1,1230011,1144807,85204,6.9
MS,1994,2,1233599,1146553,87046,7.1
MS,1994,3,1236103,1150015,86088,7
MS,1994,4,1239535,1153020,86515,7
MS,1994,5,1242360,1156881,85479,6.9
MS,1994,6,1245115,1161730,83385,6.7
MS,1994,7,1246834,1164945,81889,6.6
MS,1994,8,1246258,1167267,78991,6.3
MS,1994,9,1242540,1168349,74191,6
MS,1994,10,1246712,1167502,79210,6.4
MS,1994,11,1250898,1168101,82797,6.6
MS,1994,12,1250630,1170338,80292,6.4
MS,1995,1,1250257,1171784,78473,6.3
MS,1995,2,1248551,1173034,75517,6
MS,1995,3,1249414,1172227,77187,6.2
MS,1995,4,1252384,1172156,80228,6.4
MS,1995,5,1255353,1172381,82972,6.6
MS,1995,6,1258204,1173978,84226,6.7
MS,1995,7,1260044,1174274,85770,6.8
MS,1995,8,1266372,1177535,88837,7
MS,1995,9,1265472,1178212,87260,6.9
MS,1995,10,1260372,1179283,81089,6.4
MS,1995,11,1261308,1179448,81860,6.5
MS,1995,12,1263069,1179025,84044,6.7
MS,1996,1,1266980,1179814,87166,6.9
MS,1996,2,1263950,1180476,83474,6.6
MS,1996,3,1263575,1182271,81304,6.4
MS,1996,4,1266986,1183999,82987,6.5
MS,1996,5,1267437,1185501,81936,6.5
MS,1996,6,1265357,1186553,78804,6.2
MS,1996,7,1266558,1187539,79019,6.2
MS,1996,8,1267264,1189287,77977,6.2
MS,1996,9,1265210,1191209,74001,5.8
MS,1996,10,1267930,1190987,76943,6.1
MS,1996,11,1268491,1192562,75929,6
MS,1996,12,1269571,1194022,75549,6
MS,1997,1,1270912,1193925,76987,6.1
MS,1997,2,1274517,1196557,77960,6.1
MS,1997,3,1274780,1198194,76586,6
MS,1997,4,1273114,1199259,73855,5.8
MS,1997,5,1274848,1200213,74635,5.9
MS,1997,6,1275053,1198945,76108,6
MS,1997,7,1278794,1201048,77746,6.1
MS,1997,8,1281951,1201514,80437,6.3
MS,1997,9,1284330,1202002,82328,6.4
MS,1997,10,1284383,1204107,80276,6.3
MS,1997,11,1283160,1206725,76435,6
MS,1997,12,1280334,1207651,72683,5.7
MS,1998,1,1282613,1207915,74698,5.8
MS,1998,2,1281489,1207974,73515,5.7
MS,1998,3,1282145,1208534,73611,5.7
MS,1998,4,1279744,1210061,69683,5.4
MS,1998,5,1279922,1211605,68317,5.3
MS,1998,6,1277002,1210953,66049,5.2
MS,1998,7,1280427,1212152,68275,5.3
MS,1998,8,1282543,1212346,70197,5.5
MS,1998,9,1283260,1213159,70101,5.5
MS,1998,10,1281649,1214441,67208,5.2
MS,1998,11,1281731,1214427,67304,5.3
MS,1998,12,1283819,1214857,68962,5.4
MS,1999,1,1281217,1214242,66975,5.2
MS,1999,2,1277124,1214919,62205,4.9
MS,1999,3,1283370,1217300,66070,5.1
MS,1999,4,1281680,1218457,63223,4.9
MS,1999,5,1283432,1218863,64569,5
MS,1999,6,1285910,1221804,64106,5
MS,1999,7,1290564,1224302,66262,5.1
MS,1999,8,1295026,1226638,68388,5.3
MS,1999,9,1301622,1229160,72462,5.6
MS,1999,10,1303063,1229567,73496,5.6
MS,1999,11,1304604,1233220,71384,5.5
MS,1999,12,1312596,1236229,76367,5.8
MS,2000,1,1311559,1234837,76722,5.8
MS,2000,2,1315031,1236326,78705,6
MS,2000,3,1314891,1238650,76241,5.8
MS,2000,4,1317023,1240292,76731,5.8
MS,2000,5,1319170,1242019,77151,5.8
MS,2000,6,1320994,1243005,77989,5.9
MS,2000,7,1317064,1242258,74806,5.7
MS,2000,8,1313661,1242340,71321,5.4
MS,2000,9,1310319,1240241,70078,5.3
MS,2000,10,1311680,1239840,71840,5.5
MS,2000,11,1312268,1238996,73272,5.6
MS,2000,12,1306193,1239506,66687,5.1
MS,2001,1,1302758,1238776,63982,4.9
MS,2001,2,1304846,1236936,67910,5.2
MS,2001,3,1304449,1234606,69843,5.4
MS,2001,4,1300035,1234293,65742,5.1
MS,2001,5,1299452,1233202,66250,5.1
MS,2001,6,1295991,1231066,64925,5
MS,2001,7,1297754,1228752,69002,5.3
MS,2001,8,1301284,1228575,72709,5.6
MS,2001,9,1304048,1226172,77876,6
MS,2001,10,1303448,1223238,80210,6.2
MS,2001,11,1306779,1221644,85135,6.5
MS,2001,12,1309920,1221342,88578,6.8
MS,2002,1,1303677,1215198,88479,6.8
MS,2002,2,1300805,1213455,87350,6.7
MS,2002,3,1301432,1212640,88792,6.8
MS,2002,4,1303605,1212592,91013,7
MS,2002,5,1300675,1213110,87565,6.7
MS,2002,6,1299992,1214291,85701,6.6
MS,2002,7,1297990,1214028,83962,6.5
MS,2002,8,1296584,1214285,82299,6.3
MS,2002,9,1300052,1215617,84435,6.5
MS,2002,10,1305819,1215031,90788,7
MS,2002,11,1307389,1216421,90968,7
MS,2002,12,1308804,1218909,89895,6.9
MS,2003,1,1307066,1219077,87989,6.7
MS,2003,2,1305025,1220099,84926,6.5
MS,2003,3,1308371,1221034,87337,6.7
MS,2003,4,1311353,1222228,89125,6.8
MS,2003,5,1311062,1223577,87485,6.7
MS,2003,6,1313920,1224335,89585,6.8
MS,2003,7,1315345,1227454,87891,6.7
MS,2003,8,1309167,1227849,81318,6.2
MS,2003,9,1308633,1229922,78711,6
MS,2003,10,1313157,1232674,80483,6.1
MS,2003,11,1309632,1234179,75453,5.8
MS,2003,12,1308452,1233088,75364,5.8
MS,2004,1,1307691,1233413,74278,5.7
MS,2004,2,1306235,1233647,72588,5.6
MS,2004,3,1304363,1234556,69807,5.4
MS,2004,4,1308603,1233904,74699,5.7
MS,2004,5,1313139,1232503,80636,6.1
MS,2004,6,1314701,1231828,82873,6.3
MS,2004,7,1317500,1231884,85616,6.5
MS,2004,8,1318622,1230342,88280,6.7
MS,2004,9,1322160,1230857,91303,6.9
MS,2004,10,1324477,1230381,94096,7.1
MS,2004,11,1325395,1230817,94578,7.1
MS,2004,12,1325074,1231534,93540,7.1
MS,2005,1,1324724,1233035,91689,6.9
MS,2005,2,1325044,1234473,90571,6.8
MS,2005,3,1327907,1235725,92182,6.9
MS,2005,4,1328051,1236421,91630,6.9
MS,2005,5,1331488,1237013,94475,7.1
MS,2005,6,1332946,1237719,95227,7.1
MS,2005,7,1332596,1240564,92032,6.9
MS,2005,8,1337395,1241364,96031,7.2
MS,2005,9,1329736,1191702,138034,10.4
MS,2005,10,1317742,1193660,124082,9.4
MS,2005,11,1316532,1194639,121893,9.3
MS,2005,12,1303578,1195862,107716,8.3
MS,2006,1,1298120,1198988,99132,7.6
MS,2006,2,1295763,1202340,93423,7.2
MS,2006,3,1287624,1204777,82847,6.4
MS,2006,4,1290618,1206307,84311,6.5
MS,2006,5,1293471,1209212,84259,6.5
MS,2006,6,1294987,1210877,84110,6.5
MS,2006,7,1296542,1209942,86600,6.7
MS,2006,8,1299110,1213278,85832,6.6
MS,2006,9,1303424,1215309,88115,6.8
MS,2006,10,1303312,1215968,87344,6.7
MS,2006,11,1306675,1217021,89654,6.9
MS,2006,12,1305794,1218916,86878,6.7
MS,2007,1,1301933,1219674,82259,6.3
MS,2007,2,1304686,1219926,84760,6.5
MS,2007,3,1304474,1220500,83974,6.4
MS,2007,4,1304863,1221386,83477,6.4
MS,2007,5,1302564,1222229,80335,6.2
MS,2007,6,1304600,1223250,81350,6.2
MS,2007,7,1306881,1224277,82604,6.3
MS,2007,8,1306270,1226764,79506,6.1
MS,2007,9,1308905,1227939,80966,6.2
MS,2007,10,1310663,1228575,82088,6.3
MS,2007,11,1311611,1230931,80680,6.2
MS,2007,12,1312147,1231844,80303,6.1
MS,2008,1,1310115,1231646,78469,6
MS,2008,2,1307396,1229863,77533,5.9
MS,2008,3,1310275,1229714,80561,6.1
MS,2008,4,1312789,1228440,84349,6.4
MS,2008,5,1315760,1226464,89296,6.8
MS,2008,6,1313855,1223140,90715,6.9
MS,2008,7,1316676,1220649,96027,7.3
MS,2008,8,1315975,1220099,95876,7.3
MS,2008,9,1316830,1219452,97378,7.4
MS,2008,10,1314948,1219687,95261,7.2
MS,2008,11,1317273,1219257,98016,7.4
MS,2008,12,1321435,1217884,103551,7.8
MS,2009,1,1321630,1207272,114358,8.7
MO,1976,1,2111095,1989590,121505,5.8
MO,1976,2,2108111,1991627,116484,5.5
MO,1976,3,2107034,1987860,119174,5.7
MO,1976,4,2107416,1982985,124431,5.9
MO,1976,5,2107435,1984313,123122,5.8
MO,1976,6,2114298,1986057,128241,6.1
MO,1976,7,2126997,1992518,134479,6.3
MO,1976,8,2130794,1995589,135205,6.3
MO,1976,9,2140794,1997812,142982,6.7
MO,1976,10,2143785,2002908,140877,6.6
MO,1976,11,2151676,2011676,140000,6.5
MO,1976,12,2159603,2014453,145150,6.7
MO,1977,1,2161951,2018068,143883,6.7
MO,1977,2,2172949,2036567,136382,6.3
MO,1977,3,2177347,2046731,130616,6
MO,1977,4,2174359,2052668,121691,5.6
MO,1977,5,2183325,2056090,127235,5.8
MO,1977,6,2199117,2066741,132376,6
MO,1977,7,2214458,2081260,133198,6
MO,1977,8,2222488,2089597,132891,6
MO,1977,9,2220672,2093771,126901,5.7
MO,1977,10,2226810,2099449,127361,5.7
MO,1977,11,2226433,2102392,124041,5.6
MO,1977,12,2231382,2104713,126669,5.7
MO,1978,1,2241936,2116698,125238,5.6
MO,1978,2,2234667,2108830,125837,5.6
MO,1978,3,2233656,2114258,119398,5.3
MO,1978,4,2238002,2128860,109142,4.9
MO,1978,5,2238420,2136635,101785,4.5
MO,1978,6,2250342,2143650,106692,4.7
MO,1978,7,2253958,2143153,110805,4.9
MO,1978,8,2251306,2139938,111368,4.9
MO,1978,9,2254237,2150143,104094,4.6
MO,1978,10,2258540,2158118,100422,4.4
MO,1978,11,2261845,2162996,98849,4.4
MO,1978,12,2254069,2160714,93355,4.1
MO,1979,1,2248818,2157846,90972,4
MO,1979,2,2261754,2163148,98606,4.4
MO,1979,3,2269640,2174781,94859,4.2
MO,1979,4,2276742,2180886,95856,4.2
MO,1979,5,2292345,2194319,98026,4.3
MO,1979,6,2297977,2201124,96853,4.2
MO,1979,7,2297593,2196976,100617,4.4
MO,1979,8,2307746,2195300,112446,4.9
MO,1979,9,2298969,2184904,114065,5
MO,1979,10,2296368,2180450,115918,5
MO,1979,11,2297959,2176653,121306,5.3
MO,1979,12,2307145,2179994,127151,5.5
MO,1980,1,2301610,2167400,134210,5.8
MO,1980,2,2309798,2164434,145364,6.3
MO,1980,3,2314944,2161744,153200,6.6
MO,1980,4,2307918,2146708,161210,7
MO,1980,5,2303591,2134798,168793,7.3
MO,1980,6,2301668,2124042,177626,7.7
MO,1980,7,2308984,2130264,178720,7.7
MO,1980,8,2310539,2130456,180083,7.8
MO,1980,9,2305899,2127939,177960,7.7
MO,1980,10,2310294,2130749,179545,7.8
MO,1980,11,2316800,2139365,177435,7.7
MO,1980,12,2322950,2147127,175823,7.6
MO,1981,1,2337733,2161792,175941,7.5
MO,1981,2,2335444,2158314,177130,7.6
MO,1981,3,2329766,2157062,172704,7.4
MO,1981,4,2321232,2153850,167382,7.2
MO,1981,5,2316722,2147179,169543,7.3
MO,1981,6,2307267,2142197,165070,7.2
MO,1981,7,2290773,2131021,159752,7
MO,1981,8,2300503,2133416,167087,7.3
MO,1981,9,2316426,2143387,173039,7.5
MO,1981,10,2325290,2145499,179791,7.7
MO,1981,11,2329478,2142733,186745,8
MO,1981,12,2328032,2135637,192395,8.3
MO,1982,1,2325805,2126472,199333,8.6
MO,1982,2,2323848,2124117,199731,8.6
MO,1982,3,2327888,2124695,203193,8.7
MO,1982,4,2329486,2124502,204984,8.8
MO,1982,5,2329084,2123728,205356,8.8
MO,1982,6,2331814,2119294,212520,9.1
MO,1982,7,2343787,2128423,215364,9.2
MO,1982,8,2336796,2120585,216211,9.3
MO,1982,9,2328350,2107244,221106,9.5
MO,1982,10,2329854,2105844,224010,9.6
MO,1982,11,2334033,2098664,235369,10.1
MO,1982,12,2342395,2102322,240073,10.2
MO,1983,1,2350143,2110860,239283,10.2
MO,1983,2,2356796,2113625,243171,10.3
MO,1983,3,2359563,2113310,246253,10.4
MO,1983,4,2365434,2117638,247796,10.5
MO,1983,5,2366203,2125576,240627,10.2
MO,1983,6,2364778,2131253,233525,9.9
MO,1983,7,2358551,2124025,234526,9.9
MO,1983,8,2367931,2138883,229048,9.7
MO,1983,9,2370616,2146230,224386,9.5
MO,1983,10,2370710,2148910,221800,9.4
MO,1983,11,2373438,2158263,215175,9.1
MO,1983,12,2375083,2166895,208188,8.8
MO,1984,1,2384465,2183032,201433,8.4
MO,1984,2,2393071,2201892,191179,8
MO,1984,3,2386814,2203520,183294,7.7
MO,1984,4,2387891,2206529,181362,7.6
MO,1984,5,2387515,2216742,170773,7.2
MO,1984,6,2385493,2224562,160931,6.7
MO,1984,7,2374666,2220505,154161,6.5
MO,1984,8,2374273,2216304,157969,6.7
MO,1984,9,2398166,2242452,155714,6.5
MO,1984,10,2399764,2245935,153829,6.4
MO,1984,11,2412457,2252327,160130,6.6
MO,1984,12,2421534,2258766,162768,6.7
MO,1985,1,2419218,2256926,162292,6.7
MO,1985,2,2419019,2253880,165139,6.8
MO,1985,3,2422906,2260002,162904,6.7
MO,1985,4,2432130,2269833,162297,6.7
MO,1985,5,2440973,2279236,161737,6.6
MO,1985,6,2440153,2287304,152849,6.3
MO,1985,7,2449844,2299260,150584,6.1
MO,1985,8,2459239,2308556,150683,6.1
MO,1985,9,2454339,2300897,153442,6.3
MO,1985,10,2457955,2306284,151671,6.2
MO,1985,11,2455981,2305920,150061,6.1
MO,1985,12,2459390,2308711,150679,6.1
MO,1986,1,2471019,2322680,148339,6
MO,1986,2,2472610,2323995,148615,6
MO,1986,3,2479500,2330550,148950,6
MO,1986,4,2488184,2337581,150603,6.1
MO,1986,5,2500031,2341897,158134,6.3
MO,1986,6,2500027,2343087,156940,6.3
MO,1986,7,2513165,2356262,156903,6.2
MO,1986,8,2521414,2362748,158666,6.3
MO,1986,9,2517584,2357317,160267,6.4
MO,1986,10,2521358,2360430,160928,6.4
MO,1986,11,2530389,2369279,161110,6.4
MO,1986,12,2532281,2372622,159659,6.3
MO,1987,1,2542619,2379019,163600,6.4
MO,1987,2,2545572,2383295,162277,6.4
MO,1987,3,2544801,2382023,162778,6.4
MO,1987,4,2549481,2384401,165080,6.5
MO,1987,5,2551794,2386019,165775,6.5
MO,1987,6,2549362,2389135,160227,6.3
MO,1987,7,2555606,2393126,162480,6.4
MO,1987,8,2552362,2395996,156366,6.1
MO,1987,9,2552042,2403535,148507,5.8
MO,1987,10,2563114,2410606,152508,6
MO,1987,11,2558236,2406731,151505,5.9
MO,1987,12,2553981,2411342,142639,5.6
MO,1988,1,2548577,2408187,140390,5.5
MO,1988,2,2549994,2411482,138512,5.4
MO,1988,3,2557888,2421164,136724,5.3
MO,1988,4,2566070,2425164,140906,5.5
MO,1988,5,2571050,2425415,145635,5.7
MO,1988,6,2578844,2431940,146904,5.7
MO,1988,7,2580406,2433015,147391,5.7
MO,1988,8,2577942,2432068,145874,5.7
MO,1988,9,2587972,2441948,146024,5.6
MO,1988,10,2588523,2442345,146178,5.6
MO,1988,11,2600570,2453137,147433,5.7
MO,1988,12,2604683,2457326,147357,5.7
MO,1989,1,2604540,2461452,143088,5.5
MO,1989,2,2604510,2460531,143979,5.5
MO,1989,3,2606763,2462007,144756,5.6
MO,1989,4,2609427,2469404,140023,5.4
MO,1989,5,2607647,2470096,137551,5.3
MO,1989,6,2614479,2473582,140897,5.4
MO,1989,7,2618417,2476303,142114,5.4
MO,1989,8,2617702,2478878,138824,5.3
MO,1989,9,2618035,2474847,143188,5.5
MO,1989,10,2620303,2476641,143662,5.5
MO,1989,11,2617814,2471738,146076,5.6
MO,1989,12,2614368,2468893,145475,5.6
MO,1990,1,2611570,2465086,146484,5.6
MO,1990,2,2609402,2466004,143398,5.5
MO,1990,3,2602645,2460023,142622,5.5
MO,1990,4,2594974,2453537,141437,5.5
MO,1990,5,2597573,2457761,139812,5.4
MO,1990,6,2599886,2457986,141900,5.5
MO,1990,7,2599968,2452861,147107,5.7
MO,1990,8,2610509,2458325,152184,5.8
MO,1990,9,2612945,2457009,155936,6
MO,1990,10,2611695,2450584,161111,6.2
MO,1990,11,2616961,2451071,165890,6.3
MO,1990,12,2622883,2453735,169148,6.4
MO,1991,1,2635189,2458757,176432,6.7
MO,1991,2,2640849,2459709,181140,6.9
MO,1991,3,2643125,2463524,179601,6.8
MO,1991,4,2637087,2456966,180121,6.8
MO,1991,5,2635265,2458535,176730,6.7
MO,1991,6,2640153,2466122,174031,6.6
MO,1991,7,2645866,2478114,167752,6.3
MO,1991,8,2654431,2487859,166572,6.3
MO,1991,9,2658459,2490851,167608,6.3
MO,1991,10,2657891,2488525,169366,6.4
MO,1991,11,2656098,2488214,167884,6.3
MO,1991,12,2660407,2492831,167576,6.3
MO,1992,1,2658556,2490681,167875,6.3
MO,1992,2,2656203,2495849,160354,6
MO,1992,3,2658195,2498457,159738,6
MO,1992,4,2666934,2504446,162488,6.1
MO,1992,5,2669219,2504558,164661,6.2
MO,1992,6,2665960,2503410,162550,6.1
MO,1992,7,2668338,2509560,158778,6
MO,1992,8,2665432,2507839,157593,5.9
MO,1992,9,2663043,2506942,156101,5.9
MO,1992,10,2662265,2506592,155673,5.8
MO,1992,11,2656884,2504213,152671,5.7
MO,1992,12,2658334,2500805,157529,5.9
MO,1993,1,2670016,2508700,161316,6
MO,1993,2,2676374,2515157,161217,6
MO,1993,3,2681537,2514353,167184,6.2
MO,1993,4,2698252,2529090,169162,6.3
MO,1993,5,2707501,2536533,170968,6.3
MO,1993,6,2707250,2536514,170736,6.3
MO,1993,7,2709568,2540353,169215,6.2
MO,1993,8,2709621,2539852,169769,6.3
MO,1993,9,2719858,2550499,169359,6.2
MO,1993,10,2728456,2561839,166617,6.1
MO,1993,11,2730296,2569571,160725,5.9
MO,1993,12,2730224,2575038,155186,5.7
MO,1994,1,2730082,2580147,149935,5.5
MO,1994,2,2724643,2577390,147253,5.4
MO,1994,3,2729672,2585412,144260,5.3
MO,1994,4,2733565,2595074,138491,5.1
MO,1994,5,2741179,2604271,136908,5
MO,1994,6,2752607,2619245,133362,4.8
MO,1994,7,2761941,2631024,130917,4.7
MO,1994,8,2772290,2639518,132772,4.8
MO,1994,9,2774488,2644097,130391,4.7
MO,1994,10,2785947,2655184,130763,4.7
MO,1994,11,2794156,2664525,129631,4.6
MO,1994,12,2803364,2671542,131822,4.7
MO,1995,1,2796341,2665527,130814,4.7
MO,1995,2,2807965,2674105,133860,4.8
MO,1995,3,2819688,2682207,137481,4.9
MO,1995,4,2817952,2680638,137314,4.9
MO,1995,5,2817160,2678458,138702,4.9
MO,1995,6,2821883,2685002,136881,4.9
MO,1995,7,2822555,2685324,137231,4.9
MO,1995,8,2830728,2695165,135563,4.8
MO,1995,9,2838126,2706854,131272,4.6
MO,1995,10,2825403,2703501,121902,4.3
MO,1995,11,2830407,2709252,121155,4.3
MO,1995,12,2838176,2716488,121688,4.3
MO,1996,1,2844102,2719949,124153,4.4
MO,1996,2,2849004,2721748,127256,4.5
MO,1996,3,2860019,2727843,132176,4.6
MO,1996,4,2869939,2733638,136301,4.7
MO,1996,5,2870991,2734061,136930,4.8
MO,1996,6,2864559,2727538,137021,4.8
MO,1996,7,2868886,2729765,139121,4.8
MO,1996,8,2869454,2733502,135952,4.7
MO,1996,9,2868756,2734235,134521,4.7
MO,1996,10,2885170,2748697,136473,4.7
MO,1996,11,2892959,2754410,138549,4.8
MO,1996,12,2889025,2752929,136096,4.7
MO,1997,1,2898337,2763529,134808,4.7
MO,1997,2,2898049,2768474,129575,4.5
MO,1997,3,2899922,2776419,123503,4.3
MO,1997,4,2901111,2775672,125439,4.3
MO,1997,5,2896377,2776927,119450,4.1
MO,1997,6,2897225,2779718,117507,4.1
MO,1997,7,2902321,2782570,119751,4.1
MO,1997,8,2907893,2788108,119785,4.1
MO,1997,9,2911493,2786627,124866,4.3
MO,1997,10,2912316,2788092,124224,4.3
MO,1997,11,2912429,2789748,122681,4.2
MO,1997,12,2913094,2786334,126760,4.4
MO,1998,1,2910003,2783613,126390,4.3
MO,1998,2,2915025,2789926,125099,4.3
MO,1998,3,2910109,2781882,128227,4.4
MO,1998,4,2914740,2787466,127274,4.4
MO,1998,5,2922742,2799951,122791,4.2
MO,1998,6,2921894,2803189,118705,4.1
MO,1998,7,2922421,2801502,120919,4.1
MO,1998,8,2914796,2800720,114076,3.9
MO,1998,9,2907149,2800754,106395,3.7
MO,1998,10,2899379,2793476,105903,3.7
MO,1998,11,2895342,2793162,102180,3.5
MO,1998,12,2896856,2802790,94066,3.2
MO,1999,1,2886447,2797759,88688,3.1
MO,1999,2,2893437,2804024,89413,3.1
MO,1999,3,2898612,2805221,93391,3.2
MO,1999,4,2909049,2812409,96640,3.3
MO,1999,5,2908091,2810223,97868,3.4
MO,1999,6,2908879,2809984,98895,3.4
MO,1999,7,2919845,2824887,94958,3.3
MO,1999,8,2911387,2818283,93104,3.2
MO,1999,9,2922239,2831487,90752,3.1
MO,1999,10,2920878,2836543,84335,2.9
MO,1999,11,2924205,2839810,84395,2.9
MO,1999,12,2931215,2847610,83605,2.9
MO,2000,1,2944845,2868482,76363,2.6
MO,2000,2,2952543,2870420,82123,2.8
MO,2000,3,2959333,2872188,87145,2.9
MO,2000,4,2959519,2873710,85809,2.9
MO,2000,5,2967735,2875026,92709,3.1
MO,2000,6,2969494,2876135,93359,3.1
MO,2000,7,2972030,2876967,95063,3.2
MO,2000,8,2979400,2877620,101780,3.4
MO,2000,9,2989180,2878110,111070,3.7
MO,2000,10,2992740,2878458,114282,3.8
MO,2000,11,2991134,2878555,112579,3.8
MO,2000,12,2999146,2878363,120783,4
MO,2001,1,3004437,2877974,126463,4.2
MO,2001,2,3006263,2877233,129030,4.3
MO,2001,3,3002341,2876114,126227,4.2
MO,2001,4,3003709,2874624,129085,4.3
MO,2001,5,3000326,2872780,127546,4.3
MO,2001,6,3004112,2870582,133530,4.4
MO,2001,7,3001801,2868032,133769,4.5
MO,2001,8,3001455,2865285,136170,4.5
MO,2001,9,3001941,2862354,139587,4.6
MO,2001,10,3005079,2859360,145719,4.8
MO,2001,11,3002071,2856403,145668,4.9
MO,2001,12,2999034,2853490,145544,4.9
MO,2002,1,2992136,2841672,150464,5
MO,2002,2,2990488,2838703,151785,5.1
MO,2002,3,2993093,2835908,157185,5.3
MO,2002,4,2990253,2833332,156921,5.2
MO,2002,5,2986076,2831075,155001,5.2
MO,2002,6,2989823,2829125,160698,5.4
MO,2002,7,2985731,2827471,158260,5.3
MO,2002,8,2979417,2826209,153208,5.1
MO,2002,9,2980937,2825215,155722,5.2
MO,2002,10,2981232,2824355,156877,5.3
MO,2002,11,2981428,2823665,157763,5.3
MO,2002,12,2980558,2823083,157475,5.3
MO,2003,1,2976904,2817077,159827,5.4
MO,2003,2,2973847,2816266,157581,5.3
MO,2003,3,2978511,2815431,163080,5.5
MO,2003,4,2981729,2814649,167080,5.6
MO,2003,5,2984105,2813951,170154,5.7
MO,2003,6,2986715,2813336,173379,5.8
MO,2003,7,2983823,2812811,171012,5.7
MO,2003,8,2982166,2812373,169793,5.7
MO,2003,9,2979052,2812054,166998,5.6
MO,2003,10,2975390,2811827,163563,5.5
MO,2003,11,2973693,2811610,162083,5.5
MO,2003,12,2974314,2811468,162846,5.5
MO,2004,1,2974497,2813524,160973,5.4
MO,2004,2,2979980,2813466,166514,5.6
MO,2004,3,2977838,2813586,164252,5.5
MO,2004,4,2977627,2813828,163799,5.5
MO,2004,5,2984872,2814149,170723,5.7
MO,2004,6,2988482,2814604,173878,5.8
MO,2004,7,2994021,2815200,178821,6
MO,2004,8,2994142,2816003,178139,5.9
MO,2004,9,2994963,2817035,177928,5.9
MO,2004,10,2994698,2818291,176407,5.9
MO,2004,11,2997015,2819666,177349,5.9
MO,2004,12,2995218,2821183,174035,5.8
MO,2005,1,3001919,2822848,179071,6
MO,2005,2,2996091,2824830,171261,5.7
MO,2005,3,2995406,2827075,168331,5.6
MO,2005,4,2995808,2829583,166225,5.5
MO,2005,5,2995583,2832182,163401,5.5
MO,2005,6,2996012,2834917,161095,5.4
MO,2005,7,2998450,2837813,160637,5.4
MO,2005,8,2991499,2840752,150747,5
MO,2005,9,2995488,2843703,151785,5.1
MO,2005,10,2999977,2846738,153239,5.1
MO,2005,11,3003934,2849913,154021,5.1
MO,2005,12,3002759,2853205,149554,5
MO,2006,1,2999267,2856563,142704,4.8
MO,2006,2,2998778,2859688,139090,4.6
MO,2006,3,3000828,2862535,138293,4.6
MO,2006,4,3006596,2865077,141519,4.7
MO,2006,5,3010231,2867323,142908,4.7
MO,2006,6,3014326,2869320,145006,4.8
MO,2006,7,3015242,2871093,144149,4.8
MO,2006,8,3024315,2872641,151674,5
MO,2006,9,3026487,2874000,152487,5
MO,2006,10,3028804,2875149,153655,5.1
MO,2006,11,3024067,2876104,147963,4.9
MO,2006,12,3020501,2876788,143713,4.8
MO,2007,1,3017436,2877126,140310,4.6
MO,2007,2,3025501,2877133,148368,4.9
MO,2007,3,3020021,2876804,143217,4.7
MO,2007,4,3019190,2876003,143187,4.7
MO,2007,5,3020888,2874835,146053,4.8
MO,2007,6,3025079,2873277,151802,5
MO,2007,7,3026200,2871363,154837,5.1
MO,2007,8,3027907,2869138,158769,5.2
MO,2007,9,3027813,2866561,161252,5.3
MO,2007,10,3028274,2863631,164643,5.4
MO,2007,11,3021637,2860418,161219,5.3
MO,2007,12,3017324,2856858,160466,5.3
MO,2008,1,3017918,2852937,164981,5.5
MO,2008,2,3015452,2848905,166547,5.5
MO,2008,3,3015046,2844737,170309,5.6
MO,2008,4,3010406,2840533,169873,5.6
MO,2008,5,3010341,2836276,174065,5.8
MO,2008,6,3007445,2831916,175529,5.8
MO,2008,7,3010020,2827461,182559,6.1
MO,2008,8,3009891,2822943,186948,6.2
MO,2008,9,3008507,2818385,190122,6.3
MO,2008,10,3009009,2813798,195211,6.5
MO,2008,11,3013992,2809116,204876,6.8
MO,2008,12,3017492,2804465,213027,7.1
MO,2009,1,3008509,2767195,241314,8
MT,1976,1,330410,311857,18553,5.6
MT,1976,2,330894,312173,18721,5.7
MT,1976,3,330836,311959,18877,5.7
MT,1976,4,331115,312093,19022,5.7
MT,1976,5,330181,311025,19156,5.8
MT,1976,6,329844,310564,19280,5.8
MT,1976,7,333681,314288,19393,5.8
MT,1976,8,332984,313487,19497,5.9
MT,1976,9,333289,313697,19592,5.9
MT,1976,10,334623,314945,19678,5.9
MT,1976,11,335812,316058,19754,5.9
MT,1976,12,336350,316531,19819,5.9
MT,1977,1,337365,317495,19870,5.9
MT,1977,2,338455,318535,19920,5.9
MT,1977,3,339805,319836,19969,5.9
MT,1977,4,340539,320525,20014,5.9
MT,1977,5,342477,322420,20057,5.9
MT,1977,6,345157,325063,20094,5.8
MT,1977,7,344663,324539,20124,5.8
MT,1977,8,349649,329502,20147,5.8
MT,1977,9,349099,328936,20163,5.8
MT,1977,10,345768,325597,20171,5.8
MT,1977,11,346439,326268,20171,5.8
MT,1977,12,348062,327900,20162,5.8
MT,1978,1,348886,328741,20145,5.8
MT,1978,2,349525,329413,20112,5.8
MT,1978,3,350570,330505,20065,5.7
MT,1978,4,352674,332669,20005,5.7
MT,1978,5,354126,334191,19935,5.6
MT,1978,6,367450,347592,19858,5.4
MT,1978,7,370885,351110,19775,5.3
MT,1978,8,370204,350513,19691,5.3
MT,1978,9,370565,350958,19607,5.3
MT,1978,10,369715,350188,19527,5.3
MT,1978,11,369094,349640,19454,5.3
MT,1978,12,369116,349724,19392,5.3
MT,1979,1,367157,347817,19340,5.3
MT,1979,2,367493,348167,19326,5.3
MT,1979,3,368034,348685,19349,5.3
MT,1979,4,369554,350144,19410,5.3
MT,1979,5,371944,352436,19508,5.2
MT,1979,6,374518,354874,19644,5.2
MT,1979,7,373235,353418,19817,5.3
MT,1979,8,373575,353549,20026,5.4
MT,1979,9,374581,354310,20271,5.4
MT,1979,10,374402,353851,20551,5.5
MT,1979,11,374559,353691,20868,5.6
MT,1979,12,374049,352827,21222,5.7
MT,1980,1,373982,352369,21613,5.8
MT,1980,2,374186,352191,21995,5.9
MT,1980,3,373913,351548,22365,6
MT,1980,4,372529,349809,22720,6.1
MT,1980,5,372721,349664,23057,6.2
MT,1980,6,371759,348386,23373,6.3
MT,1980,7,371227,347561,23666,6.4
MT,1980,8,371924,347993,23931,6.4
MT,1980,9,372543,348377,24166,6.5
MT,1980,10,376092,351725,24367,6.5
MT,1980,11,376868,352335,24533,6.5
MT,1980,12,377977,353315,24662,6.5
MT,1981,1,380730,355977,24753,6.5
MT,1981,2,381228,356348,24880,6.5
MT,1981,3,382273,357227,25046,6.6
MT,1981,4,383030,357779,25251,6.6
MT,1981,5,382479,356983,25496,6.7
MT,1981,6,382164,356380,25784,6.7
MT,1981,7,382979,356863,26116,6.8
MT,1981,8,383243,356749,26494,6.9
MT,1981,9,382961,356043,26918,7
MT,1981,10,384369,356979,27390,7.1
MT,1981,11,384339,356430,27909,7.3
MT,1981,12,384465,355989,28476,7.4
MT,1982,1,384007,354915,29092,7.6
MT,1982,2,383748,354067,29681,7.7
MT,1982,3,383752,353513,30239,7.9
MT,1982,4,383939,353175,30764,8
MT,1982,5,384497,353243,31254,8.1
MT,1982,6,384008,352301,31707,8.3
MT,1982,7,385490,353371,32119,8.3
MT,1982,8,385733,353242,32491,8.4
MT,1982,9,385773,352952,32821,8.5
MT,1982,10,387341,354233,33108,8.5
MT,1982,11,387932,354583,33349,8.6
MT,1982,12,388598,355052,33546,8.6
MT,1983,1,389267,355569,33698,8.7
MT,1983,2,389366,355560,33806,8.7
MT,1983,3,390008,356137,33871,8.7
MT,1983,4,390460,356569,33891,8.7
MT,1983,5,390165,356297,33868,8.7
MT,1983,6,391718,357918,33800,8.6
MT,1983,7,393070,359380,33690,8.6
MT,1983,8,393140,359601,33539,8.5
MT,1983,9,395962,362615,33347,8.4
MT,1983,10,395790,362674,33116,8.4
MT,1983,11,396407,363561,32846,8.3
MT,1983,12,397136,364597,32539,8.2
MT,1984,1,397978,365779,32199,8.1
MT,1984,2,399768,367875,31893,8
MT,1984,3,400433,368811,31622,7.9
MT,1984,4,400653,369266,31387,7.8
MT,1984,5,401612,370423,31189,7.8
MT,1984,6,402060,371029,31031,7.7
MT,1984,7,401710,370798,30912,7.7
MT,1984,8,402130,371294,30836,7.7
MT,1984,9,402841,372038,30803,7.6
MT,1984,10,402703,371889,30814,7.7
MT,1984,11,402794,371922,30872,7.7
MT,1984,12,402730,371753,30977,7.7
MT,1985,1,402250,371122,31128,7.7
MT,1985,2,401848,370589,31259,7.8
MT,1985,3,401617,370249,31368,7.8
MT,1985,4,401921,370468,31453,7.8
MT,1985,5,402205,370690,31515,7.8
MT,1985,6,401144,369594,31550,7.9
MT,1985,7,400660,369102,31558,7.9
MT,1985,8,401342,369803,31539,7.9
MT,1985,9,400297,368806,31491,7.9
MT,1985,10,400462,369049,31413,7.8
MT,1985,11,400861,369555,31306,7.8
MT,1985,12,400701,369532,31169,7.8
MT,1986,1,402363,371362,31001,7.7
MT,1986,2,402273,371429,30844,7.7
MT,1986,3,402235,371536,30699,7.6
MT,1986,4,401195,370631,30564,7.6
MT,1986,5,400407,369968,30439,7.6
MT,1986,6,400167,369844,30323,7.6
MT,1986,7,399031,368815,30216,7.6
MT,1986,8,398518,368399,30119,7.6
MT,1986,9,399125,369095,30030,7.5
MT,1986,10,399700,369749,29951,7.5
MT,1986,11,399235,369355,29880,7.5
MT,1986,12,399775,369957,29818,7.5
MT,1987,1,400599,370834,29765,7.4
MT,1987,2,400840,371151,29689,7.4
MT,1987,3,400307,370713,29594,7.4
MT,1987,4,400558,371079,29479,7.4
MT,1987,5,400085,370738,29347,7.3
MT,1987,6,397674,368479,29195,7.3
MT,1987,7,398930,369905,29025,7.3
MT,1987,8,398740,369905,28835,7.2
MT,1987,9,398698,370071,28627,7.2
MT,1987,10,399775,371374,28401,7.1
MT,1987,11,399578,371422,28156,7
MT,1987,12,400985,373093,27892,7
MT,1988,1,401143,373533,27610,6.9
MT,1988,2,401214,373881,27333,6.8
MT,1988,3,401271,374209,27062,6.7
MT,1988,4,400828,374031,26797,6.7
MT,1988,5,400374,373835,26539,6.6
MT,1988,6,401203,374913,26290,6.6
MT,1988,7,399490,373439,26051,6.5
MT,1988,8,400081,374256,25825,6.5
MT,1988,9,401630,376017,25613,6.4
MT,1988,10,402046,376626,25420,6.3
MT,1988,11,404117,378872,25245,6.2
MT,1988,12,402430,377341,25089,6.2
MT,1989,1,402833,377882,24951,6.2
MT,1989,2,402413,377589,24824,6.2
MT,1989,3,402518,377811,24707,6.1
MT,1989,4,403563,378963,24600,6.1
MT,1989,5,403428,378923,24505,6.1
MT,1989,6,405039,380617,24422,6
MT,1989,7,404822,380470,24352,6
MT,1989,8,403948,379654,24294,6
MT,1989,9,404960,380710,24250,6
MT,1989,10,405263,381044,24219,6
MT,1989,11,406105,381901,24204,6
MT,1989,12,407800,383596,24204,5.9
MT,1990,1,407008,382787,24221,6
MT,1990,2,407316,383065,24251,6
MT,1990,3,408469,384173,24296,5.9
MT,1990,4,408691,384337,24354,6
MT,1990,5,409056,384632,24424,6
MT,1990,6,408795,384291,24504,6
MT,1990,7,407823,383229,24594,6
MT,1990,8,407697,383005,24692,6.1
MT,1990,9,407219,382423,24796,6.1
MT,1990,10,408990,384089,24901,6.1
MT,1990,11,409472,384467,25005,6.1
MT,1990,12,409075,383971,25104,6.1
MT,1991,1,408936,383739,25197,6.2
MT,1991,2,408694,383395,25299,6.2
MT,1991,3,407792,382383,25409,6.2
MT,1991,4,407347,381822,25525,6.3
MT,1991,5,408022,382374,25648,6.3
MT,1991,6,408181,382404,25777,6.3
MT,1991,7,408773,382862,25911,6.3
MT,1991,8,410019,383969,26050,6.4
MT,1991,9,411223,385030,26193,6.4
MT,1991,10,411526,385187,26339,6.4
MT,1991,11,411847,385359,26488,6.4
MT,1991,12,413421,386784,26637,6.4
MT,1992,1,414953,388166,26787,6.5
MT,1992,2,415634,388729,26905,6.5
MT,1992,3,416455,389463,26992,6.5
MT,1992,4,417100,390051,27049,6.5
MT,1992,5,417645,390568,27077,6.5
MT,1992,6,418168,391092,27076,6.5
MT,1992,7,417471,390425,27046,6.5
MT,1992,8,416974,389984,26990,6.5
MT,1992,9,417276,390369,26907,6.4
MT,1992,10,417612,390815,26797,6.4
MT,1992,11,419150,392487,26663,6.4
MT,1992,12,418704,392199,26505,6.3
MT,1993,1,418444,392121,26323,6.3
MT,1993,2,419587,393449,26138,6.2
MT,1993,3,420270,394319,25951,6.2
MT,1993,4,421492,395728,25764,6.1
MT,1993,5,421896,396318,25578,6.1
MT,1993,6,422660,397266,25394,6
MT,1993,7,422597,397385,25212,6
MT,1993,8,423623,398590,25033,5.9
MT,1993,9,423571,398712,24859,5.9
MT,1993,10,424956,400263,24693,5.8
MT,1993,11,425156,400620,24536,5.8
MT,1993,12,426698,402309,24389,5.7
MT,1994,1,428376,404120,24256,5.7
MT,1994,2,428922,404790,24132,5.6
MT,1994,3,430231,406210,24021,5.6
MT,1994,4,432341,408419,23922,5.5
MT,1994,5,433347,409510,23837,5.5
MT,1994,6,434013,410246,23767,5.5
MT,1994,7,436002,412289,23713,5.4
MT,1994,8,438425,414752,23673,5.4
MT,1994,9,439264,415621,23643,5.4
MT,1994,10,438370,414747,23623,5.4
MT,1994,11,438969,415359,23610,5.4
MT,1994,12,439029,415426,23603,5.4
MT,1995,1,439737,416137,23600,5.4
MT,1995,2,440242,416626,23616,5.4
MT,1995,3,440720,417072,23648,5.4
MT,1995,4,439403,415708,23695,5.4
MT,1995,5,439615,415859,23756,5.4
MT,1995,6,441279,417449,23830,5.4
MT,1995,7,442653,418739,23914,5.4
MT,1995,8,443026,419017,24009,5.4
MT,1995,9,444001,419888,24113,5.4
MT,1995,10,443387,419162,24225,5.5
MT,1995,11,442926,418581,24345,5.5
MT,1995,12,443480,419006,24474,5.5
MT,1996,1,444038,419425,24613,5.5
MT,1996,2,444762,420043,24719,5.6
MT,1996,3,445303,420509,24794,5.6
MT,1996,4,446214,421374,24840,5.6
MT,1996,5,446496,421638,24858,5.6
MT,1996,6,446900,422051,24849,5.6
MT,1996,7,447527,422713,24814,5.5
MT,1996,8,448223,423468,24755,5.5
MT,1996,9,448589,423918,24671,5.5
MT,1996,10,449354,424790,24564,5.5
MT,1996,11,449585,425148,24437,5.4
MT,1996,12,448712,424424,24288,5.4
MT,1997,1,448200,424081,24119,5.4
MT,1997,2,448528,424537,23991,5.3
MT,1997,3,448604,424700,23904,5.3
MT,1997,4,448880,425024,23856,5.3
MT,1997,5,450389,426544,23845,5.3
MT,1997,6,450235,426363,23872,5.3
MT,1997,7,451264,427329,23935,5.3
MT,1997,8,452506,428473,24033,5.3
MT,1997,9,453529,429363,24166,5.3
MT,1997,10,454943,430609,24334,5.3
MT,1997,11,455530,430995,24535,5.4
MT,1997,12,456798,432030,24768,5.4
MT,1998,1,457001,431969,25032,5.5
MT,1998,2,457841,432578,25263,5.5
MT,1998,3,457815,432355,25460,5.6
MT,1998,4,459081,433457,25624,5.6
MT,1998,5,459663,433909,25754,5.6
MT,1998,6,459925,434076,25849,5.6
MT,1998,7,461549,435639,25910,5.6
MT,1998,8,462234,436296,25938,5.6
MT,1998,9,463028,437096,25932,5.6
MT,1998,10,463670,437778,25892,5.6
MT,1998,11,463965,438149,25816,5.6
MT,1998,12,464271,438567,25704,5.5
MT,1999,1,463492,437934,25558,5.5
MT,1999,2,463671,438268,25403,5.5
MT,1999,3,464723,439482,25241,5.4
MT,1999,4,465498,440426,25072,5.4
MT,1999,5,464450,439553,24897,5.4
MT,1999,6,464782,440063,24719,5.3
MT,1999,7,466126,441587,24539,5.3
MT,1999,8,465533,441177,24356,5.2
MT,1999,9,465720,441549,24171,5.2
MT,1999,10,465977,441995,23982,5.1
MT,1999,11,466180,442389,23791,5.1
MT,1999,12,466922,443325,23597,5.1
MT,2000,1,468228,444968,23260,5
MT,2000,2,468975,445915,23060,4.9
MT,2000,3,470450,447582,22868,4.9
MT,2000,4,469114,446430,22684,4.8
MT,2000,5,469847,447338,22509,4.8
MT,2000,6,469083,446742,22341,4.8
MT,2000,7,468837,446654,22183,4.7
MT,2000,8,469165,447132,22033,4.7
MT,2000,9,469040,447148,21892,4.7
MT,2000,10,467923,446162,21761,4.7
MT,2000,11,468020,446380,21640,4.6
MT,2000,12,467702,446173,21529,4.6
MT,2001,1,470163,448733,21430,4.6
MT,2001,2,470270,448929,21341,4.5
MT,2001,3,470173,448912,21261,4.5
MT,2001,4,469457,448264,21193,4.5
MT,2001,5,469893,448759,21134,4.5
MT,2001,6,470262,449175,21087,4.5
MT,2001,7,468527,447475,21052,4.5
MT,2001,8,468453,447424,21029,4.5
MT,2001,9,467436,446420,21016,4.5
MT,2001,10,467869,446854,21015,4.5
MT,2001,11,467620,446596,21024,4.5
MT,2001,12,467427,446382,21045,4.5
MT,2002,1,466487,445493,20994,4.5
MT,2002,2,466090,445073,21017,4.5
MT,2002,3,465182,444149,21033,4.5
MT,2002,4,465315,444272,21043,4.5
MT,2002,5,465979,444932,21047,4.5
MT,2002,6,466787,445739,21048,4.5
MT,2002,7,466125,445081,21044,4.5
MT,2002,8,465885,444851,21034,4.5
MT,2002,9,466561,445539,21022,4.5
MT,2002,10,466487,445482,21005,4.5
MT,2002,11,466956,445974,20982,4.5
MT,2002,12,467740,446788,20952,4.5
MT,2003,1,469574,449043,20531,4.4
MT,2003,2,469479,448996,20483,4.4
MT,2003,3,468803,448365,20438,4.4
MT,2003,4,469855,449459,20396,4.3
MT,2003,5,470265,449910,20355,4.3
MT,2003,6,469119,448805,20314,4.3
MT,2003,7,469374,449104,20270,4.3
MT,2003,8,470970,450745,20225,4.3
MT,2003,9,471488,451312,20176,4.3
MT,2003,10,472201,452078,20123,4.3
MT,2003,11,471930,451863,20067,4.3
MT,2003,12,472608,452602,20006,4.2
MT,2004,1,470471,450840,19631,4.2
MT,2004,2,471378,451802,19576,4.2
MT,2004,3,472740,453225,19515,4.1
MT,2004,4,475636,456191,19445,4.1
MT,2004,5,475571,456205,19366,4.1
MT,2004,6,476441,457162,19279,4
MT,2004,7,476771,457589,19182,4
MT,2004,8,476255,457177,19078,4
MT,2004,9,477008,458044,18964,4
MT,2004,10,477296,458453,18843,3.9
MT,2004,11,478309,459594,18715,3.9
MT,2004,12,478916,460335,18581,3.9
MT,2005,1,477681,459237,18444,3.9
MT,2005,2,479043,460741,18302,3.8
MT,2005,3,480038,461882,18156,3.8
MT,2005,4,479697,461689,18008,3.8
MT,2005,5,480243,462386,17857,3.7
MT,2005,6,481206,463501,17705,3.7
MT,2005,7,482505,464953,17552,3.6
MT,2005,8,483236,465836,17400,3.6
MT,2005,9,484638,467389,17249,3.6
MT,2005,10,485384,468282,17102,3.5
MT,2005,11,486742,469783,16959,3.5
MT,2005,12,486647,469823,16824,3.5
MT,2006,1,488100,471402,16698,3.4
MT,2006,2,489418,472841,16577,3.4
MT,2006,3,490312,473851,16461,3.4
MT,2006,4,491741,475387,16354,3.3
MT,2006,5,493029,476773,16256,3.3
MT,2006,6,495832,479664,16168,3.3
MT,2006,7,496886,480793,16093,3.2
MT,2006,8,494916,478882,16034,3.2
MT,2006,9,494249,478257,15992,3.2
MT,2006,10,494461,478492,15969,3.2
MT,2006,11,495560,479593,15967,3.2
MT,2006,12,497129,481139,15990,3.2
MT,2007,1,498352,482316,16036,3.2
MT,2007,2,498769,482643,16126,3.2
MT,2007,3,500544,484284,16260,3.2
MT,2007,4,500690,484251,16439,3.3
MT,2007,5,501335,484676,16659,3.3
MT,2007,6,502364,485444,16920,3.4
MT,2007,7,502605,485385,17220,3.4
MT,2007,8,503418,485862,17556,3.5
MT,2007,9,502906,484977,17929,3.6
MT,2007,10,503987,485649,18338,3.6
MT,2007,11,504453,485670,18783,3.7
MT,2007,12,504948,485684,19264,3.8
MT,2008,1,504901,485119,19782,3.9
MT,2008,2,505044,484736,20308,4
MT,2008,3,504979,484139,20840,4.1
MT,2008,4,504764,483387,21377,4.2
MT,2008,5,505824,483910,21914,4.3
MT,2008,6,505562,483110,22452,4.4
MT,2008,7,506482,483494,22988,4.5
MT,2008,8,507295,483774,23521,4.6
MT,2008,9,507350,483302,24048,4.7
MT,2008,10,507385,482818,24567,4.8
MT,2008,11,507037,481962,25075,4.9
MT,2008,12,507276,481704,25572,5
MT,2009,1,503878,475666,28212,5.6
NE,1976,1,710646,685170,25476,3.6
NE,1976,2,708994,684052,24942,3.5
NE,1976,3,706886,684046,22840,3.2
NE,1976,4,705879,684923,20956,3
NE,1976,5,706822,685520,21302,3
NE,1976,6,707560,686213,21347,3
NE,1976,7,711292,689682,21610,3
NE,1976,8,712735,690306,22429,3.1
NE,1976,9,714892,691826,23066,3.2
NE,1976,10,717426,693646,23780,3.3
NE,1976,11,720336,696162,24174,3.4
NE,1976,12,722362,698333,24029,3.3
NE,1977,1,726167,702427,23740,3.3
NE,1977,2,729382,705743,23639,3.2
NE,1977,3,731885,708320,23565,3.2
NE,1977,4,735898,711593,24305,3.3
NE,1977,5,737321,713595,23726,3.2
NE,1977,6,740622,716195,24427,3.3
NE,1977,7,741658,717761,23897,3.2
NE,1977,8,745340,720058,25282,3.4
NE,1977,9,749961,722095,27866,3.7
NE,1977,10,751404,722130,29274,3.9
NE,1977,11,751916,723015,28901,3.8
NE,1977,12,752274,725936,26338,3.5
NE,1978,1,754999,726996,28003,3.7
NE,1978,2,756630,727956,28674,3.8
NE,1978,3,759429,730158,29271,3.9
NE,1978,4,756407,732534,23873,3.2
NE,1978,5,756233,735555,20678,2.7
NE,1978,6,757102,736520,20582,2.7
NE,1978,7,759100,738904,20196,2.7
NE,1978,8,760800,740035,20765,2.7
NE,1978,9,760794,741336,19458,2.6
NE,1978,10,761444,742266,19178,2.5
NE,1978,11,758858,740516,18342,2.4
NE,1978,12,759881,739442,20439,2.7
NE,1979,1,756025,737317,18708,2.5
NE,1979,2,758014,738894,19120,2.5
NE,1979,3,759143,740809,18334,2.4
NE,1979,4,763312,742309,21003,2.8
NE,1979,5,764373,742974,21399,2.8
NE,1979,6,766887,745993,20894,2.7
NE,1979,7,768184,746206,21978,2.9
NE,1979,8,766859,744689,22170,2.9
NE,1979,9,766231,743102,23129,3
NE,1979,10,767395,744752,22643,3
NE,1979,11,768800,746291,22509,2.9
NE,1979,12,767887,745419,22468,2.9
NE,1980,1,765091,742826,22265,2.9
NE,1980,2,765404,742969,22435,2.9
NE,1980,3,767000,742047,24953,3.3
NE,1980,4,768807,739939,28868,3.8
NE,1980,5,769781,738169,31612,4.1
NE,1980,6,770545,737242,33303,4.3
NE,1980,7,768237,735006,33231,4.3
NE,1980,8,767829,734397,33432,4.4
NE,1980,9,765826,733203,32623,4.3
NE,1980,10,766092,734420,31672,4.1
NE,1980,11,766702,735055,31647,4.1
NE,1980,12,766142,734845,31297,4.1
NE,1981,1,766445,737251,29194,3.8
NE,1981,2,768458,738993,29465,3.8
NE,1981,3,770085,740653,29432,3.8
NE,1981,4,769459,739888,29571,3.8
NE,1981,5,770552,740725,29827,3.9
NE,1981,6,772248,741741,30507,4
NE,1981,7,773531,742733,30798,4
NE,1981,8,772771,741554,31217,4
NE,1981,9,773198,741345,31853,4.1
NE,1981,10,774149,740910,33239,4.3
NE,1981,11,776064,740935,35129,4.5
NE,1981,12,775836,740093,35743,4.6
NE,1982,1,776601,738751,37850,4.9
NE,1982,2,776332,736807,39525,5.1
NE,1982,3,778953,736642,42311,5.4
NE,1982,4,780160,736862,43298,5.5
NE,1982,5,782132,736032,46100,5.9
NE,1982,6,781854,735937,45917,5.9
NE,1982,7,782118,736530,45588,5.8
NE,1982,8,783122,738453,44669,5.7
NE,1982,9,784894,739329,45565,5.8
NE,1982,10,786321,739515,46806,6
NE,1982,11,788311,740658,47653,6
NE,1982,12,789577,740304,49273,6.2
NE,1983,1,794758,740576,54182,6.8
NE,1983,2,795359,740881,54478,6.8
NE,1983,3,791788,739515,52273,6.6
NE,1983,4,791099,739843,51256,6.5
NE,1983,5,787162,740141,47021,6
NE,1983,6,783661,739900,43761,5.6
NE,1983,7,781287,740561,40726,5.2
NE,1983,8,783015,742576,40439,5.2
NE,1983,9,783366,744683,38683,4.9
NE,1983,10,781826,743650,38176,4.9
NE,1983,11,781247,743045,38202,4.9
NE,1983,12,783756,743445,40311,5.1
NE,1984,1,787387,747583,39804,5.1
NE,1984,2,785310,748455,36855,4.7
NE,1984,3,787321,751258,36063,4.6
NE,1984,4,788843,751038,37805,4.8
NE,1984,5,787495,753714,33781,4.3
NE,1984,6,788377,756111,32266,4.1
NE,1984,7,791319,758144,33175,4.2
NE,1984,8,791616,759306,32310,4.1
NE,1984,9,793939,760454,33485,4.2
NE,1984,10,795488,761638,33850,4.3
NE,1984,11,796059,761874,34185,4.3
NE,1984,12,795349,761372,33977,4.3
NE,1985,1,800049,760783,39266,4.9
NE,1985,2,801864,760140,41724,5.2
NE,1985,3,801099,759844,41255,5.1
NE,1985,4,802094,761491,40603,5.1
NE,1985,5,801574,761363,40211,5
NE,1985,6,802279,761898,40381,5
NE,1985,7,803922,762983,40939,5.1
NE,1985,8,805169,764478,40691,5.1
NE,1985,9,805277,764550,40727,5.1
NE,1985,10,806981,765628,41353,5.1
NE,1985,11,809922,766905,43017,5.3
NE,1985,12,813795,768197,45598,5.6
NE,1986,1,812821,769070,43751,5.4
NE,1986,2,813753,769439,44314,5.4
NE,1986,3,813466,770573,42893,5.3
NE,1986,4,814466,773166,41300,5.1
NE,1986,5,811901,773848,38053,4.7
NE,1986,6,810436,772625,37811,4.7
NE,1986,7,809695,771592,38103,4.7
NE,1986,8,811424,773647,37777,4.7
NE,1986,9,813750,775655,38095,4.7
NE,1986,10,815088,776255,38833,4.8
NE,1986,11,817980,776736,41244,5
NE,1986,12,817830,777539,40291,4.9
NE,1987,1,815533,777151,38382,4.7
NE,1987,2,815386,777120,38266,4.7
NE,1987,3,815684,777664,38020,4.7
NE,1987,4,809415,777400,32015,4
NE,1987,5,814299,776990,37309,4.6
NE,1987,6,813556,776208,37348,4.6
NE,1987,7,814216,777925,36291,4.5
NE,1987,8,812974,777647,35327,4.3
NE,1987,9,812537,777663,34874,4.3
NE,1987,10,812245,777965,34280,4.2
NE,1987,11,811651,778599,33052,4.1
NE,1987,12,812073,779658,32415,4
NE,1988,1,813239,780643,32596,4
NE,1988,2,814766,782681,32085,3.9
NE,1988,3,815326,784928,30398,3.7
NE,1988,4,815112,787313,27799,3.4
NE,1988,5,817843,789702,28141,3.4
NE,1988,6,820866,792661,28205,3.4
NE,1988,7,821631,793835,27796,3.4
NE,1988,8,824302,796357,27945,3.4
NE,1988,9,824328,796400,27928,3.4
NE,1988,10,824811,797603,27208,3.3
NE,1988,11,824056,797902,26154,3.2
NE,1988,12,824128,799425,24703,3
NE,1989,1,823197,799849,23348,2.8
NE,1989,2,822596,798947,23649,2.9
NE,1989,3,823199,799400,23799,2.9
NE,1989,4,823736,799663,24073,2.9
NE,1989,5,821340,798095,23245,2.8
NE,1989,6,821715,797805,23910,2.9
NE,1989,7,822207,798441,23766,2.9
NE,1989,8,823505,799453,24052,2.9
NE,1989,9,822497,798722,23775,2.9
NE,1989,10,821320,798120,23200,2.8
NE,1989,11,819605,797766,21839,2.7
NE,1989,12,820209,797823,22386,2.7
NE,1990,1,816743,797426,19317,2.4
NE,1990,2,815349,797207,18142,2.2
NE,1990,3,815152,797103,18049,2.2
NE,1990,4,816176,796416,19760,2.4
NE,1990,5,815645,797074,18571,2.3
NE,1990,6,816376,798181,18195,2.2
NE,1990,7,816500,797214,19286,2.4
NE,1990,8,815122,795396,19726,2.4
NE,1990,9,815299,795970,19329,2.4
NE,1990,10,817104,797733,19371,2.4
NE,1990,11,819630,801246,18384,2.2
NE,1990,12,821343,802622,18721,2.3
NE,1991,1,825529,804802,20727,2.5
NE,1991,2,826809,807264,19545,2.4
NE,1991,3,828005,808351,19654,2.4
NE,1991,4,830308,808865,21443,2.6
NE,1991,5,831969,810235,21734,2.6
NE,1991,6,832289,810359,21930,2.6
NE,1991,7,833267,810779,22488,2.7
NE,1991,8,835576,812235,23341,2.8
NE,1991,9,836624,813743,22881,2.7
NE,1991,10,834694,812598,22096,2.6
NE,1991,11,835306,810418,24888,3
NE,1991,12,836205,812525,23680,2.8
NE,1992,1,837766,814234,23532,2.8
NE,1992,2,838014,815635,22379,2.7
NE,1992,3,837894,814725,23169,2.8
NE,1992,4,838428,814895,23533,2.8
NE,1992,5,841637,817335,24302,2.9
NE,1992,6,843361,818371,24990,3
NE,1992,7,844515,819375,25140,3
NE,1992,8,843643,818603,25040,3
NE,1992,9,844183,819358,24825,2.9
NE,1992,10,844601,820476,24125,2.9
NE,1992,11,844128,820478,23650,2.8
NE,1992,12,844963,821492,23471,2.8
NE,1993,1,847049,822809,24240,2.9
NE,1993,2,849056,825346,23710,2.8
NE,1993,3,852759,827839,24920,2.9
NE,1993,4,856630,831300,25330,3
NE,1993,5,858179,833248,24931,2.9
NE,1993,6,860062,835724,24338,2.8
NE,1993,7,862010,837895,24115,2.8
NE,1993,8,864859,840871,23988,2.8
NE,1993,9,866911,843446,23465,2.7
NE,1993,10,870561,847146,23415,2.7
NE,1993,11,873100,850089,23011,2.6
NE,1993,12,875692,852612,23080,2.6
NE,1994,1,879074,856481,22593,2.6
NE,1994,2,883049,858481,24568,2.8
NE,1994,3,881963,857563,24400,2.8
NE,1994,4,881429,858192,23237,2.6
NE,1994,5,884349,861026,23323,2.6
NE,1994,6,884519,861053,23466,2.7
NE,1994,7,885361,862305,23056,2.6
NE,1994,8,886797,863553,23244,2.6
NE,1994,9,889213,865925,23288,2.6
NE,1994,10,890149,866829,23320,2.6
NE,1994,11,891793,869667,22126,2.5
NE,1994,12,893487,870830,22657,2.5
NE,1995,1,894239,872865,21374,2.4
NE,1995,2,896010,875956,20054,2.2
NE,1995,3,899425,878518,20907,2.3
NE,1995,4,902610,879518,23092,2.6
NE,1995,5,904710,879837,24873,2.7
NE,1995,6,905769,881210,24559,2.7
NE,1995,7,907299,882627,24672,2.7
NE,1995,8,910921,886382,24539,2.7
NE,1995,9,911656,886791,24865,2.7
NE,1995,10,914606,889073,25533,2.8
NE,1995,11,913608,888713,24895,2.7
NE,1995,12,915351,889746,25605,2.8
NE,1996,1,916376,891709,24667,2.7
NE,1996,2,917358,892146,25212,2.7
NE,1996,3,917390,892639,24751,2.7
NE,1996,4,919115,893386,25729,2.8
NE,1996,5,920424,894252,26172,2.8
NE,1996,6,921686,895077,26609,2.9
NE,1996,7,922977,895913,27064,2.9
NE,1996,8,923273,897569,25704,2.8
NE,1996,9,924344,898935,25409,2.7
NE,1996,10,924570,899282,25288,2.7
NE,1996,11,925549,900760,24789,2.7
NE,1996,12,925190,901915,23275,2.5
NE,1997,1,924531,900723,23808,2.6
NE,1997,2,922949,899994,22955,2.5
NE,1997,3,922815,901422,21393,2.3
NE,1997,4,924104,901970,22134,2.4
NE,1997,5,925303,902767,22536,2.4
NE,1997,6,925360,902428,22932,2.5
NE,1997,7,926308,903791,22517,2.4
NE,1997,8,927576,904704,22872,2.5
NE,1997,9,928626,905912,22714,2.4
NE,1997,10,929657,907781,21876,2.4
NE,1997,11,930635,909673,20962,2.3
NE,1997,12,933902,912740,21162,2.3
NE,1998,1,931659,911363,20296,2.2
NE,1998,2,932639,912499,20140,2.2
NE,1998,3,934173,912110,22063,2.4
NE,1998,4,936208,914765,21443,2.3
NE,1998,5,936823,914681,22142,2.4
NE,1998,6,939058,915827,23231,2.5
NE,1998,7,941610,916420,25190,2.7
NE,1998,8,941027,915872,25155,2.7
NE,1998,9,940351,915245,25106,2.7
NE,1998,10,940757,915192,25565,2.7
NE,1998,11,941529,915607,25922,2.8
NE,1998,12,941437,916146,25291,2.7
NE,1999,1,939774,914544,25230,2.7
NE,1999,2,937638,913538,24100,2.6
NE,1999,3,938863,913868,24995,2.7
NE,1999,4,938308,913149,25159,2.7
NE,1999,5,939390,913186,26204,2.8
NE,1999,6,940296,914133,26163,2.8
NE,1999,7,943491,917132,26359,2.8
NE,1999,8,943080,916088,26992,2.9
NE,1999,9,945208,918316,26892,2.8
NE,1999,10,945742,918714,27028,2.9
NE,1999,11,947155,920856,26299,2.8
NE,1999,12,947321,921718,25603,2.7
NE,2000,1,943880,919724,24156,2.6
NE,2000,2,945438,921096,24342,2.6
NE,2000,3,947165,922777,24388,2.6
NE,2000,4,948474,922356,26118,2.8
NE,2000,5,950003,923060,26943,2.8
NE,2000,6,951726,924303,27423,2.9
NE,2000,7,951086,923830,27256,2.9
NE,2000,8,952431,924459,27972,2.9
NE,2000,9,950821,923459,27362,2.9
NE,2000,10,951087,923239,27848,2.9
NE,2000,11,953489,924898,28591,3
NE,2000,12,951549,925180,26369,2.8
NE,2001,1,953242,927272,25970,2.7
NE,2001,2,954459,927440,27019,2.8
NE,2001,3,956180,928161,28019,2.9
NE,2001,4,956822,927784,29038,3
NE,2001,5,957446,927697,29749,3.1
NE,2001,6,957669,927254,30415,3.2
NE,2001,7,956374,925295,31079,3.2
NE,2001,8,955174,924548,30626,3.2
NE,2001,9,955306,924298,31008,3.2
NE,2001,10,956343,924143,32200,3.4
NE,2001,11,955650,923276,32374,3.4
NE,2001,12,955174,922225,32949,3.4
NE,2002,1,951417,917611,33806,3.6
NE,2002,2,954352,918972,35380,3.7
NE,2002,3,954533,919043,35490,3.7
NE,2002,4,954537,918169,36368,3.8
NE,2002,5,954748,918741,36007,3.8
NE,2002,6,956389,919897,36492,3.8
NE,2002,7,955495,919772,35723,3.7
NE,2002,8,955428,919892,35536,3.7
NE,2002,9,959154,923432,35722,3.7
NE,2002,10,959584,924385,35199,3.7
NE,2002,11,962318,926544,35774,3.7
NE,2002,12,963795,927955,35840,3.7
NE,2003,1,968222,931097,37125,3.8
NE,2003,2,968842,930726,38116,3.9
NE,2003,3,970269,930458,39811,4.1
NE,2003,4,971735,931699,40036,4.1
NE,2003,5,970406,931128,39278,4
NE,2003,6,969341,929829,39512,4.1
NE,2003,7,968540,928875,39665,4.1
NE,2003,8,970754,932077,38677,4
NE,2003,9,970383,931816,38567,4
NE,2003,10,971422,933569,37853,3.9
NE,2003,11,971369,933614,37755,3.9
NE,2003,12,972344,934571,37773,3.9
NE,2004,1,974006,935261,38745,4
NE,2004,2,973954,934432,39522,4.1
NE,2004,3,974185,935462,38723,4
NE,2004,4,975066,937953,37113,3.8
NE,2004,5,976519,938881,37638,3.9
NE,2004,6,978222,940734,37488,3.8
NE,2004,7,978466,941038,37428,3.8
NE,2004,8,978419,940126,38293,3.9
NE,2004,9,978053,939070,38983,4
NE,2004,10,976941,938742,38199,3.9
NE,2004,11,976050,938173,37877,3.9
NE,2004,12,975899,937392,38507,3.9
NE,2005,1,977657,936464,41193,4.2
NE,2005,2,977455,938115,39340,4
NE,2005,3,977355,938162,39193,4
NE,2005,4,975656,937053,38603,4
NE,2005,5,974594,936889,37705,3.9
NE,2005,6,974595,937318,37277,3.8
NE,2005,7,975564,937885,37679,3.9
NE,2005,8,974310,936686,37624,3.9
NE,2005,9,974706,938086,36620,3.8
NE,2005,10,975301,939375,35926,3.7
NE,2005,11,974516,939594,34922,3.6
NE,2005,12,976601,939935,36666,3.8
NE,2006,1,971177,940664,30513,3.1
NE,2006,2,972516,943946,28570,2.9
NE,2006,3,972024,942803,29221,3
NE,2006,4,972898,943142,29756,3.1
NE,2006,5,973212,943737,29475,3
NE,2006,6,975109,945731,29378,3
NE,2006,7,974765,944688,30077,3.1
NE,2006,8,975770,945275,30495,3.1
NE,2006,9,977489,947511,29978,3.1
NE,2006,10,977883,948014,29869,3.1
NE,2006,11,977417,948455,28962,3
NE,2006,12,978389,949488,28901,3
NE,2007,1,976316,948847,27469,2.8
NE,2007,2,978363,949787,28576,2.9
NE,2007,3,977058,950998,26060,2.7
NE,2007,4,979681,952642,27039,2.8
NE,2007,5,985465,955217,30248,3.1
NE,2007,6,986426,956222,30204,3.1
NE,2007,7,987345,957212,30133,3.1
NE,2007,8,987879,958086,29793,3
NE,2007,9,989738,959493,30245,3.1
NE,2007,10,989653,959468,30185,3.1
NE,2007,11,991348,959792,31556,3.2
NE,2007,12,986715,960377,26338,2.7
NE,2008,1,991918,962322,29596,3
NE,2008,2,991468,961467,30001,3
NE,2008,3,993123,961893,31230,3.1
NE,2008,4,994844,962394,32450,3.3
NE,2008,5,994761,963252,31509,3.2
NE,2008,6,994740,962160,32580,3.3
NE,2008,7,994572,961968,32604,3.3
NE,2008,8,996194,963016,33178,3.3
NE,2008,9,997024,962834,34190,3.4
NE,2008,10,998493,962821,35672,3.6
NE,2008,11,999107,962656,36451,3.6
NE,2008,12,1001373,962227,39146,3.9
NE,2009,1,990665,947882,42783,4.3
NV,1976,1,320088,290069,30019,9.4
NV,1976,2,321683,291737,29946,9.3
NV,1976,3,322164,292333,29831,9.3
NV,1976,4,324256,294544,29712,9.2
NV,1976,5,326104,296524,29580,9.1
NV,1976,6,328375,298932,29443,9
NV,1976,7,329984,300671,29313,8.9
NV,1976,8,331181,302033,29148,8.8
NV,1976,9,332421,303488,28933,8.7
NV,1976,10,333682,305019,28663,8.6
NV,1976,11,335113,306805,28308,8.4
NV,1976,12,337217,309369,27848,8.3
NV,1977,1,340091,312793,27298,8
NV,1977,2,342841,316163,26678,7.8
NV,1977,3,344753,318718,26035,7.6
NV,1977,4,346538,321170,25368,7.3
NV,1977,5,348255,323559,24696,7.1
NV,1977,6,350248,326228,24020,6.9
NV,1977,7,352628,329299,23329,6.6
NV,1977,8,354582,331931,22651,6.4
NV,1977,9,356196,334232,21964,6.2
NV,1977,10,357152,335882,21270,6
NV,1977,11,359748,339170,20578,5.7
NV,1977,12,361270,341375,19895,5.5
NV,1978,1,363851,344584,19267,5.3
NV,1978,2,364945,346257,18688,5.1
NV,1978,3,366672,348453,18219,5
NV,1978,4,368660,350769,17891,4.9
NV,1978,5,370822,353143,17679,4.8
NV,1978,6,372998,355439,17559,4.7
NV,1978,7,376448,358931,17517,4.7
NV,1978,8,379042,361510,17532,4.6
NV,1978,9,379080,361470,17610,4.6
NV,1978,10,381000,363306,17694,4.6
NV,1978,11,382428,364638,17790,4.7
NV,1978,12,385000,367123,17877,4.6
NV,1979,1,386873,368902,17971,4.6
NV,1979,2,389567,371447,18120,4.7
NV,1979,3,392889,374549,18340,4.7
NV,1979,4,395111,376462,18649,4.7
NV,1979,5,397674,378666,19008,4.8
NV,1979,6,400423,381042,19381,4.8
NV,1979,7,403052,383306,19746,4.9
NV,1979,8,405879,385753,20126,5
NV,1979,9,407904,387363,20541,5
NV,1979,10,411205,390200,21005,5.1
NV,1979,11,413877,392360,21517,5.2
NV,1979,12,416762,394642,22120,5.3
NV,1980,1,417740,394856,22884,5.5
NV,1980,2,420227,396465,23762,5.7
NV,1980,3,422812,398052,24760,5.9
NV,1980,4,424161,398300,25861,6.1
NV,1980,5,425574,398598,26976,6.3
NV,1980,6,427449,399426,28023,6.6
NV,1980,7,429854,400904,28950,6.7
NV,1980,8,432211,402461,29750,6.9
NV,1980,9,435491,405104,30387,7
NV,1980,10,438515,407629,30886,7
NV,1980,11,442079,410782,31297,7.1
NV,1980,12,443439,411782,31657,7.1
NV,1981,1,446034,414169,31865,7.1
NV,1981,2,448375,416307,32068,7.2
NV,1981,3,451082,418805,32277,7.2
NV,1981,4,454027,421507,32520,7.2
NV,1981,5,456665,423816,32849,7.2
NV,1981,6,458740,425443,33297,7.3
NV,1981,7,460561,426643,33918,7.4
NV,1981,8,464526,429796,34730,7.5
NV,1981,9,466756,431022,35734,7.7
NV,1981,10,468672,431766,36906,7.9
NV,1981,11,470619,432388,38231,8.1
NV,1981,12,472560,432890,39670,8.4
NV,1982,1,474912,433705,41207,8.7
NV,1982,2,476125,433417,42708,9
NV,1982,3,477744,433595,44149,9.2
NV,1982,4,478029,432507,45522,9.5
NV,1982,5,479259,432495,46764,9.8
NV,1982,6,480057,432169,47888,10
NV,1982,7,480001,431088,48913,10.2
NV,1982,8,480139,430335,49804,10.4
NV,1982,9,481244,430722,50522,10.5
NV,1982,10,481337,430262,51075,10.6
NV,1982,11,481229,429806,51423,10.7
NV,1982,12,482576,431037,51539,10.7
NV,1983,1,483357,431945,51412,10.6
NV,1983,2,483579,432495,51084,10.6
NV,1983,3,484251,433719,50532,10.4
NV,1983,4,485648,435882,49766,10.2
NV,1983,5,485238,436360,48878,10.1
NV,1983,6,486311,438419,47892,9.8
NV,1983,7,486320,439426,46894,9.6
NV,1983,8,486483,440606,45877,9.4
NV,1983,9,488373,443537,44836,9.2
NV,1983,10,489283,445474,43809,9
NV,1983,11,490061,447274,42787,8.7
NV,1983,12,491650,449861,41789,8.5
NV,1984,1,494012,453181,40831,8.3
NV,1984,2,494751,454732,40019,8.1
NV,1984,3,496364,457014,39350,7.9
NV,1984,4,497837,459002,38835,7.8
NV,1984,5,500062,461582,38480,7.7
NV,1984,6,500809,462545,38264,7.6
NV,1984,7,502139,463991,38148,7.6
NV,1984,8,503586,465465,38121,7.6
NV,1984,9,504984,466845,38139,7.6
NV,1984,10,506192,468006,38186,7.5
NV,1984,11,507267,468985,38282,7.5
NV,1984,12,508152,469731,38421,7.6
NV,1985,1,509832,471237,38595,7.6
NV,1985,2,510782,472036,38746,7.6
NV,1985,3,512049,473199,38850,7.6
NV,1985,4,513235,474331,38904,7.6
NV,1985,5,514308,475405,38903,7.6
NV,1985,6,515126,476280,38846,7.5
NV,1985,7,516668,477955,38713,7.5
NV,1985,8,517842,479299,38543,7.4
NV,1985,9,518477,480134,38343,7.4
NV,1985,10,519730,481641,38089,7.3
NV,1985,11,520448,482674,37774,7.3
NV,1985,12,522220,484856,37364,7.2
NV,1986,1,523898,487016,36882,7
NV,1986,2,526320,489901,36419,6.9
NV,1986,3,527956,491919,36037,6.8
NV,1986,4,529806,494123,35683,6.7
NV,1986,5,531964,496601,35363,6.6
NV,1986,6,532965,497866,35099,6.6
NV,1986,7,534985,500089,34896,6.5
NV,1986,8,536772,502028,34744,6.5
NV,1986,9,538520,503877,34643,6.4
NV,1986,10,540212,505635,34577,6.4
NV,1986,11,541808,507277,34531,6.4
NV,1986,12,543825,509317,34508,6.3
NV,1987,1,545711,511190,34521,6.3
NV,1987,2,547611,513093,34518,6.3
NV,1987,3,548713,514219,34494,6.3
NV,1987,4,550577,516126,34451,6.3
NV,1987,5,552544,518162,34382,6.2
NV,1987,6,554596,520320,34276,6.2
NV,1987,7,556451,522310,34141,6.1
NV,1987,8,558017,524055,33962,6.1
NV,1987,9,559779,526050,33729,6
NV,1987,10,560941,527508,33433,6
NV,1987,11,563765,530680,33085,5.9
NV,1987,12,566182,533482,32700,5.8
NV,1988,1,568300,536001,32299,5.7
NV,1988,2,570247,538323,31924,5.6
NV,1988,3,572209,540624,31585,5.5
NV,1988,4,574801,543521,31280,5.4
NV,1988,5,577071,546066,31005,5.4
NV,1988,6,579283,548548,30735,5.3
NV,1988,7,581622,551159,30463,5.2
NV,1988,8,583750,553537,30213,5.2
NV,1988,9,586178,556209,29969,5.1
NV,1988,10,588818,559095,29723,5
NV,1988,11,590773,561272,29501,5
NV,1988,12,592064,562753,29311,5
NV,1989,1,593182,564007,29175,4.9
NV,1989,2,595369,566320,29049,4.9
NV,1989,3,598507,569584,28923,4.8
NV,1989,4,601368,572519,28849,4.8
NV,1989,5,603576,574769,28807,4.8
NV,1989,6,606590,577795,28795,4.7
NV,1989,7,609206,580388,28818,4.7
NV,1989,8,612353,583463,28890,4.7
NV,1989,9,615600,586574,29026,4.7
NV,1989,10,619404,590223,29181,4.7
NV,1989,11,623058,593698,29360,4.7
NV,1989,12,628546,598960,29586,4.7
NV,1990,1,633747,603863,29884,4.7
NV,1990,2,637608,607307,30301,4.8
NV,1990,3,641855,611052,30803,4.8
NV,1990,4,645595,614229,31366,4.9
NV,1990,5,649552,617575,31977,4.9
NV,1990,6,654326,621689,32637,5
NV,1990,7,659689,626321,33368,5.1
NV,1990,8,663318,629120,34198,5.2
NV,1990,9,666161,631073,35088,5.3
NV,1990,10,669706,633687,36019,5.4
NV,1990,11,673526,636557,36969,5.5
NV,1990,12,675662,637713,37949,5.6
NV,1991,1,678390,639442,38948,5.7
NV,1991,2,681529,641571,39958,5.9
NV,1991,3,683802,642889,40913,6
NV,1991,4,686483,644736,41747,6.1
NV,1991,5,689835,647364,42471,6.2
NV,1991,6,693381,650253,43128,6.2
NV,1991,7,694782,651013,43769,6.3
NV,1991,8,697815,653397,44418,6.4
NV,1991,9,700919,655814,45105,6.4
NV,1991,10,703425,657573,45852,6.5
NV,1991,11,705001,658343,46658,6.6
NV,1991,12,708979,661492,47487,6.7
NV,1992,1,711547,663220,48327,6.8
NV,1992,2,714475,665437,49038,6.9
NV,1992,3,717312,667721,49591,6.9
NV,1992,4,720603,670575,50028,6.9
NV,1992,5,723966,673572,50394,7
NV,1992,6,725188,674470,50718,7
NV,1992,7,728841,677874,50967,7
NV,1992,8,731620,680486,51134,7
NV,1992,9,735673,684421,51252,7
NV,1992,10,737366,686019,51347,7
NV,1992,11,741325,689889,51436,6.9
NV,1992,12,742779,691223,51556,6.9
NV,1993,1,746166,694471,51695,6.9
NV,1993,2,749100,697274,51826,6.9
NV,1993,3,752428,700473,51955,6.9
NV,1993,4,755921,703877,52044,6.9
NV,1993,5,759273,707183,52090,6.9
NV,1993,6,764016,711925,52091,6.8
NV,1993,7,766395,714345,52050,6.8
NV,1993,8,770178,718203,51975,6.7
NV,1993,9,773265,721399,51866,6.7
NV,1993,10,780280,728540,51740,6.6
NV,1993,11,784054,732457,51597,6.6
NV,1993,12,789697,738238,51459,6.5
NV,1994,1,794858,743551,51307,6.5
NV,1994,2,798958,747843,51115,6.4
NV,1994,3,802234,751371,50863,6.3
NV,1994,4,806269,755701,50568,6.3
NV,1994,5,809309,759060,50249,6.2
NV,1994,6,812074,762154,49920,6.1
NV,1994,7,816256,766662,49594,6.1
NV,1994,8,819938,770644,49294,6
NV,1994,9,823412,774420,48992,5.9
NV,1994,10,825658,776946,48712,5.9
NV,1994,11,829264,780823,48441,5.8
NV,1994,12,832420,784236,48184,5.8
NV,1995,1,833806,785845,47961,5.8
NV,1995,2,837378,789608,47770,5.7
NV,1995,3,841801,794200,47601,5.7
NV,1995,4,843958,796487,47471,5.6
NV,1995,5,846917,799549,47368,5.6
NV,1995,6,850980,803714,47266,5.6
NV,1995,7,854536,807350,47186,5.5
NV,1995,8,857880,810766,47114,5.5
NV,1995,9,861766,814705,47061,5.5
NV,1995,10,864521,817476,47045,5.4
NV,1995,11,867730,820661,47069,5.4
NV,1995,12,870190,823072,47118,5.4
NV,1996,1,874088,826877,47211,5.4
NV,1996,2,877797,830529,47268,5.4
NV,1996,3,880593,833309,47284,5.4
NV,1996,4,884591,837371,47220,5.3
NV,1996,5,887503,840420,47083,5.3
NV,1996,6,891166,844305,46861,5.3
NV,1996,7,895332,848772,46560,5.2
NV,1996,8,898672,852487,46185,5.1
NV,1996,9,902447,856707,45740,5.1
NV,1996,10,905607,860386,45221,5
NV,1996,11,911116,866461,44655,4.9
NV,1996,12,913758,869661,44097,4.8
NV,1997,1,918061,874540,43521,4.7
NV,1997,2,921895,878860,43035,4.7
NV,1997,3,925015,882366,42649,4.6
NV,1997,4,927213,884839,42374,4.6
NV,1997,5,931314,889125,42189,4.5
NV,1997,6,935286,893185,42101,4.5
NV,1997,7,939542,897454,42088,4.5
NV,1997,8,943004,900868,42136,4.5
NV,1997,9,947117,904854,42263,4.5
NV,1997,10,951106,908658,42448,4.5
NV,1997,11,954773,912075,42698,4.5
NV,1997,12,959312,916273,43039,4.5
NV,1998,1,960878,917445,43433,4.5
NV,1998,2,964844,921107,43737,4.5
NV,1998,3,968420,924494,43926,4.5
NV,1998,4,972887,928894,43993,4.5
NV,1998,5,976781,932822,43959,4.5
NV,1998,6,981366,937529,43837,4.5
NV,1998,7,984576,940951,43625,4.4
NV,1998,8,987600,944235,43365,4.4
NV,1998,9,991023,947947,43076,4.3
NV,1998,10,995808,952989,42819,4.3
NV,1998,11,999085,956478,42607,4.3
NV,1998,12,1001507,959046,42461,4.2
NV,1999,1,1004727,962341,42386,4.2
NV,1999,2,1007602,965144,42458,4.2
NV,1999,3,1011716,969071,42645,4.2
NV,1999,4,1015274,972338,42936,4.2
NV,1999,5,1017630,974361,43269,4.3
NV,1999,6,1020695,977106,43589,4.3
NV,1999,7,1023374,979500,43874,4.3
NV,1999,8,1026034,981934,44100,4.3
NV,1999,9,1029413,985135,44278,4.3
NV,1999,10,1034573,990141,44432,4.3
NV,1999,11,1038084,993487,44597,4.3
NV,1999,12,1041882,997064,44818,4.3
NV,2000,1,1043674,998973,44701,4.3
NV,2000,2,1046492,1001498,44994,4.3
NV,2000,3,1049311,1003966,45345,4.3
NV,2000,4,1053048,1007300,45748,4.3
NV,2000,5,1058010,1011783,46227,4.4
NV,2000,6,1060579,1013779,46800,4.4
NV,2000,7,1064513,1017051,47462,4.5
NV,2000,8,1069650,1021425,48225,4.5
NV,2000,9,1073016,1023919,49097,4.6
NV,2000,10,1074963,1024947,50016,4.7
NV,2000,11,1078809,1027851,50958,4.7
NV,2000,12,1082074,1030159,51915,4.8
NV,2001,1,1087156,1034232,52924,4.9
NV,2001,2,1090860,1036866,53994,4.9
NV,2001,3,1093386,1038291,55095,5
NV,2001,4,1094617,1038394,56223,5.1
NV,2001,5,1097613,1040279,57334,5.2
NV,2001,6,1101225,1042772,58453,5.3
NV,2001,7,1102704,1043133,59571,5.4
NV,2001,8,1104996,1044346,60650,5.5
NV,2001,9,1107182,1045527,61655,5.6
NV,2001,10,1109358,1046769,62589,5.6
NV,2001,11,1110963,1047532,63431,5.7
NV,2001,12,1112173,1048040,64133,5.8
NV,2002,1,1122060,1056942,65118,5.8
NV,2002,2,1123547,1058220,65327,5.8
NV,2002,3,1125791,1060467,65324,5.8
NV,2002,4,1127697,1062541,65156,5.8
NV,2002,5,1129331,1064429,64902,5.7
NV,2002,6,1129808,1065205,64603,5.7
NV,2002,7,1131286,1067002,64284,5.7
NV,2002,8,1133000,1069065,63935,5.6
NV,2002,9,1134071,1070452,63619,5.6
NV,2002,10,1136108,1072747,63361,5.6
NV,2002,11,1137530,1074398,63132,5.5
NV,2002,12,1139132,1076254,62878,5.5
NV,2003,1,1143305,1080869,62436,5.5
NV,2003,2,1145713,1083556,62157,5.4
NV,2003,3,1146631,1084735,61896,5.4
NV,2003,4,1146554,1084942,61612,5.4
NV,2003,5,1149321,1088028,61293,5.3
NV,2003,6,1150768,1089835,60933,5.3
NV,2003,7,1153824,1093320,60504,5.2
NV,2003,8,1157206,1097209,59997,5.2
NV,2003,9,1159670,1100223,59447,5.1
NV,2003,10,1162612,1103772,58840,5.1
NV,2003,11,1164243,1106044,58199,5
NV,2003,12,1167072,1109552,57520,4.9
NV,2004,1,1166944,1110736,56208,4.8
NV,2004,2,1167194,1112224,54970,4.7
NV,2004,3,1169280,1115542,53738,4.6
NV,2004,4,1173146,1120541,52605,4.5
NV,2004,5,1174421,1122774,51647,4.4
NV,2004,6,1177309,1126260,51049,4.3
NV,2004,7,1180578,1130017,50561,4.3
NV,2004,8,1182399,1132321,50078,4.2
NV,2004,9,1186254,1136258,49996,4.2
NV,2004,10,1191985,1141623,50362,4.2
NV,2004,11,1195138,1143793,51345,4.3
NV,2004,12,1199116,1146588,52528,4.4
NV,2005,1,1201671,1148093,53578,4.5
NV,2005,2,1205938,1151586,54352,4.5
NV,2005,3,1211097,1156111,54986,4.5
NV,2005,4,1217871,1162466,55405,4.5
NV,2005,5,1219917,1164273,55644,4.6
NV,2005,6,1223749,1167948,55801,4.6
NV,2005,7,1228150,1172294,55856,4.5
NV,2005,8,1231139,1175420,55719,4.5
NV,2005,9,1235897,1180746,55151,4.5
NV,2005,10,1238127,1183752,54375,4.4
NV,2005,11,1242067,1188449,53618,4.3
NV,2005,12,1246104,1193270,52834,4.2
NV,2006,1,1251060,1198404,52656,4.2
NV,2006,2,1257058,1204028,53030,4.2
NV,2006,3,1262432,1208837,53595,4.2
NV,2006,4,1266729,1212484,54245,4.3
NV,2006,5,1272199,1217490,54709,4.3
NV,2006,6,1277657,1222468,55189,4.3
NV,2006,7,1280389,1224970,55419,4.3
NV,2006,8,1284373,1228903,55470,4.3
NV,2006,9,1288554,1232801,55753,4.3
NV,2006,10,1291074,1234799,56275,4.4
NV,2006,11,1295589,1238862,56727,4.4
NV,2006,12,1299240,1242146,57094,4.4
NV,2007,1,1302645,1245397,57248,4.4
NV,2007,2,1307462,1250118,57344,4.4
NV,2007,3,1310702,1253085,57617,4.4
NV,2007,4,1313021,1254647,58374,4.4
NV,2007,5,1317550,1257980,59570,4.5
NV,2007,6,1320911,1260065,60846,4.6
NV,2007,7,1323471,1261070,62401,4.7
NV,2007,8,1327276,1263209,64067,4.8
NV,2007,9,1330159,1264486,65673,4.9
NV,2007,10,1335026,1267981,67045,5
NV,2007,11,1339783,1271430,68353,5.1
NV,2007,12,1343710,1273843,69867,5.2
NV,2008,1,1346619,1274958,71661,5.3
NV,2008,2,1349138,1275419,73719,5.5
NV,2008,3,1352855,1276624,76231,5.6
NV,2008,4,1358083,1278824,79259,5.8
NV,2008,5,1363718,1280795,82923,6.1
NV,2008,6,1368658,1281663,86995,6.4
NV,2008,7,1374762,1283337,91425,6.7
NV,2008,8,1380679,1284355,96324,7
NV,2008,9,1387047,1285558,101489,7.3
NV,2008,10,1393529,1286652,106877,7.7
NV,2008,11,1399659,1287254,112405,8
NV,2008,12,1406796,1288705,118091,8.4
NV,2009,1,1403244,1270856,132388,9.4
NH,1976,1,388420,361156,27264,7
NH,1976,2,389729,362782,26947,6.9
NH,1976,3,391529,364453,27076,6.9
NH,1976,4,393252,366165,27087,6.9
NH,1976,5,394898,367931,26967,6.8
NH,1976,6,396316,369746,26570,6.7
NH,1976,7,397897,371605,26292,6.6
NH,1976,8,399908,373449,26459,6.6
NH,1976,9,401430,375287,26143,6.5
NH,1976,10,403026,377181,25845,6.4
NH,1976,11,404607,379124,25483,6.3
NH,1976,12,406906,381167,25739,6.3
NH,1977,1,409407,383362,26045,6.4
NH,1977,2,411844,385595,26249,6.4
NH,1977,3,413877,387848,26029,6.3
NH,1977,4,415765,390143,25622,6.2
NH,1977,5,417411,392427,24984,6
NH,1977,6,418560,394690,23870,5.7
NH,1977,7,420057,396924,23133,5.5
NH,1977,8,421623,399108,22515,5.3
NH,1977,9,423050,401249,21801,5.2
NH,1977,10,424003,403319,20684,4.9
NH,1977,11,425177,405356,19821,4.7
NH,1977,12,426910,407343,19567,4.6
NH,1978,1,428249,409278,18971,4.4
NH,1978,2,429838,411272,18566,4.3
NH,1978,3,431473,413335,18138,4.2
NH,1978,4,433178,415426,17752,4.1
NH,1978,5,434854,417489,17365,4
NH,1978,6,436125,419502,16623,3.8
NH,1978,7,438098,421455,16643,3.8
NH,1978,8,439401,423377,16024,3.6
NH,1978,9,440881,425274,15607,3.5
NH,1978,10,442169,427142,15027,3.4
NH,1978,11,443574,428997,14577,3.3
NH,1978,12,445052,430854,14198,3.2
NH,1979,1,446995,432705,14290,3.2
NH,1979,2,448826,434393,14433,3.2
NH,1979,3,450338,435922,14416,3.2
NH,1979,4,451215,437292,13923,3.1
NH,1979,5,451942,438489,13453,3
NH,1979,6,452798,439510,13288,2.9
NH,1979,7,453902,440348,13554,3
NH,1979,8,455488,441105,14383,3.2
NH,1979,9,456891,441771,15120,3.3
NH,1979,10,458052,442334,15718,3.4
NH,1979,11,458867,442775,16092,3.5
NH,1979,12,459448,443066,16382,3.6
NH,1980,1,460442,443186,17256,3.7
NH,1980,2,461750,443333,18417,4
NH,1980,3,462724,443487,19237,4.2
NH,1980,4,463852,443622,20230,4.4
NH,1980,5,465077,443813,21264,4.6
NH,1980,6,466291,444080,22211,4.8
NH,1980,7,467327,444470,22857,4.9
NH,1980,8,468384,445003,23381,5
NH,1980,9,469583,445696,23887,5.1
NH,1980,10,470009,446571,23438,5
NH,1980,11,470199,447564,22635,4.8
NH,1980,12,471614,448644,22970,4.9
NH,1981,1,472760,449798,22962,4.9
NH,1981,2,473648,450854,22794,4.8
NH,1981,3,475150,451801,23349,4.9
NH,1981,4,476299,452666,23633,5
NH,1981,5,476994,453422,23572,4.9
NH,1981,6,477544,454076,23468,4.9
NH,1981,7,478730,454621,24109,5
NH,1981,8,480394,455023,25371,5.3
NH,1981,9,481402,455277,26125,5.4
NH,1981,10,482540,455403,27137,5.6
NH,1981,11,483898,455410,28488,5.9
NH,1981,12,484868,455329,29539,6.1
NH,1982,1,485855,455167,30688,6.3
NH,1982,2,487235,455031,32204,6.6
NH,1982,3,487970,454927,33043,6.8
NH,1982,4,489054,454863,34191,7
NH,1982,5,489663,454933,34730,7.1
NH,1982,6,490174,455134,35040,7.1
NH,1982,7,490468,455453,35015,7.1
NH,1982,8,490786,455844,34942,7.1
NH,1982,9,491239,456286,34953,7.1
NH,1982,10,491796,456801,34995,7.1
NH,1982,11,492585,457486,35099,7.1
NH,1982,12,492909,458384,34525,7
NH,1983,1,492941,459516,33425,6.8
NH,1983,2,493734,460935,32799,6.6
NH,1983,3,494337,462631,31706,6.4
NH,1983,4,494875,464580,30295,6.1
NH,1983,5,495809,466728,29081,5.9
NH,1983,6,497547,469032,28515,5.7
NH,1983,7,498787,471480,27307,5.5
NH,1983,8,499829,474051,25778,5.2
NH,1983,9,502355,476750,25605,5.1
NH,1983,10,504605,479526,25079,5
NH,1983,11,507029,482370,24659,4.9
NH,1983,12,509329,485328,24001,4.7
NH,1984,1,511542,488426,23116,4.5
NH,1984,2,514100,491398,22702,4.4
NH,1984,3,516569,494223,22346,4.3
NH,1984,4,518867,496902,21965,4.2
NH,1984,5,521325,499411,21914,4.2
NH,1984,6,523593,501836,21757,4.2
NH,1984,7,526321,504152,22169,4.2
NH,1984,8,528566,506311,22255,4.2
NH,1984,9,531077,508296,22781,4.3
NH,1984,10,533207,510131,23076,4.3
NH,1984,11,535357,511847,23510,4.4
NH,1984,12,536950,513436,23514,4.4
NH,1985,1,538215,514887,23328,4.3
NH,1985,2,539348,516384,22964,4.3
NH,1985,3,540614,517970,22644,4.2
NH,1985,4,541615,519636,21979,4.1
NH,1985,5,542170,521352,20818,3.8
NH,1985,6,543836,523096,20740,3.8
NH,1985,7,544996,524869,20127,3.7
NH,1985,8,546051,526712,19339,3.5
NH,1985,9,547535,528645,18890,3.5
NH,1985,10,549180,530686,18494,3.4
NH,1985,11,550957,532778,18179,3.3
NH,1985,12,552820,534889,17931,3.2
NH,1986,1,554521,537006,17515,3.2
NH,1986,2,556413,539084,17329,3.1
NH,1986,3,558072,541115,16957,3
NH,1986,4,559409,543127,16282,2.9
NH,1986,5,560710,545133,15577,2.8
NH,1986,6,561458,547102,14356,2.6
NH,1986,7,562447,549029,13418,2.4
NH,1986,8,563603,550936,12667,2.2
NH,1986,9,563451,552800,10651,1.9
NH,1986,10,565733,554661,11072,2
NH,1986,11,568252,556549,11703,2.1
NH,1986,12,570886,558475,12411,2.2
NH,1987,1,572765,560423,12342,2.2
NH,1987,2,574652,562315,12337,2.1
NH,1987,3,576049,564152,11897,2.1
NH,1987,4,576713,565927,10786,1.9
NH,1987,5,580052,567629,12423,2.1
NH,1987,6,582474,569252,13222,2.3
NH,1987,7,584667,570813,13854,2.4
NH,1987,8,586220,572200,14020,2.4
NH,1987,9,587843,573477,14366,2.4
NH,1987,10,589374,574731,14643,2.5
NH,1987,11,590675,575951,14724,2.5
NH,1987,12,591514,577110,14404,2.4
NH,1988,1,592013,578167,13846,2.3
NH,1988,2,592687,579168,13519,2.3
NH,1988,3,593322,580112,13210,2.2
NH,1988,4,594929,581012,13917,2.3
NH,1988,5,595742,581868,13874,2.3
NH,1988,6,597133,582710,14423,2.4
NH,1988,7,598715,583505,15210,2.5
NH,1988,8,599840,584269,15571,2.6
NH,1988,9,600825,584998,15827,2.6
NH,1988,10,601202,585649,15553,2.6
NH,1988,11,601737,586203,15534,2.6
NH,1988,12,602095,586624,15471,2.6
NH,1989,1,602802,586889,15913,2.6
NH,1989,2,602997,587070,15927,2.6
NH,1989,3,604011,587181,16830,2.8
NH,1989,4,605281,587229,18052,3
NH,1989,5,607000,587304,19696,3.2
NH,1989,6,608493,587414,21079,3.5
NH,1989,7,609547,587517,22030,3.6
NH,1989,8,611182,587655,23527,3.8
NH,1989,9,612564,587825,24739,4
NH,1989,10,613673,588020,25653,4.2
NH,1989,11,615049,588253,26796,4.4
NH,1989,12,616392,588507,27885,4.5
NH,1990,1,617650,588737,28913,4.7
NH,1990,2,618951,588735,30216,4.9
NH,1990,3,619988,588507,31481,5.1
NH,1990,4,620475,588049,32426,5.2
NH,1990,5,621337,587394,33943,5.5
NH,1990,6,621575,586548,35027,5.6
NH,1990,7,621138,585538,35600,5.7
NH,1990,8,620746,584403,36343,5.9
NH,1990,9,620415,583095,37320,6
NH,1990,10,619794,581549,38245,6.2
NH,1990,11,619676,579833,39843,6.4
NH,1990,12,618706,578000,40706,6.6
NH,1991,1,617957,576091,41866,6.8
NH,1991,2,616840,574288,42552,6.9
NH,1991,3,616168,572632,43536,7.1
NH,1991,4,615424,571149,44275,7.2
NH,1991,5,614683,569883,44800,7.3
NH,1991,6,613914,568827,45087,7.3
NH,1991,7,613345,568001,45344,7.4
NH,1991,8,613170,567431,45739,7.5
NH,1991,9,612781,567049,45732,7.5
NH,1991,10,612693,566822,45871,7.5
NH,1991,11,612980,566680,46300,7.6
NH,1991,12,613468,566600,46868,7.6
NH,1992,1,613535,566619,46916,7.6
NH,1992,2,613679,566735,46944,7.6
NH,1992,3,614241,566965,47276,7.7
NH,1992,4,614917,567306,47611,7.7
NH,1992,5,615151,567703,47448,7.7
NH,1992,6,615274,568124,47150,7.7
NH,1992,7,615362,568615,46747,7.6
NH,1992,8,615972,569231,46741,7.6
NH,1992,9,616614,570018,46596,7.6
NH,1992,10,617199,570928,46271,7.5
NH,1992,11,617699,571856,45843,7.4
NH,1992,12,618138,572812,45326,7.3
NH,1993,1,618667,573808,44859,7.3
NH,1993,2,618856,574841,44015,7.1
NH,1993,3,618788,575908,42880,6.9
NH,1993,4,618300,577048,41252,6.7
NH,1993,5,617862,578222,39640,6.4
NH,1993,6,618354,579423,38931,6.3
NH,1993,7,618786,580674,38112,6.2
NH,1993,8,619460,581907,37553,6.1
NH,1993,9,620002,583120,36882,5.9
NH,1993,10,620626,584313,36313,5.9
NH,1993,11,620742,585547,35195,5.7
NH,1993,12,621244,586834,34410,5.5
NH,1994,1,621682,588167,33515,5.4
NH,1994,2,622269,589493,32776,5.3
NH,1994,3,622522,590811,31711,5.1
NH,1994,4,623172,592104,31068,5
NH,1994,5,623636,593358,30278,4.9
NH,1994,6,624229,594608,29621,4.7
NH,1994,7,624857,595835,29022,4.6
NH,1994,8,625318,597000,28318,4.5
NH,1994,9,625459,598071,27388,4.4
NH,1994,10,626511,599047,27464,4.4
NH,1994,11,627118,599952,27166,4.3
NH,1994,12,628018,600771,27247,4.3
NH,1995,1,628460,601516,26944,4.3
NH,1995,2,628862,602282,26580,4.2
NH,1995,3,629539,603064,26475,4.2
NH,1995,4,629508,603836,25672,4.1
NH,1995,5,629689,604605,25084,4
NH,1995,6,630192,605398,24794,3.9
NH,1995,7,631199,606209,24990,4
NH,1995,8,631906,607078,24828,3.9
NH,1995,9,632820,607977,24843,3.9
NH,1995,10,632992,608871,24121,3.8
NH,1995,11,633224,609733,23491,3.7
NH,1995,12,634214,610581,23633,3.7
NH,1996,1,635441,611420,24021,3.8
NH,1996,2,636568,612322,24246,3.8
NH,1996,3,637488,613282,24206,3.8
NH,1996,4,638362,614302,24060,3.8
NH,1996,5,639727,615408,24319,3.8
NH,1996,6,640774,616600,24174,3.8
NH,1996,7,641690,617856,23834,3.7
NH,1996,8,642835,619176,23659,3.7
NH,1996,9,644429,620549,23880,3.7
NH,1996,10,645289,621996,23293,3.6
NH,1996,11,645824,623526,22298,3.5
NH,1996,12,646531,625114,21417,3.3
NH,1997,1,647777,626776,21001,3.2
NH,1997,2,648967,628422,20545,3.2
NH,1997,3,649423,630072,19351,3
NH,1997,4,652260,631731,20529,3.1
NH,1997,5,654345,633389,20956,3.2
NH,1997,6,656188,634987,21201,3.2
NH,1997,7,657577,636529,21048,3.2
NH,1997,8,658775,638008,20767,3.2
NH,1997,9,660251,639433,20818,3.2
NH,1997,10,661477,640798,20679,3.1
NH,1997,11,662723,642108,20615,3.1
NH,1997,12,663365,643375,19990,3
NH,1998,1,664278,644610,19668,3
NH,1998,2,665318,645838,19480,2.9
NH,1998,3,666576,647041,19535,2.9
NH,1998,4,667523,648209,19314,2.9
NH,1998,5,668658,649372,19286,2.9
NH,1998,6,669383,650540,18843,2.8
NH,1998,7,670091,651746,18345,2.7
NH,1998,8,671159,652977,18182,2.7
NH,1998,9,673332,654255,19077,2.8
NH,1998,10,675371,655592,19779,2.9
NH,1998,11,677036,656968,20068,3
NH,1998,12,677991,658355,19636,2.9
NH,1999,1,679385,659735,19650,2.9
NH,1999,2,680836,661065,19771,2.9
NH,1999,3,681813,662332,19481,2.9
NH,1999,4,682442,663550,18892,2.8
NH,1999,5,683622,664677,18945,2.8
NH,1999,6,684594,665765,18829,2.8
NH,1999,7,685146,666815,18331,2.7
NH,1999,8,685753,667824,17929,2.6
NH,1999,9,686771,668804,17967,2.6
NH,1999,10,688571,669780,18791,2.7
NH,1999,11,689688,670737,18951,2.7
NH,1999,12,690219,671703,18516,2.7
NH,2000,1,689948,671048,18900,2.7
NH,2000,2,690534,671909,18625,2.7
NH,2000,3,691006,672776,18230,2.6
NH,2000,4,692445,673628,18817,2.7
NH,2000,5,693583,674446,19137,2.8
NH,2000,6,694460,675237,19223,2.8
NH,2000,7,695100,675994,19106,2.7
NH,2000,8,695364,676737,18627,2.7
NH,2000,9,695674,677518,18156,2.6
NH,2000,10,696698,678305,18393,2.6
NH,2000,11,697186,679088,18098,2.6
NH,2000,12,699047,679804,19243,2.8
NH,2001,1,700076,680423,19653,2.8
NH,2001,2,701135,680850,20285,2.9
NH,2001,3,702098,681079,21019,3
NH,2001,4,703083,681152,21931,3.1
NH,2001,5,703042,681128,21914,3.1
NH,2001,6,704300,680997,23303,3.3
NH,2001,7,705758,680787,24971,3.5
NH,2001,8,706786,680598,26188,3.7
NH,2001,9,707336,680445,26891,3.8
NH,2001,10,707551,680344,27207,3.8
NH,2001,11,708675,680310,28365,4
NH,2001,12,709047,680352,28695,4
NH,2002,1,708362,678566,29796,4.2
NH,2002,2,709093,678735,30358,4.3
NH,2002,3,710166,678941,31225,4.4
NH,2002,4,711037,679163,31874,4.5
NH,2002,5,712000,679402,32598,4.6
NH,2002,6,712493,679656,32837,4.6
NH,2002,7,712657,679926,32731,4.6
NH,2002,8,713603,680190,33413,4.7
NH,2002,9,713769,680445,33324,4.7
NH,2002,10,714266,680683,33583,4.7
NH,2002,11,714358,680929,33429,4.7
NH,2002,12,714365,681183,33182,4.6
NH,2003,1,709386,677014,32372,4.6
NH,2003,2,708743,677218,31525,4.4
NH,2003,3,709424,677492,31932,4.5
NH,2003,4,709842,677847,31995,4.5
NH,2003,5,709968,678307,31661,4.5
NH,2003,6,710604,678851,31753,4.5
NH,2003,7,711574,679448,32126,4.5
NH,2003,8,712085,680072,32013,4.5
NH,2003,9,712438,680687,31751,4.5
NH,2003,10,712623,681352,31271,4.4
NH,2003,11,713022,682031,30991,4.3
NH,2003,12,713073,682722,30351,4.3
NH,2004,1,713178,683223,29955,4.2
NH,2004,2,713636,684059,29577,4.1
NH,2004,3,714097,684955,29142,4.1
NH,2004,4,714580,685848,28732,4
NH,2004,5,715006,686726,28280,4
NH,2004,6,715474,687576,27898,3.9
NH,2004,7,715951,688416,27535,3.8
NH,2004,8,716130,689218,26912,3.8
NH,2004,9,716415,689990,26425,3.7
NH,2004,10,716779,690729,26050,3.6
NH,2004,11,717280,691425,25855,3.6
NH,2004,12,718143,692101,26042,3.6
NH,2005,1,719265,692778,26487,3.7
NH,2005,2,720323,693455,26868,3.7
NH,2005,3,720770,694183,26587,3.7
NH,2005,4,721000,694982,26018,3.6
NH,2005,5,722019,695774,26245,3.6
NH,2005,6,722877,696578,26299,3.6
NH,2005,7,723692,697418,26274,3.6
NH,2005,8,724642,698268,26374,3.6
NH,2005,9,725713,699148,26565,3.7
NH,2005,10,726492,700026,26466,3.6
NH,2005,11,726788,700946,25842,3.6
NH,2005,12,727246,701890,25356,3.5
NH,2006,1,728073,702834,25239,3.5
NH,2006,2,729010,703773,25237,3.5
NH,2006,3,729841,704693,25148,3.4
NH,2006,4,730514,705570,24944,3.4
NH,2006,5,731560,706352,25208,3.4
NH,2006,6,732687,707097,25590,3.5
NH,2006,7,733810,707777,26033,3.5
NH,2006,8,734265,708403,25862,3.5
NH,2006,9,734747,708995,25752,3.5
NH,2006,10,735767,709534,26233,3.6
NH,2006,11,736624,710027,26597,3.6
NH,2006,12,737157,710493,26664,3.6
NH,2007,1,737946,710901,27045,3.7
NH,2007,2,738443,711280,27163,3.7
NH,2007,3,738827,711599,27228,3.7
NH,2007,4,738880,711872,27008,3.7
NH,2007,5,738494,712166,26328,3.6
NH,2007,6,738553,712417,26136,3.5
NH,2007,7,738194,712595,25599,3.5
NH,2007,8,737837,712708,25129,3.4
NH,2007,9,737550,712781,24769,3.4
NH,2007,10,737473,712820,24653,3.3
NH,2007,11,738016,712833,25183,3.4
NH,2007,12,738331,712801,25530,3.5
NH,2008,1,738847,712680,26167,3.5
NH,2008,2,739534,712478,27056,3.7
NH,2008,3,739633,712222,27411,3.7
NH,2008,4,739455,711927,27528,3.7
NH,2008,5,738886,711594,27292,3.7
NH,2008,6,738679,711201,27478,3.7
NH,2008,7,738531,710754,27777,3.8
NH,2008,8,738766,710257,28509,3.9
NH,2008,9,738462,709672,28790,3.9
NH,2008,10,738173,709010,29163,4
NH,2008,11,738462,708252,30210,4.1
NH,2008,12,738866,707429,31437,4.3
NH,2009,1,739759,701702,38057,5.1
NJ,1976,1,3276867,2932163,344704,10.5
NJ,1976,2,3273925,2938212,335713,10.3
NJ,1976,3,3285667,2944942,340725,10.4
NJ,1976,4,3294278,2950529,343749,10.4
NJ,1976,5,3296923,2953564,343359,10.4
NJ,1976,6,3298924,2953481,345443,10.5
NJ,1976,7,3309193,2963863,345330,10.4
NJ,1976,8,3321233,2973610,347623,10.5
NJ,1976,9,3328955,2978355,350600,10.5
NJ,1976,10,3336228,2982368,353860,10.6
NJ,1976,11,3346515,2992451,354064,10.6
NJ,1976,12,3350104,2999173,350931,10.5
NJ,1977,1,3363531,3005523,358008,10.6
NJ,1977,2,3373071,3014834,358237,10.6
NJ,1977,3,3370655,3027244,343411,10.2
NJ,1977,4,3376082,3040557,335525,9.9
NJ,1977,5,3376989,3054392,322597,9.6
NJ,1977,6,3380086,3065329,314757,9.3
NJ,1977,7,3377892,3073847,304045,9
NJ,1977,8,3380555,3081197,299358,8.9
NJ,1977,9,3394574,3095604,298970,8.8
NJ,1977,10,3396641,3105369,291272,8.6
NJ,1977,11,3403471,3117310,286161,8.4
NJ,1977,12,3412392,3133660,278732,8.2
NJ,1978,1,3407864,3142029,265835,7.8
NJ,1978,2,3412171,3147287,264884,7.8
NJ,1978,3,3412266,3158029,254237,7.5
NJ,1978,4,3425380,3172951,252429,7.4
NJ,1978,5,3439050,3187576,251474,7.3
NJ,1978,6,3455579,3201974,253605,7.3
NJ,1978,7,3468906,3218603,250303,7.2
NJ,1978,8,3482504,3236898,245606,7.1
NJ,1978,9,3497017,3251601,245416,7
NJ,1978,10,3508160,3264735,243425,6.9
NJ,1978,11,3518344,3278939,239405,6.8
NJ,1978,12,3534198,3283279,250919,7.1
NJ,1979,1,3544373,3294942,249431,7
NJ,1979,2,3558162,3305534,252628,7.1
NJ,1979,3,3565648,3313556,252092,7.1
NJ,1979,4,3558873,3316335,242538,6.8
NJ,1979,5,3569344,3323373,245971,6.9
NJ,1979,6,3574934,3331521,243413,6.8
NJ,1979,7,3574742,3332417,242325,6.8
NJ,1979,8,3584610,3336537,248073,6.9
NJ,1979,9,3585612,3341909,243703,6.8
NJ,1979,10,3583066,3339739,243327,6.8
NJ,1979,11,3578841,3336163,242678,6.8
NJ,1979,12,3583557,3341167,242390,6.8
NJ,1980,1,3579421,3341419,238002,6.6
NJ,1980,2,3579793,3341500,238293,6.7
NJ,1980,3,3581766,3335785,245981,6.9
NJ,1980,4,3583029,3330728,252301,7
NJ,1980,5,3590275,3326221,264054,7.4
NJ,1980,6,3593248,3325161,268087,7.5
NJ,1980,7,3597527,3323218,274309,7.6
NJ,1980,8,3597428,3322146,275282,7.7
NJ,1980,9,3587885,3320366,267519,7.5
NJ,1980,10,3595616,3327340,268276,7.5
NJ,1980,11,3600571,3329981,270590,7.5
NJ,1980,12,3603930,3334219,269711,7.5
NJ,1981,1,3614239,3339594,274645,7.6
NJ,1981,2,3610015,3341592,268423,7.4
NJ,1981,3,3613766,3343840,269926,7.5
NJ,1981,4,3614942,3346752,268190,7.4
NJ,1981,5,3611906,3346449,265457,7.3
NJ,1981,6,3605561,3344944,260617,7.2
NJ,1981,7,3609882,3346554,263328,7.3
NJ,1981,8,3608695,3342562,266133,7.4
NJ,1981,9,3607169,3342034,265135,7.4
NJ,1981,10,3607832,3340164,267668,7.4
NJ,1981,11,3613742,3335454,278288,7.7
NJ,1981,12,3616086,3326389,289697,8
NJ,1982,1,3619970,3319803,300167,8.3
NJ,1982,2,3615329,3313114,302215,8.4
NJ,1982,3,3620352,3312635,307717,8.5
NJ,1982,4,3622170,3308869,313301,8.6
NJ,1982,5,3625360,3311428,313932,8.7
NJ,1982,6,3623931,3311893,312038,8.6
NJ,1982,7,3626479,3313782,312697,8.6
NJ,1982,8,3627946,3314792,313154,8.6
NJ,1982,9,3633721,3316324,317397,8.7
NJ,1982,10,3640093,3315920,324173,8.9
NJ,1982,11,3648981,3317112,331869,9.1
NJ,1982,12,3646296,3318669,327627,9
NJ,1983,1,3653598,3326321,327277,9
NJ,1983,2,3658879,3330517,328362,9
NJ,1983,3,3659964,3339183,320781,8.8
NJ,1983,4,3661792,3353060,308732,8.4
NJ,1983,5,3668584,3364969,303615,8.3
NJ,1983,6,3678287,3378802,299485,8.1
NJ,1983,7,3686409,3394221,292188,7.9
NJ,1983,8,3697250,3408677,288573,7.8
NJ,1983,9,3708282,3427932,280350,7.6
NJ,1983,10,3715123,3444083,271040,7.3
NJ,1983,11,3731307,3460585,270722,7.3
NJ,1983,12,3745939,3483034,262905,7
NJ,1984,1,3755176,3501307,253869,6.8
NJ,1984,2,3768409,3518682,249727,6.6
NJ,1984,3,3781398,3531533,249865,6.6
NJ,1984,4,3797308,3553284,244024,6.4
NJ,1984,5,3806104,3565413,240691,6.3
NJ,1984,6,3799570,3569670,229900,6.1
NJ,1984,7,3800121,3572932,227189,6
NJ,1984,8,3803932,3575623,228309,6
NJ,1984,9,3808999,3580498,228501,6
NJ,1984,10,3809601,3586577,223024,5.9
NJ,1984,11,3802446,3586121,216325,5.7
NJ,1984,12,3808059,3589632,218427,5.7
NJ,1985,1,3805021,3594267,210754,5.5
NJ,1985,2,3819625,3599264,220361,5.8
NJ,1985,3,3826180,3602750,223430,5.8
NJ,1985,4,3830326,3607967,222359,5.8
NJ,1985,5,3826592,3614243,212349,5.5
NJ,1985,6,3833112,3619379,213733,5.6
NJ,1985,7,3841253,3628897,212356,5.5
NJ,1985,8,3840806,3636430,204376,5.3
NJ,1985,9,3850581,3640682,209899,5.5
NJ,1985,10,3856502,3642948,213554,5.5
NJ,1985,11,3871709,3651006,220703,5.7
NJ,1985,12,3872742,3655390,217352,5.6
NJ,1986,1,3881626,3661132,220494,5.7
NJ,1986,2,3881735,3669158,212577,5.5
NJ,1986,3,3875795,3675167,200628,5.2
NJ,1986,4,3884490,3684375,200115,5.2
NJ,1986,5,3897889,3693864,204025,5.2
NJ,1986,6,3902811,3701457,201354,5.2
NJ,1986,7,3912298,3711637,200661,5.1
NJ,1986,8,3911948,3719348,192600,4.9
NJ,1986,9,3917688,3728081,189607,4.8
NJ,1986,10,3925526,3736484,189042,4.8
NJ,1986,11,3925695,3746213,179482,4.6
NJ,1986,12,3924836,3751601,173235,4.4
NJ,1987,1,3927640,3761669,165971,4.2
NJ,1987,2,3938384,3770457,167927,4.3
NJ,1987,3,3948656,3783801,164855,4.2
NJ,1987,4,3955028,3790843,164185,4.2
NJ,1987,5,3964568,3798869,165699,4.2
NJ,1987,6,3965429,3801291,164138,4.1
NJ,1987,7,3966047,3805318,160729,4.1
NJ,1987,8,3969919,3809984,159935,4
NJ,1987,9,3968533,3807587,160946,4.1
NJ,1987,10,3972628,3816109,156519,3.9
NJ,1987,11,3970350,3818506,151844,3.8
NJ,1987,12,3970315,3817982,152333,3.8
NJ,1988,1,3973566,3816423,157143,4
NJ,1988,2,3968343,3818482,149861,3.8
NJ,1988,3,3968460,3818581,149879,3.8
NJ,1988,4,3967351,3821476,145875,3.7
NJ,1988,5,3969086,3818226,150860,3.8
NJ,1988,6,3970834,3820355,150479,3.8
NJ,1988,7,3973579,3823260,150319,3.8
NJ,1988,8,3975483,3824933,150550,3.8
NJ,1988,9,3974854,3823167,151687,3.8
NJ,1988,10,3972265,3819377,152888,3.8
NJ,1988,11,3978315,3825607,152708,3.8
NJ,1988,12,3989579,3832084,157495,3.9
NJ,1989,1,3989764,3837285,152479,3.8
NJ,1989,2,3988259,3838042,150217,3.8
NJ,1989,3,3981541,3836994,144547,3.6
NJ,1989,4,3979547,3829316,150231,3.8
NJ,1989,5,3980416,3828230,152186,3.8
NJ,1989,6,3988981,3827397,161584,4.1
NJ,1989,7,3993335,3827290,166045,4.2
NJ,1989,8,4003953,3829809,174144,4.3
NJ,1989,9,4013067,3835964,177103,4.4
NJ,1989,10,4022245,3835936,186309,4.6
NJ,1989,11,4027940,3844070,183870,4.6
NJ,1989,12,4031504,3853634,177870,4.4
NJ,1990,1,4045602,3860998,184604,4.6
NJ,1990,2,4054657,3872419,182238,4.5
NJ,1990,3,4064612,3878187,186425,4.6
NJ,1990,4,4067749,3873385,194364,4.8
NJ,1990,5,4074879,3876712,198167,4.9
NJ,1990,6,4081769,3879548,202221,5
NJ,1990,7,4082160,3877157,205003,5
NJ,1990,8,4084004,3872841,211163,5.2
NJ,1990,9,4084047,3862812,221235,5.4
NJ,1990,10,4081017,3853086,227931,5.6
NJ,1990,11,4077769,3842909,234860,5.8
NJ,1990,12,4071652,3829435,242217,5.9
NJ,1991,1,4064760,3813733,251027,6.2
NJ,1991,2,4060617,3803228,257389,6.3
NJ,1991,3,4059853,3796672,263181,6.5
NJ,1991,4,4056651,3790787,265864,6.6
NJ,1991,5,4049308,3781454,267854,6.6
NJ,1991,6,4047948,3778576,269372,6.7
NJ,1991,7,4043941,3772958,270983,6.7
NJ,1991,8,4041831,3767359,274472,6.8
NJ,1991,9,4041471,3763877,277594,6.9
NJ,1991,10,4045839,3756857,288982,7.1
NJ,1991,11,4044202,3749785,294417,7.3
NJ,1991,12,4048140,3744297,303843,7.5
NJ,1992,1,4049901,3738716,311185,7.7
NJ,1992,2,4055729,3733971,321758,7.9
NJ,1992,3,4056840,3728473,328367,8.1
NJ,1992,4,4056145,3718663,337482,8.3
NJ,1992,5,4056769,3707374,349395,8.6
NJ,1992,6,4056683,3701530,355153,8.8
NJ,1992,7,4057617,3698947,358670,8.8
NJ,1992,8,4049423,3694284,355139,8.8
NJ,1992,9,4048214,3694903,353311,8.7
NJ,1992,10,4048170,3698273,349897,8.6
NJ,1992,11,4044843,3697176,347667,8.6
NJ,1992,12,4042703,3701345,341358,8.4
NJ,1993,1,4031656,3705047,326609,8.1
NJ,1993,2,4031014,3707441,323573,8
NJ,1993,3,4033176,3706272,326904,8.1
NJ,1993,4,4038578,3710631,327947,8.1
NJ,1993,5,4040116,3722042,318074,7.9
NJ,1993,6,4037267,3728803,308464,7.6
NJ,1993,7,4028356,3727579,300777,7.5
NJ,1993,8,4029226,3731063,298163,7.4
NJ,1993,9,4032118,3735600,296518,7.4
NJ,1993,10,4034850,3745525,289325,7.2
NJ,1993,11,4037852,3752992,284860,7.1
NJ,1993,12,4040814,3754149,286665,7.1
NJ,1994,1,4041610,3756115,285495,7.1
NJ,1994,2,4043429,3754493,288936,7.1
NJ,1994,3,4053998,3761540,292458,7.2
NJ,1994,4,4053166,3768529,284637,7
NJ,1994,5,4055418,3771872,283546,7
NJ,1994,6,4063417,3783952,279465,6.9
NJ,1994,7,4071358,3795835,275523,6.8
NJ,1994,8,4079164,3806850,272314,6.7
NJ,1994,9,4084230,3813006,271224,6.6
NJ,1994,10,4087801,3818354,269447,6.6
NJ,1994,11,4086529,3821297,265232,6.5
NJ,1994,12,4089717,3827678,262039,6.4
NJ,1995,1,4094136,3828660,265476,6.5
NJ,1995,2,4099521,3833747,265774,6.5
NJ,1995,3,4102524,3839144,263380,6.4
NJ,1995,4,4107528,3841392,266136,6.5
NJ,1995,5,4114273,3844333,269940,6.6
NJ,1995,6,4118985,3847755,271230,6.6
NJ,1995,7,4114842,3845198,269644,6.6
NJ,1995,8,4113229,3846909,266320,6.5
NJ,1995,9,4114153,3853988,260165,6.3
NJ,1995,10,4118724,3859154,259570,6.3
NJ,1995,11,4121163,3858154,263009,6.4
NJ,1995,12,4122857,3857434,265423,6.4
NJ,1996,1,4137974,3868299,269675,6.5
NJ,1996,2,4142105,3874366,267739,6.5
NJ,1996,3,4150056,3883315,266741,6.4
NJ,1996,4,4156302,3890682,265620,6.4
NJ,1996,5,4163294,3907181,256113,6.2
NJ,1996,6,4174759,3919937,254822,6.1
NJ,1996,7,4185826,3931264,254562,6.1
NJ,1996,8,4199738,3945430,254308,6.1
NJ,1996,9,4209600,3955245,254355,6
NJ,1996,10,4220220,3967568,252652,6
NJ,1996,11,4230387,3977938,252449,6
NJ,1996,12,4238364,3988308,250056,5.9
NJ,1997,1,4246851,4000193,246658,5.8
NJ,1997,2,4252284,4012951,239333,5.6
NJ,1997,3,4252139,4018608,233531,5.5
NJ,1997,4,4254111,4026878,227233,5.3
NJ,1997,5,4258068,4029486,228582,5.4
NJ,1997,6,4263016,4033916,229100,5.4
NJ,1997,7,4266778,4040615,226163,5.3
NJ,1997,8,4260756,4038521,222235,5.2
NJ,1997,9,4262497,4040930,221567,5.2
NJ,1997,10,4260657,4043602,217055,5.1
NJ,1997,11,4257116,4044789,212327,5
NJ,1997,12,4255014,4041780,213234,5
NJ,1998,1,4252510,4040725,211785,5
NJ,1998,2,4248912,4040000,208912,4.9
NJ,1998,3,4246165,4040308,205857,4.8
NJ,1998,4,4244164,4040725,203439,4.8
NJ,1998,5,4241773,4044623,197150,4.6
NJ,1998,6,4240288,4047248,193040,4.6
NJ,1998,7,4235978,4043216,192762,4.6
NJ,1998,8,4234650,4045351,189299,4.5
NJ,1998,9,4238821,4052001,186820,4.4
NJ,1998,10,4238352,4054367,183985,4.3
NJ,1998,11,4238810,4054222,184588,4.4
NJ,1998,12,4247973,4061957,186016,4.4
NJ,1999,1,4261358,4071820,189538,4.4
NJ,1999,2,4266701,4079328,187373,4.4
NJ,1999,3,4275591,4078962,196629,4.6
NJ,1999,4,4282677,4085428,197249,4.6
NJ,1999,5,4287167,4086221,200946,4.7
NJ,1999,6,4290200,4085850,204350,4.8
NJ,1999,7,4295735,4094251,201484,4.7
NJ,1999,8,4297036,4100047,196989,4.6
NJ,1999,9,4288345,4097247,191098,4.5
NJ,1999,10,4288022,4103328,184694,4.3
NJ,1999,11,4290309,4111290,179019,4.2
NJ,1999,12,4291515,4118792,172723,4
NJ,2000,1,4286125,4122337,163788,3.8
NJ,2000,2,4291539,4127228,164311,3.8
NJ,2000,3,4287146,4132604,154542,3.6
NJ,2000,4,4290438,4136026,154412,3.6
NJ,2000,5,4287358,4134339,153019,3.6
NJ,2000,6,4285860,4135781,150079,3.5
NJ,2000,7,4287967,4131712,156255,3.6
NJ,2000,8,4291809,4130712,161097,3.8
NJ,2000,9,4287893,4129106,158787,3.7
NJ,2000,10,4285769,4128593,157176,3.7
NJ,2000,11,4287070,4127084,159986,3.7
NJ,2000,12,4284428,4128201,156227,3.6
NJ,2001,1,4281189,4125356,155833,3.6
NJ,2001,2,4275533,4121241,154292,3.6
NJ,2001,3,4275413,4118155,157258,3.7
NJ,2001,4,4283882,4117411,166471,3.9
NJ,2001,5,4287177,4115649,171528,4
NJ,2001,6,4296285,4117284,179001,4.2
NJ,2001,7,4297324,4115892,181432,4.2
NJ,2001,8,4307741,4114497,193244,4.5
NJ,2001,9,4316344,4114755,201589,4.7
NJ,2001,10,4326764,4115781,210983,4.9
NJ,2001,11,4337176,4117662,219514,5.1
NJ,2001,12,4343249,4116833,226416,5.2
NJ,2002,1,4358063,4123859,234204,5.4
NJ,2002,2,4365868,4124870,240998,5.5
NJ,2002,3,4370805,4123887,246918,5.6
NJ,2002,4,4368242,4118851,249391,5.7
NJ,2002,5,4370017,4117028,252989,5.8
NJ,2002,6,4371049,4114045,257004,5.9
NJ,2002,7,4368703,4112369,256334,5.9
NJ,2002,8,4370500,4113025,257475,5.9
NJ,2002,9,4376677,4115306,261371,6
NJ,2002,10,4377958,4113217,264741,6
NJ,2002,11,4377589,4114947,262642,6
NJ,2002,12,4374237,4115777,258460,5.9
NJ,2003,1,4359522,4102308,257214,5.9
NJ,2003,2,4358239,4098828,259411,6
NJ,2003,3,4361371,4097857,263514,6
NJ,2003,4,4359817,4100387,259430,6
NJ,2003,5,4360462,4102231,258231,5.9
NJ,2003,6,4359145,4099153,259992,6
NJ,2003,7,4368477,4105223,263254,6
NJ,2003,8,4367365,4109629,257736,5.9
NJ,2003,9,4368663,4113422,255241,5.8
NJ,2003,10,4367746,4118889,248857,5.7
NJ,2003,11,4365937,4123282,242655,5.6
NJ,2003,12,4370010,4129552,240458,5.5
NJ,2004,1,4351639,4116174,235465,5.4
NJ,2004,2,4354281,4121527,232754,5.3
NJ,2004,3,4356402,4128372,228030,5.2
NJ,2004,4,4360338,4131960,228378,5.2
NJ,2004,5,4354240,4136182,218058,5
NJ,2004,6,4355097,4140605,214492,4.9
NJ,2004,7,4360093,4145448,214645,4.9
NJ,2004,8,4361679,4151107,210572,4.8
NJ,2004,9,4361311,4155050,206261,4.7
NJ,2004,10,4362200,4160318,201882,4.6
NJ,2004,11,4364660,4168774,195886,4.5
NJ,2004,12,4364954,4175162,189792,4.3
NJ,2005,1,4372156,4180696,191460,4.4
NJ,2005,2,4381868,4185992,195876,4.5
NJ,2005,3,4387331,4192239,195092,4.4
NJ,2005,4,4392468,4203966,188502,4.3
NJ,2005,5,4400082,4211121,188961,4.3
NJ,2005,6,4413313,4220444,192869,4.4
NJ,2005,7,4422083,4226379,195704,4.4
NJ,2005,8,4430456,4230441,200015,4.5
NJ,2005,9,4436944,4237016,199928,4.5
NJ,2005,10,4443926,4241681,202245,4.6
NJ,2005,11,4453671,4245078,208593,4.7
NJ,2005,12,4458749,4246771,211978,4.8
NJ,2006,1,4465575,4252296,213279,4.8
NJ,2006,2,4469036,4257541,211495,4.7
NJ,2006,3,4476370,4265926,210444,4.7
NJ,2006,4,4479252,4264979,214273,4.8
NJ,2006,5,4477160,4265519,211641,4.7
NJ,2006,6,4480504,4269137,211367,4.7
NJ,2006,7,4485926,4273592,212334,4.7
NJ,2006,8,4489066,4276237,212829,4.7
NJ,2006,9,4483636,4274593,209043,4.7
NJ,2006,10,4475981,4276453,199528,4.5
NJ,2006,11,4475310,4278355,196955,4.4
NJ,2006,12,4472141,4281116,191025,4.3
NJ,2007,1,4464430,4277048,187382,4.2
NJ,2007,2,4462634,4274114,188520,4.2
NJ,2007,3,4458708,4269363,189345,4.2
NJ,2007,4,4459567,4269648,189919,4.3
NJ,2007,5,4457609,4271408,186201,4.2
NJ,2007,6,4460638,4274163,186475,4.2
NJ,2007,7,4459435,4270098,189337,4.2
NJ,2007,8,4460334,4270809,189525,4.2
NJ,2007,9,4461221,4269747,191474,4.3
NJ,2007,10,4463084,4270843,192241,4.3
NJ,2007,11,4467850,4270877,196973,4.4
NJ,2007,12,4471532,4271708,199824,4.5
NJ,2008,1,4478667,4272302,206365,4.6
NJ,2008,2,4483931,4272140,211791,4.7
NJ,2008,3,4485501,4268922,216579,4.8
NJ,2008,4,4487720,4265500,222220,5
NJ,2008,5,4491277,4261186,230091,5.1
NJ,2008,6,4492619,4256907,235712,5.2
NJ,2008,7,4497826,4252577,245249,5.5
NJ,2008,8,4502100,4247318,254782,5.7
NJ,2008,9,4502508,4241892,260616,5.8
NJ,2008,10,4507366,4235569,271797,6
NJ,2008,11,4510423,4224896,285527,6.3
NJ,2008,12,4520784,4215127,305657,6.8
NJ,2009,1,4503641,4173692,329949,7.3
NM,1976,1,477468,436780,40688,8.5
NM,1976,2,478136,436927,41209,8.6
NM,1976,3,478725,437022,41703,8.7
NM,1976,4,481625,439466,42159,8.8
NM,1976,5,483415,440840,42575,8.8
NM,1976,6,485647,442710,42937,8.8
NM,1976,7,486888,443670,43218,8.9
NM,1976,8,487573,444163,43410,8.9
NM,1976,9,489190,445695,43495,8.9
NM,1976,10,490281,446824,43457,8.9
NM,1976,11,492180,448892,43288,8.8
NM,1976,12,494276,451280,42996,8.7
NM,1977,1,496827,454248,42579,8.6
NM,1977,2,500377,458313,42064,8.4
NM,1977,3,502598,461137,41461,8.2
NM,1977,4,504532,463748,40784,8.1
NM,1977,5,508384,468319,40065,7.9
NM,1977,6,510913,471591,39322,7.7
NM,1977,7,512835,474276,38559,7.5
NM,1977,8,514055,476265,37790,7.4
NM,1977,9,514159,477125,37034,7.2
NM,1977,10,515454,479149,36305,7
NM,1977,11,517119,481509,35610,6.9
NM,1977,12,517462,482490,34972,6.8
NM,1978,1,520603,486196,34407,6.6
NM,1978,2,521354,487421,33933,6.5
NM,1978,3,523409,489841,33568,6.4
NM,1978,4,526414,493098,33316,6.3
NM,1978,5,527296,494137,33159,6.3
NM,1978,6,531172,498087,33085,6.2
NM,1978,7,533927,500843,33084,6.2
NM,1978,8,535687,502545,33142,6.2
NM,1978,9,535946,502694,33252,6.2
NM,1978,10,535606,502205,33401,6.2
NM,1978,11,536826,503252,33574,6.3
NM,1978,12,540334,506577,33757,6.2
NM,1979,1,539745,505793,33952,6.3
NM,1979,2,541675,507466,34209,6.3
NM,1979,3,544649,510132,34517,6.3
NM,1979,4,546245,511366,34879,6.4
NM,1979,5,549376,514081,35295,6.4
NM,1979,6,551928,516153,35775,6.5
NM,1979,7,553629,517312,36317,6.6
NM,1979,8,554395,517491,36904,6.7
NM,1979,9,556407,518878,37529,6.7
NM,1979,10,558506,520318,38188,6.8
NM,1979,11,559138,520258,38880,7
NM,1979,12,559682,520070,39612,7.1
NM,1980,1,558429,518036,40393,7.2
NM,1980,2,560557,519435,41122,7.3
NM,1980,3,562172,520370,41802,7.4
NM,1980,4,560883,518458,42425,7.6
NM,1980,5,561768,518808,42960,7.6
NM,1980,6,560609,517219,43390,7.7
NM,1980,7,562276,518572,43704,7.8
NM,1980,8,563888,519981,43907,7.8
NM,1980,9,564166,520183,43983,7.8
NM,1980,10,565654,521729,43925,7.8
NM,1980,11,567005,523268,43737,7.7
NM,1980,12,569167,525757,43410,7.6
NM,1981,1,573192,530237,42955,7.5
NM,1981,2,573760,531228,42532,7.4
NM,1981,3,574602,532435,42167,7.3
NM,1981,4,576308,534423,41885,7.3
NM,1981,5,576810,535080,41730,7.2
NM,1981,6,576994,535281,41713,7.2
NM,1981,7,577805,535964,41841,7.2
NM,1981,8,579808,537682,42126,7.3
NM,1981,9,580169,537581,42588,7.3
NM,1981,10,581163,537913,43250,7.4
NM,1981,11,582687,538569,44118,7.6
NM,1981,12,584729,539538,45191,7.7
NM,1982,1,586863,540407,46456,7.9
NM,1982,2,587484,539708,47776,8.1
NM,1982,3,588139,539003,49136,8.4
NM,1982,4,589833,539320,50513,8.6
NM,1982,5,590193,538314,51879,8.8
NM,1982,6,591287,538081,53206,9
NM,1982,7,593856,539390,54466,9.2
NM,1982,8,595091,539455,55636,9.3
NM,1982,9,596671,539984,56687,9.5
NM,1982,10,597340,539738,57602,9.6
NM,1982,11,597970,539607,58363,9.8
NM,1982,12,599003,540024,58979,9.8
NM,1983,1,600429,540999,59430,9.9
NM,1983,2,601473,541771,59702,9.9
NM,1983,3,602212,542431,59781,9.9
NM,1983,4,603368,543699,59669,9.9
NM,1983,5,605157,545793,59364,9.8
NM,1983,6,607196,548319,58877,9.7
NM,1983,7,610778,552544,58234,9.5
NM,1983,8,609921,552467,57454,9.4
NM,1983,9,611560,554996,56564,9.2
NM,1983,10,612694,557112,55582,9.1
NM,1983,11,613768,559235,54533,8.9
NM,1983,12,615758,562310,53448,8.7
NM,1984,1,619274,566913,52361,8.5
NM,1984,2,621776,570378,51398,8.3
NM,1984,3,622887,572303,50584,8.1
NM,1984,4,624526,574584,49942,8
NM,1984,5,625641,576156,49485,7.9
NM,1984,6,628948,579734,49214,7.8
NM,1984,7,627504,578381,49123,7.8
NM,1984,8,631771,582561,49210,7.8
NM,1984,9,633010,583535,49475,7.8
NM,1984,10,634275,584367,49908,7.9
NM,1984,11,636111,585600,50511,7.9
NM,1984,12,636746,585487,51259,8.1
NM,1985,1,639788,587642,52146,8.2
NM,1985,2,641177,588132,53045,8.3
NM,1985,3,643463,589530,53933,8.4
NM,1985,4,644202,589413,54789,8.5
NM,1985,5,645354,589761,55593,8.6
NM,1985,6,647010,590671,56339,8.7
NM,1985,7,648540,591513,57027,8.8
NM,1985,8,649652,592003,57649,8.9
NM,1985,9,653534,595323,58211,8.9
NM,1985,10,657636,598918,58718,8.9
NM,1985,11,660154,600990,59164,9
NM,1985,12,662225,602671,59554,9
NM,1986,1,663452,603581,59871,9
NM,1986,2,663483,603296,60187,9.1
NM,1986,3,663692,603193,60499,9.1
NM,1986,4,664680,603872,60808,9.1
NM,1986,5,664958,603852,61106,9.2
NM,1986,6,665040,603649,61391,9.2
NM,1986,7,666750,605094,61656,9.2
NM,1986,8,669648,607751,61897,9.2
NM,1986,9,669330,607222,62108,9.3
NM,1986,10,670556,608266,62290,9.3
NM,1986,11,671519,609077,62442,9.3
NM,1986,12,673556,611004,62552,9.3
NM,1987,1,671622,609005,62617,9.3
NM,1987,2,671904,609322,62582,9.3
NM,1987,3,672784,610339,62445,9.3
NM,1987,4,672493,610273,62220,9.3
NM,1987,5,673893,611989,61904,9.2
NM,1987,6,672726,611229,61497,9.1
NM,1987,7,674829,613826,61003,9
NM,1987,8,674269,613837,60432,9
NM,1987,9,675471,615680,59791,8.9
NM,1987,10,676581,617499,59082,8.7
NM,1987,11,676380,618069,58311,8.6
NM,1987,12,676747,619273,57474,8.5
NM,1988,1,679753,623163,56590,8.3
NM,1988,2,680575,624876,55699,8.2
NM,1988,3,680395,625597,54798,8.1
NM,1988,4,681143,627270,53873,7.9
NM,1988,5,680021,627088,52933,7.8
NM,1988,6,681543,629548,51995,7.6
NM,1988,7,681823,630741,51082,7.5
NM,1988,8,682198,631987,50211,7.4
NM,1988,9,683330,633933,49397,7.2
NM,1988,10,683563,634901,48662,7.1
NM,1988,11,685739,637722,48017,7
NM,1988,12,683871,636379,47492,6.9
NM,1989,1,684207,637140,47067,6.9
NM,1989,2,685780,639052,46728,6.8
NM,1989,3,687148,640665,46483,6.8
NM,1989,4,687075,640748,46327,6.7
NM,1989,5,688350,642098,46252,6.7
NM,1989,6,690058,643816,46242,6.7
NM,1989,7,690800,644522,46278,6.7
NM,1989,8,692124,645778,46346,6.7
NM,1989,9,695541,649106,46435,6.7
NM,1989,10,697844,651308,46536,6.7
NM,1989,11,699231,652583,46648,6.7
NM,1989,12,703577,656807,46770,6.6
NM,1990,1,703610,656696,46914,6.7
NM,1990,2,704750,657673,47077,6.7
NM,1990,3,707236,659975,47261,6.7
NM,1990,4,710180,662714,47466,6.7
NM,1990,5,713167,665477,47690,6.7
NM,1990,6,714533,666597,47936,6.7
NM,1990,7,712424,664218,48206,6.8
NM,1990,8,714197,665697,48500,6.8
NM,1990,9,714289,665472,48817,6.8
NM,1990,10,715369,666220,49149,6.9
NM,1990,11,717354,667867,49487,6.9
NM,1990,12,715581,665771,49810,7
NM,1991,1,715288,665190,50098,7
NM,1991,2,716065,665684,50381,7
NM,1991,3,715745,665087,50658,7.1
NM,1991,4,716197,665275,50922,7.1
NM,1991,5,717755,666592,51163,7.1
NM,1991,6,716769,665380,51389,7.2
NM,1991,7,719617,668003,51614,7.2
NM,1991,8,721526,669675,51851,7.2
NM,1991,9,722796,670680,52116,7.2
NM,1991,10,722515,670098,52417,7.3
NM,1991,11,722364,669598,52766,7.3
NM,1991,12,724281,671118,53163,7.3
NM,1992,1,726359,672766,53593,7.4
NM,1992,2,727404,673418,53986,7.4
NM,1992,3,729302,674970,54332,7.4
NM,1992,4,731458,676828,54630,7.5
NM,1992,5,732795,677911,54884,7.5
NM,1992,6,734592,679494,55098,7.5
NM,1992,7,735932,680655,55277,7.5
NM,1992,8,737560,682136,55424,7.5
NM,1992,9,739423,683879,55544,7.5
NM,1992,10,742176,686547,55629,7.5
NM,1992,11,744752,689064,55688,7.5
NM,1992,12,743602,687886,55716,7.5
NM,1993,1,744874,689168,55706,7.5
NM,1993,2,746775,691100,55675,7.5
NM,1993,3,748884,693268,55616,7.4
NM,1993,4,752920,697407,55513,7.4
NM,1993,5,753419,698056,55363,7.3
NM,1993,6,754622,699459,55163,7.3
NM,1993,7,756271,701355,54916,7.3
NM,1993,8,756853,702227,54626,7.2
NM,1993,9,759378,705081,54297,7.2
NM,1993,10,762364,708421,53943,7.1
NM,1993,11,761410,707847,53563,7
NM,1993,12,762872,709708,53164,7
NM,1994,1,764986,712221,52765,6.9
NM,1994,2,766674,714294,52380,6.8
NM,1994,3,768709,716679,52030,6.8
NM,1994,4,770953,719228,51725,6.7
NM,1994,5,772217,720753,51464,6.7
NM,1994,6,775412,724165,51247,6.6
NM,1994,7,779187,728103,51084,6.6
NM,1994,8,780317,729347,50970,6.5
NM,1994,9,782721,731821,50900,6.5
NM,1994,10,783736,732864,50872,6.5
NM,1994,11,787206,736316,50890,6.5
NM,1994,12,789804,738853,50951,6.5
NM,1995,1,792869,741813,51056,6.4
NM,1995,2,794445,743187,51258,6.5
NM,1995,3,794668,743100,51568,6.5
NM,1995,4,793570,741591,51979,6.6
NM,1995,5,796017,743512,52505,6.6
NM,1995,6,798043,744888,53155,6.7
NM,1995,7,797695,743782,53913,6.8
NM,1995,8,800370,745612,54758,6.8
NM,1995,9,802396,746726,55670,6.9
NM,1995,10,803030,746396,56634,7.1
NM,1995,11,804492,746862,57630,7.2
NM,1995,12,805853,747211,58642,7.3
NM,1996,1,806991,747336,59655,7.4
NM,1996,2,809006,748484,60522,7.5
NM,1996,3,809325,748102,61223,7.6
NM,1996,4,810629,748886,61743,7.6
NM,1996,5,812190,750120,62070,7.6
NM,1996,6,812979,750783,62196,7.7
NM,1996,7,813642,751520,62122,7.6
NM,1996,8,814267,752416,61851,7.6
NM,1996,9,814470,753084,61386,7.5
NM,1996,10,816052,755311,60741,7.4
NM,1996,11,817138,757200,59938,7.3
NM,1996,12,817654,758666,58988,7.2
NM,1997,1,816251,758342,57909,7.1
NM,1997,2,816999,760105,56894,7
NM,1997,3,817261,761313,55948,6.8
NM,1997,4,817889,762810,55079,6.7
NM,1997,5,820115,765815,54300,6.6
NM,1997,6,821319,767693,53626,6.5
NM,1997,7,823638,770574,53064,6.4
NM,1997,8,824295,771666,52629,6.4
NM,1997,9,825168,772839,52329,6.3
NM,1997,10,828121,775945,52176,6.3
NM,1997,11,828946,776787,52159,6.3
NM,1997,12,831524,779262,52262,6.3
NM,1998,1,831106,778636,52470,6.3
NM,1998,2,833030,780385,52645,6.3
NM,1998,3,834717,781946,52771,6.3
NM,1998,4,835452,782615,52837,6.3
NM,1998,5,836002,783162,52840,6.3
NM,1998,6,837065,784302,52763,6.3
NM,1998,7,837263,784666,52597,6.3
NM,1998,8,836999,784648,52351,6.3
NM,1998,9,837232,785209,52023,6.2
NM,1998,10,836941,785330,51611,6.2
NM,1998,11,837029,785902,51127,6.1
NM,1998,12,837716,787134,50582,6
NM,1999,1,837547,787570,49977,6
NM,1999,2,837223,787850,49373,5.9
NM,1999,3,837684,788906,48778,5.8
NM,1999,4,838641,790439,48202,5.7
NM,1999,5,838126,790487,47639,5.7
NM,1999,6,839662,792556,47106,5.6
NM,1999,7,839613,793020,46593,5.5
NM,1999,8,841470,795377,46093,5.5
NM,1999,9,842238,796642,45596,5.4
NM,1999,10,842555,797451,45104,5.4
NM,1999,11,842397,797777,44620,5.3
NM,1999,12,842693,798543,44150,5.2
NM,2000,1,845716,802012,43704,5.2
NM,2000,2,846618,803324,43294,5.1
NM,2000,3,848809,805875,42934,5.1
NM,2000,4,849569,806947,42622,5
NM,2000,5,850783,808428,42355,5
NM,2000,6,850620,808492,42128,5
NM,2000,7,852705,810764,41941,4.9
NM,2000,8,854420,812625,41795,4.9
NM,2000,9,855834,814143,41691,4.9
NM,2000,10,855561,813941,41620,4.9
NM,2000,11,857697,816120,41577,4.8
NM,2000,12,859180,817618,41562,4.8
NM,2001,1,859271,817691,41580,4.8
NM,2001,2,861135,819503,41632,4.8
NM,2001,3,862953,821236,41717,4.8
NM,2001,4,862866,821022,41844,4.8
NM,2001,5,863967,821950,42017,4.9
NM,2001,6,865056,822822,42234,4.9
NM,2001,7,864110,821606,42504,4.9
NM,2001,8,865424,822590,42834,4.9
NM,2001,9,865196,821969,43227,5
NM,2001,10,864142,820468,43674,5.1
NM,2001,11,864607,820436,44171,5.1
NM,2001,12,865453,820740,44713,5.2
NM,2002,1,865721,820428,45293,5.2
NM,2002,2,866123,820249,45874,5.3
NM,2002,3,867476,821025,46451,5.4
NM,2002,4,868696,821669,47027,5.4
NM,2002,5,870246,822648,47598,5.5
NM,2002,6,871139,822981,48158,5.5
NM,2002,7,872244,823546,48698,5.6
NM,2002,8,873386,824172,49214,5.6
NM,2002,9,874491,824786,49705,5.7
NM,2002,10,874015,823840,50175,5.7
NM,2002,11,876495,825875,50620,5.8
NM,2002,12,878109,827072,51037,5.8
NM,2003,1,883032,831640,51392,5.8
NM,2003,2,883478,831718,51760,5.9
NM,2003,3,883998,831905,52093,5.9
NM,2003,4,884990,832604,52386,5.9
NM,2003,5,886194,833557,52637,5.9
NM,2003,6,887105,834263,52842,6
NM,2003,7,888866,835863,53003,6
NM,2003,8,890287,837176,53111,6
NM,2003,9,890409,837248,53161,6
NM,2003,10,893319,840165,53154,6
NM,2003,11,894115,841027,53088,5.9
NM,2003,12,895826,842853,52973,5.9
NM,2004,1,894954,842071,52883,5.9
NM,2004,2,896315,843542,52773,5.9
NM,2004,3,897519,844891,52628,5.9
NM,2004,4,899761,847305,52456,5.8
NM,2004,5,900140,847880,52260,5.8
NM,2004,6,900158,848108,52050,5.8
NM,2004,7,901973,850143,51830,5.7
NM,2004,8,901821,850217,51604,5.7
NM,2004,9,902470,851100,51370,5.7
NM,2004,10,907789,856672,51117,5.6
NM,2004,11,908822,857980,50842,5.6
NM,2004,12,910267,859726,50541,5.6
NM,2005,1,910777,860577,50200,5.5
NM,2005,2,911098,861279,49819,5.5
NM,2005,3,911869,862480,49389,5.4
NM,2005,4,915841,866934,48907,5.3
NM,2005,5,915552,867178,48374,5.3
NM,2005,6,915368,867573,47795,5.2
NM,2005,7,917764,870589,47175,5.1
NM,2005,8,918837,872315,46522,5.1
NM,2005,9,921118,875270,45848,5
NM,2005,10,922190,877035,45155,4.9
NM,2005,11,924545,880096,44449,4.8
NM,2005,12,925864,882124,43740,4.7
NM,2006,1,929036,886004,43032,4.6
NM,2006,2,931511,889206,42305,4.5
NM,2006,3,933031,891461,41570,4.5
NM,2006,4,933036,892198,40838,4.4
NM,2006,5,934791,894688,40103,4.3
NM,2006,6,936853,897483,39370,4.2
NM,2006,7,935156,896514,38642,4.1
NM,2006,8,935579,897662,37917,4.1
NM,2006,9,938455,901255,37200,4
NM,2006,10,937731,901233,36498,3.9
NM,2006,11,939277,903465,35812,3.8
NM,2006,12,940296,905142,35154,3.7
NM,2007,1,940250,905713,34537,3.7
NM,2007,2,941706,907693,34013,3.6
NM,2007,3,943991,910405,33586,3.6
NM,2007,4,942198,908944,33254,3.5
NM,2007,5,943241,910220,33021,3.5
NM,2007,6,944267,911374,32893,3.5
NM,2007,7,944599,911717,32882,3.5
NM,2007,8,946155,913175,32980,3.5
NM,2007,9,947012,913825,33187,3.5
NM,2007,10,950084,916568,33516,3.5
NM,2007,11,951616,917643,33973,3.6
NM,2007,12,953280,918731,34549,3.6
NM,2008,1,953182,917942,35240,3.7
NM,2008,2,954767,918771,35996,3.8
NM,2008,3,954996,918195,36801,3.9
NM,2008,4,956306,918662,37644,3.9
NM,2008,5,957148,918626,38522,4
NM,2008,6,957813,918384,39429,4.1
NM,2008,7,959044,918687,40357,4.2
NM,2008,8,961695,920398,41297,4.3
NM,2008,9,964253,922013,42240,4.4
NM,2008,10,964525,921336,43189,4.5
NM,2008,11,964878,920747,44131,4.6
NM,2008,12,964892,919833,45059,4.7
NM,2009,1,957868,908895,48973,5.1
NY,1976,1,7697603,6902617,794986,10.3
NY,1976,2,7686000,6899172,786828,10.2
NY,1976,3,7681868,6896889,784979,10.2
NY,1976,4,7677439,6895335,782104,10.2
NY,1976,5,7632944,6890590,742354,9.7
NY,1976,6,7685905,6889845,796060,10.4
NY,1976,7,7716393,6906954,809439,10.5
NY,1976,8,7710975,6912970,798005,10.3
NY,1976,9,7700362,6911774,788588,10.2
NY,1976,10,7694819,6908752,786067,10.2
NY,1976,11,7697269,6909876,787393,10.2
NY,1976,12,7689304,6918368,770936,10
NY,1977,1,7694847,6928687,766160,10
NY,1977,2,7711813,6941005,770808,10
NY,1977,3,7693283,6955989,737294,9.6
NY,1977,4,7693861,6972096,721765,9.4
NY,1977,5,7724535,6990708,733827,9.5
NY,1977,6,7712703,7010861,701842,9.1
NY,1977,7,7721605,7032738,688867,8.9
NY,1977,8,7735948,7053715,682233,8.8
NY,1977,9,7757009,7070463,686546,8.9
NY,1977,10,7765877,7084735,681142,8.8
NY,1977,11,7782956,7098628,684328,8.8
NY,1977,12,7781355,7113478,667877,8.6
NY,1978,1,7775613,7126699,648914,8.3
NY,1978,2,7780751,7140443,640308,8.2
NY,1978,3,7796788,7164521,632267,8.1
NY,1978,4,7808540,7190438,618102,7.9
NY,1978,5,7828880,7210722,618158,7.9
NY,1978,6,7838237,7233761,604476,7.7
NY,1978,7,7851754,7248749,603005,7.7
NY,1978,8,7869308,7268765,600543,7.6
NY,1978,9,7878374,7281362,597012,7.6
NY,1978,10,7898518,7303933,594585,7.5
NY,1978,11,7901560,7325497,576063,7.3
NY,1978,12,7918848,7342317,576531,7.3
NY,1979,1,7938630,7360942,577688,7.3
NY,1979,2,7943419,7372547,570872,7.2
NY,1979,3,7962377,7388443,573934,7.2
NY,1979,4,7974056,7402946,571110,7.2
NY,1979,5,7980520,7418781,561739,7
NY,1979,6,7999144,7429164,569980,7.1
NY,1979,7,8012401,7434773,577628,7.2
NY,1979,8,8013908,7434442,579466,7.2
NY,1979,9,8013235,7433257,579978,7.2
NY,1979,10,8000459,7424910,575549,7.2
NY,1979,11,7998594,7424116,574478,7.2
NY,1979,12,7998861,7422323,576538,7.2
NY,1980,1,8001686,7416209,585477,7.3
NY,1980,2,8004070,7417189,586881,7.3
NY,1980,3,7987925,7403101,584824,7.3
NY,1980,4,7982105,7385899,596206,7.5
NY,1980,5,7990764,7379450,611314,7.7
NY,1980,6,7976397,7368229,608168,7.6
NY,1980,7,7973177,7352168,621009,7.8
NY,1980,8,7964795,7351139,613656,7.7
NY,1980,9,7962743,7354504,608239,7.6
NY,1980,10,7964608,7364770,599838,7.5
NY,1980,11,7972799,7371779,601020,7.5
NY,1980,12,7979984,7379716,600268,7.5
NY,1981,1,7995726,7390754,604972,7.6
NY,1981,2,8019764,7401340,618424,7.7
NY,1981,3,8022254,7409995,612259,7.6
NY,1981,4,8025317,7421206,604111,7.5
NY,1981,5,8014650,7413448,601202,7.5
NY,1981,6,8013019,7412236,600783,7.5
NY,1981,7,8016425,7416579,599846,7.5
NY,1981,8,8007803,7412779,595024,7.4
NY,1981,9,7997208,7402652,594556,7.4
NY,1981,10,7997258,7394595,602663,7.5
NY,1981,11,7990996,7381135,609861,7.6
NY,1981,12,7992580,7367394,625186,7.8
NY,1982,1,7985181,7352321,632860,7.9
NY,1982,2,7958297,7340604,617693,7.8
NY,1982,3,7984170,7328168,656002,8.2
NY,1982,4,7980252,7310352,669900,8.4
NY,1982,5,7979825,7306871,672954,8.4
NY,1982,6,7980533,7295764,684769,8.6
NY,1982,7,7976943,7288514,688429,8.6
NY,1982,8,7979792,7282743,697049,8.7
NY,1982,9,7973471,7272735,700736,8.8
NY,1982,10,7984184,7265541,718643,9
NY,1982,11,7983760,7259654,724106,9.1
NY,1982,12,7984862,7263754,721108,9
NY,1983,1,7993098,7269290,723808,9.1
NY,1983,2,8006339,7270480,735859,9.2
NY,1983,3,8015796,7280998,734798,9.2
NY,1983,4,8013243,7290639,722604,9
NY,1983,5,8013754,7298379,715375,8.9
NY,1983,6,8022331,7312108,710223,8.9
NY,1983,7,8033125,7331821,701304,8.7
NY,1983,8,8036111,7341213,694898,8.6
NY,1983,9,8045094,7367439,677655,8.4
NY,1983,10,8041178,7386473,654705,8.1
NY,1983,11,8052134,7407113,645021,8
NY,1983,12,8044829,7428292,616537,7.7
NY,1984,1,8049364,7448388,600976,7.5
NY,1984,2,8070172,7471098,599074,7.4
NY,1984,3,8074983,7485854,589129,7.3
NY,1984,4,8082321,7508809,573512,7.1
NY,1984,5,8093615,7519826,573789,7.1
NY,1984,6,8127661,7542164,585497,7.2
NY,1984,7,8150848,7556602,594246,7.3
NY,1984,8,8161536,7578518,583018,7.1
NY,1984,9,8162556,7593957,568599,7
NY,1984,10,8179759,7609980,569779,7
NY,1984,11,8179619,7628131,551488,6.7
NY,1984,12,8195159,7643919,551240,6.7
NY,1985,1,8210551,7662084,548467,6.7
NY,1985,2,8227683,7675239,552444,6.7
NY,1985,3,8243914,7689357,554557,6.7
NY,1985,4,8255940,7696430,559510,6.8
NY,1985,5,8273746,7719171,554575,6.7
NY,1985,6,8275559,7729973,545586,6.6
NY,1985,7,8274217,7741783,532434,6.4
NY,1985,8,8299813,7760316,539497,6.5
NY,1985,9,8316806,7766936,549870,6.6
NY,1985,10,8331896,7779886,552010,6.6
NY,1985,11,8344801,7795938,548863,6.6
NY,1985,12,8352499,7807512,544987,6.5
NY,1986,1,8360592,7819873,540719,6.5
NY,1986,2,8384465,7834278,550187,6.6
NY,1986,3,8399086,7846161,552925,6.6
NY,1986,4,8418762,7864045,554717,6.6
NY,1986,5,8427210,7875284,551926,6.5
NY,1986,6,8419768,7883401,536367,6.4
NY,1986,7,8436183,7902052,534131,6.3
NY,1986,8,8432023,7913547,518476,6.1
NY,1986,9,8447780,7938415,509365,6
NY,1986,10,8450937,7951305,499632,5.9
NY,1986,11,8445541,7963652,481889,5.7
NY,1986,12,8450398,7976034,474364,5.6
NY,1987,1,8455659,7996195,459464,5.4
NY,1987,2,8451347,8012752,438595,5.2
NY,1987,3,8456839,8024720,432119,5.1
NY,1987,4,8462461,8040162,422299,5
NY,1987,5,8470638,8050795,419843,5
NY,1987,6,8482144,8066062,416082,4.9
NY,1987,7,8483691,8080843,402848,4.7
NY,1987,8,8488474,8088715,399759,4.7
NY,1987,9,8493295,8099194,394101,4.6
NY,1987,10,8522078,8122801,399277,4.7
NY,1987,11,8534118,8133018,401100,4.7
NY,1987,12,8522335,8142562,379773,4.5
NY,1988,1,8511177,8144926,366251,4.3
NY,1988,2,8499539,8152940,346599,4.1
NY,1988,3,8511207,8164264,346943,4.1
NY,1988,4,8514354,8169773,344581,4
NY,1988,5,8524713,8171773,352940,4.1
NY,1988,6,8533183,8184055,349128,4.1
NY,1988,7,8555413,8195965,359448,4.2
NY,1988,8,8575449,8203397,372052,4.3
NY,1988,9,8592083,8209601,382482,4.5
NY,1988,10,8602967,8218100,384867,4.5
NY,1988,11,8618043,8230549,387494,4.5
NY,1988,12,8639248,8238548,400700,4.6
NY,1989,1,8650927,8246582,404345,4.7
NY,1989,2,8654987,8249713,405274,4.7
NY,1989,3,8657700,8258795,398905,4.6
NY,1989,4,8687571,8264086,423485,4.9
NY,1989,5,8703328,8266569,436759,5
NY,1989,6,8709840,8277841,431999,5
NY,1989,7,8700737,8274300,426437,4.9
NY,1989,8,8716873,8277289,439584,5
NY,1989,9,8734701,8286296,448405,5.1
NY,1989,10,8749067,8292589,456478,5.2
NY,1989,11,8769860,8305980,463880,5.3
NY,1989,12,8788985,8327273,461712,5.3
NY,1990,1,8798346,8344470,453876,5.2
NY,1990,2,8805085,8357250,447835,5.1
NY,1990,3,8816195,8366475,449720,5.1
NY,1990,4,8819350,8363535,455815,5.2
NY,1990,5,8837021,8372636,464385,5.3
NY,1990,6,8825922,8369008,456914,5.2
NY,1990,7,8825103,8362200,462903,5.2
NY,1990,8,8815297,8350719,464578,5.3
NY,1990,9,8819703,8335439,484264,5.5
NY,1990,10,8800926,8311803,489123,5.6
NY,1990,11,8780659,8285366,495293,5.6
NY,1990,12,8762666,8258700,503966,5.8
NY,1991,1,8816983,8232662,584321,6.6
NY,1991,2,8804856,8204815,600041,6.8
NY,1991,3,8800595,8176996,623599,7.1
NY,1991,4,8796233,8153409,642824,7.3
NY,1991,5,8782697,8134093,648604,7.4
NY,1991,6,8762944,8116803,646141,7.4
NY,1991,7,8740852,8090902,649950,7.4
NY,1991,8,8730167,8077086,653081,7.5
NY,1991,9,8708056,8061836,646220,7.4
NY,1991,10,8701905,8048390,653515,7.5
NY,1991,11,8701097,8035808,665289,7.6
NY,1991,12,8709764,8017235,692529,8
NY,1992,1,8715409,8000127,715282,8.2
NY,1992,2,8724819,7989781,735038,8.4
NY,1992,3,8725697,7980195,745502,8.5
NY,1992,4,8730133,7982194,747939,8.6
NY,1992,5,8740237,7978224,762013,8.7
NY,1992,6,8749840,7973152,776688,8.9
NY,1992,7,8751206,7975840,775366,8.9
NY,1992,8,8745677,7974457,771220,8.8
NY,1992,9,8752719,7975200,777519,8.9
NY,1992,10,8735634,7976627,759007,8.7
NY,1992,11,8725943,7974428,751515,8.6
NY,1992,12,8721979,7976481,745498,8.5
NY,1993,1,8720137,7986855,733282,8.4
NY,1993,2,8698394,7989067,709327,8.2
NY,1993,3,8676726,7985997,690729,8
NY,1993,4,8684297,7994310,689987,7.9
NY,1993,5,8698202,8005469,692733,8
NY,1993,6,8700842,8011765,689077,7.9
NY,1993,7,8691362,8019890,671472,7.7
NY,1993,8,8694371,8024301,670070,7.7
NY,1993,9,8692530,8027459,665071,7.7
NY,1993,10,8706018,8033770,672248,7.7
NY,1993,11,8709671,8038942,670729,7.7
NY,1993,12,8714668,8044158,670510,7.7
NY,1994,1,8702316,8041490,660826,7.6
NY,1994,2,8701583,8042582,659001,7.6
NY,1994,3,8705199,8049752,655447,7.5
NY,1994,4,8698175,8059209,638966,7.3
NY,1994,5,8686180,8068031,618149,7.1
NY,1994,6,8687097,8078108,608989,7
NY,1994,7,8689038,8091401,597637,6.9
NY,1994,8,8679673,8098136,581537,6.7
NY,1994,9,8663826,8103875,559951,6.5
NY,1994,10,8666349,8106957,559392,6.5
NY,1994,11,8658457,8111717,546740,6.3
NY,1994,12,8645948,8111660,534288,6.2
NY,1995,1,8662190,8120687,541503,6.3
NY,1995,2,8676192,8120871,555321,6.4
NY,1995,3,8678282,8123805,554477,6.4
NY,1995,4,8678455,8120889,557566,6.4
NY,1995,5,8671431,8114475,556956,6.4
NY,1995,6,8669132,8119584,549548,6.3
NY,1995,7,8666641,8118921,547720,6.3
NY,1995,8,8684257,8125155,559102,6.4
NY,1995,9,8684033,8129773,554260,6.4
NY,1995,10,8678611,8132026,546585,6.3
NY,1995,11,8681442,8138539,542903,6.3
NY,1995,12,8691386,8144856,546530,6.3
NY,1996,1,8699595,8151574,548021,6.3
NY,1996,2,8713386,8166689,546697,6.3
NY,1996,3,8741221,8177305,563916,6.5
NY,1996,4,8747558,8187141,560417,6.4
NY,1996,5,8755624,8204695,550929,6.3
NY,1996,6,8765663,8217560,548103,6.3
NY,1996,7,8781773,8229630,552143,6.3
NY,1996,8,8791240,8247076,544164,6.2
NY,1996,9,8808218,8265870,542348,6.2
NY,1996,10,8829795,8283082,546713,6.2
NY,1996,11,8853554,8299908,553646,6.3
NY,1996,12,8878902,8316423,562479,6.3
NY,1997,1,8907111,8328606,578505,6.5
NY,1997,2,8932759,8346582,586177,6.6
NY,1997,3,8961764,8369754,592010,6.6
NY,1997,4,8974797,8383691,591106,6.6
NY,1997,5,8989408,8397285,592123,6.6
NY,1997,6,9001984,8409722,592262,6.6
NY,1997,7,9017965,8427789,590176,6.5
NY,1997,8,9022873,8437570,585303,6.5
NY,1997,9,9033008,8456042,576966,6.4
NY,1997,10,9042954,8470724,572230,6.3
NY,1997,11,9043089,8480949,562140,6.2
NY,1997,12,9042420,8489811,552609,6.1
NY,1998,1,9046120,8498541,547579,6.1
NY,1998,2,9055805,8512094,543711,6
NY,1998,3,9049965,8519633,530332,5.9
NY,1998,4,9043931,8522202,521729,5.8
NY,1998,5,9049729,8537890,511839,5.7
NY,1998,6,9044250,8544346,499904,5.5
NY,1998,7,9052751,8546025,506726,5.6
NY,1998,8,9053516,8557043,496473,5.5
NY,1998,9,9066795,8566476,500319,5.5
NY,1998,10,9071053,8575539,495514,5.5
NY,1998,11,9080805,8584747,496058,5.5
NY,1998,12,9090875,8594060,496815,5.5
NY,1999,1,9096002,8601519,494483,5.4
NY,1999,2,9107426,8612816,494610,5.4
NY,1999,3,9104181,8619992,484189,5.3
NY,1999,4,9118459,8641858,476601,5.2
NY,1999,5,9128712,8647195,481517,5.3
NY,1999,6,9136349,8651597,484752,5.3
NY,1999,7,9138932,8659522,479410,5.2
NY,1999,8,9147374,8670342,477032,5.2
NY,1999,9,9152331,8673483,478848,5.2
NY,1999,10,9158602,8689870,468732,5.1
NY,1999,11,9159109,8704206,454903,5
NY,1999,12,9161474,8716773,444701,4.9
NY,2000,1,9157152,8719004,438148,4.8
NY,2000,2,9157753,8725192,432561,4.7
NY,2000,3,9164847,8738258,426589,4.7
NY,2000,4,9170205,8748331,421874,4.6
NY,2000,5,9172620,8750334,422286,4.6
NY,2000,6,9168607,8754089,414518,4.5
NY,2000,7,9166035,8758525,407510,4.4
NY,2000,8,9168861,8755025,413836,4.5
NY,2000,9,9173367,8763751,409616,4.5
NY,2000,10,9168692,8765059,403633,4.4
NY,2000,11,9170240,8768172,402068,4.4
NY,2000,12,9165279,8771550,393729,4.3
NY,2001,1,9154338,8768108,386230,4.2
NY,2001,2,9152003,8764033,387970,4.2
NY,2001,3,9143510,8754846,388664,4.3
NY,2001,4,9148324,8741877,406447,4.4
NY,2001,5,9154407,8742943,411464,4.5
NY,2001,6,9162296,8740231,422065,4.6
NY,2001,7,9173447,8737413,436034,4.8
NY,2001,8,9198130,8734675,463455,5
NY,2001,9,9228774,8740756,488018,5.3
NY,2001,10,9244909,8735894,509015,5.5
NY,2001,11,9271196,8733320,537876,5.8
NY,2001,12,9287866,8732998,554868,6
NY,2002,1,9279850,8719290,560560,6
NY,2002,2,9291913,8720982,570931,6.1
NY,2002,3,9298381,8722181,576200,6.2
NY,2002,4,9303096,8723435,579661,6.2
NY,2002,5,9302653,8720036,582617,6.3
NY,2002,6,9297145,8718238,578907,6.2
NY,2002,7,9297197,8720961,576236,6.2
NY,2002,8,9302125,8727804,574321,6.2
NY,2002,9,9291118,8721435,569683,6.1
NY,2002,10,9302472,8722675,579797,6.2
NY,2002,11,9307026,8719719,587307,6.3
NY,2002,12,9315449,8720378,595071,6.4
NY,2003,1,9305908,8710313,595595,6.4
NY,2003,2,9302342,8706812,595530,6.4
NY,2003,3,9297931,8702891,595040,6.4
NY,2003,4,9293412,8696594,596818,6.4
NY,2003,5,9288419,8695175,593244,6.4
NY,2003,6,9289391,8695862,593529,6.4
NY,2003,7,9285075,8693112,591963,6.4
NY,2003,8,9296974,8698540,598434,6.4
NY,2003,9,9303975,8703229,600746,6.5
NY,2003,10,9300374,8709250,591124,6.4
NY,2003,11,9309818,8715256,594562,6.4
NY,2003,12,9314389,8719636,594753,6.4
NY,2004,1,9335163,8739969,595194,6.4
NY,2004,2,9339206,8754307,584899,6.3
NY,2004,3,9356208,8770609,585599,6.3
NY,2004,4,9341873,8775685,566188,6.1
NY,2004,5,9344152,8795163,548989,5.9
NY,2004,6,9359756,8807045,552711,5.9
NY,2004,7,9362360,8824129,538231,5.7
NY,2004,8,9363428,8835421,528007,5.6
NY,2004,9,9371160,8850818,520342,5.6
NY,2004,10,9370741,8867165,503576,5.4
NY,2004,11,9376556,8879858,496698,5.3
NY,2004,12,9400413,8891988,508425,5.4
NY,2005,1,9385304,8897147,488157,5.2
NY,2005,2,9384731,8908444,476287,5.1
NY,2005,3,9367218,8917705,449513,4.8
NY,2005,4,9417803,8945939,471864,5
NY,2005,5,9433860,8950606,483254,5.1
NY,2005,6,9438621,8961183,477438,5.1
NY,2005,7,9453573,8975545,478028,5.1
NY,2005,8,9458797,8989937,468860,5
NY,2005,9,9485261,9003958,481303,5.1
NY,2005,10,9485622,9007444,478178,5
NY,2005,11,9499612,9019956,479656,5
NY,2005,12,9504047,9035643,468404,4.9
NY,2006,1,9510825,9048625,462200,4.9
NY,2006,2,9515212,9058765,456447,4.8
NY,2006,3,9533014,9070450,462564,4.9
NY,2006,4,9532572,9080812,451760,4.7
NY,2006,5,9530292,9087458,442834,4.6
NY,2006,6,9539951,9095097,444854,4.7
NY,2006,7,9543823,9094528,449295,4.7
NY,2006,8,9532597,9099741,432856,4.5
NY,2006,9,9528324,9105557,422767,4.4
NY,2006,10,9525863,9111117,414746,4.4
NY,2006,11,9532747,9119203,413544,4.3
NY,2006,12,9536011,9129189,406822,4.3
NY,2007,1,9549262,9131715,417547,4.4
NY,2007,2,9550294,9128634,421660,4.4
NY,2007,3,9545763,9130523,415240,4.3
NY,2007,4,9546050,9126244,419806,4.4
NY,2007,5,9568141,9136565,431576,4.5
NY,2007,6,9583630,9143477,440153,4.6
NY,2007,7,9584698,9138453,446245,4.7
NY,2007,8,9585282,9138692,446590,4.7
NY,2007,9,9581787,9143522,438265,4.6
NY,2007,10,9594551,9151446,443105,4.6
NY,2007,11,9597439,9156246,441193,4.6
NY,2007,12,9610420,9164913,445507,4.6
NY,2008,1,9620784,9166949,453835,4.7
NY,2008,2,9612699,9168074,444625,4.6
NY,2008,3,9631336,9165944,465392,4.8
NY,2008,4,9647585,9168863,478722,5
NY,2008,5,9667195,9166835,500360,5.2
NY,2008,6,9680280,9164122,516158,5.3
NY,2008,7,9691152,9167854,523298,5.4
NY,2008,8,9709913,9160107,549806,5.7
NY,2008,9,9712435,9149151,563284,5.8
NY,2008,10,9716598,9139411,577187,5.9
NY,2008,11,9731708,9122125,609583,6.3
NY,2008,12,9733719,9095774,637945,6.6
NY,2009,1,9688935,9013712,675223,7
NC,1976,1,2590108,2418322,171786,6.6
NC,1976,2,2586589,2421949,164640,6.4
NC,1976,3,2592802,2428521,164281,6.3
NC,1976,4,2595302,2431677,163625,6.3
NC,1976,5,2599377,2438265,161112,6.2
NC,1976,6,2606217,2445218,160999,6.2
NC,1976,7,2623738,2465199,158539,6
NC,1976,8,2630538,2471504,159034,6
NC,1976,9,2619364,2455464,163900,6.3
NC,1976,10,2625811,2454790,171021,6.5
NC,1976,11,2625179,2458883,166296,6.3
NC,1976,12,2637149,2463725,173424,6.6
NC,1977,1,2645112,2466899,178213,6.7
NC,1977,2,2637772,2471479,166293,6.3
NC,1977,3,2650648,2482665,167983,6.3
NC,1977,4,2657099,2493761,163338,6.1
NC,1977,5,2667086,2507375,159711,6
NC,1977,6,2682770,2521040,161730,6
NC,1977,7,2701249,2542001,159248,5.9
NC,1977,8,2713803,2557532,156271,5.8
NC,1977,9,2711432,2558120,153312,5.7
NC,1977,10,2720595,2570751,149844,5.5
NC,1977,11,2727944,2579012,148932,5.5
NC,1977,12,2743162,2599681,143481,5.2
NC,1978,1,2753382,2600611,152771,5.5
NC,1978,2,2741946,2612588,129358,4.7
NC,1978,3,2734014,2609077,124937,4.6
NC,1978,4,2746888,2620580,126308,4.6
NC,1978,5,2756369,2627616,128753,4.7
NC,1978,6,2760138,2634448,125690,4.6
NC,1978,7,2764346,2643276,121070,4.4
NC,1978,8,2774881,2651324,123557,4.5
NC,1978,9,2795635,2674788,120847,4.3
NC,1978,10,2782206,2662272,119934,4.3
NC,1978,11,2785729,2664325,121404,4.4
NC,1978,12,2785863,2661922,123941,4.4
NC,1979,1,2799037,2681115,117922,4.2
NC,1979,2,2800694,2673228,127466,4.6
NC,1979,3,2808233,2678446,129787,4.6
NC,1979,4,2812491,2678173,134318,4.8
NC,1979,5,2806513,2672250,134263,4.8
NC,1979,6,2816290,2682828,133462,4.7
NC,1979,7,2811988,2678730,133258,4.7
NC,1979,8,2821416,2683553,137863,4.9
NC,1979,9,2817992,2675516,142476,5.1
NC,1979,10,2822466,2679483,142983,5.1
NC,1979,11,2828580,2682395,146185,5.2
NC,1979,12,2839578,2690854,148724,5.2
NC,1980,1,2836234,2689943,146291,5.2
NC,1980,2,2847228,2686086,161142,5.7
NC,1980,3,2847857,2682796,165061,5.8
NC,1980,4,2853848,2683884,169964,6
NC,1980,5,2860208,2681074,179134,6.3
NC,1980,6,2854173,2661064,193109,6.8
NC,1980,7,2848357,2637930,210427,7.4
NC,1980,8,2847496,2648485,199011,7
NC,1980,9,2851866,2658085,193781,6.8
NC,1980,10,2862870,2672116,190754,6.7
NC,1980,11,2864039,2676460,187579,6.5
NC,1980,12,2873650,2686869,186781,6.5
NC,1981,1,2881005,2695526,185479,6.4
NC,1981,2,2892494,2704548,187946,6.5
NC,1981,3,2899743,2715278,184465,6.4
NC,1981,4,2896861,2717736,179125,6.2
NC,1981,5,2895108,2719784,175324,6.1
NC,1981,6,2900614,2726688,173926,6
NC,1981,7,2888835,2724279,164556,5.7
NC,1981,8,2889221,2719858,169363,5.9
NC,1981,9,2886072,2719888,166184,5.8
NC,1981,10,2955512,2720583,234929,7.9
NC,1981,11,2962031,2722531,239500,8.1
NC,1981,12,2958160,2707993,250167,8.5
NC,1982,1,2958078,2689593,268485,9.1
NC,1982,2,2962120,2694932,267188,9
NC,1982,3,2962346,2684746,277600,9.4
NC,1982,4,2941056,2676953,264103,9
NC,1982,5,2945901,2670980,274921,9.3
NC,1982,6,2938265,2658166,280099,9.5
NC,1982,7,2948126,2656048,292078,9.9
NC,1982,8,2938716,2653839,284877,9.7
NC,1982,9,2930329,2651253,279076,9.5
NC,1982,10,2925852,2637050,288802,9.9
NC,1982,11,2924834,2631688,293146,10
NC,1982,12,2919566,2634382,285184,9.8
NC,1983,1,2926494,2634961,291533,10
NC,1983,2,2922773,2623853,298920,10.2
NC,1983,3,2919701,2627090,292611,10
NC,1983,4,2924014,2642523,281491,9.6
NC,1983,5,2923074,2649423,273651,9.4
NC,1983,6,2925238,2661916,263322,9
NC,1983,7,2934096,2681739,252357,8.6
NC,1983,8,2933565,2685130,248435,8.5
NC,1983,9,2950873,2707348,243525,8.3
NC,1983,10,2953286,2716793,236493,8
NC,1983,11,2964211,2732748,231463,7.8
NC,1983,12,2978818,2754660,224158,7.5
NC,1984,1,2994840,2780829,214011,7.1
NC,1984,2,3007510,2797560,209950,7
NC,1984,3,3026865,2816245,210620,7
NC,1984,4,3028930,2821996,206934,6.8
NC,1984,5,3037002,2833139,203863,6.7
NC,1984,6,3036182,2831932,204250,6.7
NC,1984,7,3038928,2837303,201625,6.6
NC,1984,8,3045493,2842638,202855,6.7
NC,1984,9,3051621,2846426,205195,6.7
NC,1984,10,3051963,2847324,204639,6.7
NC,1984,11,3057622,2855057,202565,6.6
NC,1984,12,3058850,2859455,199395,6.5
NC,1985,1,3065457,2873438,192019,6.3
NC,1985,2,3074122,2880322,193800,6.3
NC,1985,3,3084045,2894937,189108,6.1
NC,1985,4,3084486,2904283,180203,5.8
NC,1985,5,3092756,2909222,183534,5.9
NC,1985,6,3087031,2909458,177573,5.8
NC,1985,7,3087322,2908598,178724,5.8
NC,1985,8,3096184,2923386,172798,5.6
NC,1985,9,3114202,2944735,169467,5.4
NC,1985,10,3137120,2969027,168093,5.4
NC,1985,11,3150101,2981529,168572,5.4
NC,1985,12,3158723,2991756,166967,5.3
NC,1986,1,3149579,2994271,155308,4.9
NC,1986,2,3169611,2998204,171407,5.4
NC,1986,3,3162480,2991925,170555,5.4
NC,1986,4,3168915,2993571,175344,5.5
NC,1986,5,3169319,2996817,172502,5.4
NC,1986,6,3173988,3004489,169499,5.3
NC,1986,7,3185745,3013209,172536,5.4
NC,1986,8,3189204,3019507,169697,5.3
NC,1986,9,3191037,3019813,171224,5.4
NC,1986,10,3202300,3032892,169408,5.3
NC,1986,11,3209495,3039506,169989,5.3
NC,1986,12,3223912,3055086,168826,5.2
NC,1987,1,3236637,3078575,158062,4.9
NC,1987,2,3240842,3079972,160870,5
NC,1987,3,3254723,3093967,160756,4.9
NC,1987,4,3260327,3102989,157338,4.8
NC,1987,5,3265091,3112914,152177,4.7
NC,1987,6,3273137,3121686,151451,4.6
NC,1987,7,3276766,3133186,143580,4.4
NC,1987,8,3280197,3133854,146343,4.5
NC,1987,9,3283279,3139778,143501,4.4
NC,1987,10,3301406,3161833,139573,4.2
NC,1987,11,3302949,3164348,138601,4.2
NC,1987,12,3299167,3161964,137203,4.2
NC,1988,1,3302799,3161591,141208,4.3
NC,1988,2,3317021,3187460,129561,3.9
NC,1988,3,3320722,3194768,125954,3.8
NC,1988,4,3318093,3194611,123482,3.7
NC,1988,5,3321321,3198936,122385,3.7
NC,1988,6,3328545,3210745,117800,3.5
NC,1988,7,3351582,3231746,119836,3.6
NC,1988,8,3355333,3234851,120482,3.6
NC,1988,9,3365534,3242756,122778,3.6
NC,1988,10,3360825,3237187,123638,3.7
NC,1988,11,3369008,3245812,123196,3.7
NC,1988,12,3373885,3250358,123527,3.7
NC,1989,1,3380141,3259172,120969,3.6
NC,1989,2,3382358,3265929,116429,3.4
NC,1989,3,3388826,3267907,120919,3.6
NC,1989,4,3401267,3274506,126761,3.7
NC,1989,5,3404489,3279625,124864,3.7
NC,1989,6,3415468,3293780,121688,3.6
NC,1989,7,3416854,3296292,120562,3.5
NC,1989,8,3424403,3298709,125694,3.7
NC,1989,9,3428381,3302775,125606,3.7
NC,1989,10,3433003,3312222,120781,3.5
NC,1989,11,3433827,3316035,117792,3.4
NC,1989,12,3440149,3318976,121173,3.5
NC,1990,1,3451292,3328499,122793,3.6
NC,1990,2,3470016,3345996,124020,3.6
NC,1990,3,3480303,3353376,126927,3.6
NC,1990,4,3486725,3353293,133432,3.8
NC,1990,5,3500862,3364727,136135,3.9
NC,1990,6,3507178,3369087,138091,3.9
NC,1990,7,3505384,3360526,144858,4.1
NC,1990,8,3500647,3358473,142174,4.1
NC,1990,9,3508997,3358403,150594,4.3
NC,1990,10,3514051,3343005,171046,4.9
NC,1990,11,3518690,3346889,171801,4.9
NC,1990,12,3526675,3343706,182969,5.2
NC,1991,1,3520288,3325468,194820,5.5
NC,1991,2,3523434,3319437,203997,5.8
NC,1991,3,3516940,3304583,212357,6
NC,1991,4,3521348,3308147,213201,6.1
NC,1991,5,3521962,3312079,209883,6
NC,1991,6,3524043,3314421,209622,5.9
NC,1991,7,3544408,3328988,215420,6.1
NC,1991,8,3552808,3345556,207252,5.8
NC,1991,9,3560128,3351318,208810,5.9
NC,1991,10,3564323,3357555,206768,5.8
NC,1991,11,3562979,3348755,214224,6
NC,1991,12,3562819,3344116,218703,6.1
NC,1992,1,3573655,3348986,224669,6.3
NC,1992,2,3578276,3349572,228704,6.4
NC,1992,3,3585341,3354845,230496,6.4
NC,1992,4,3569673,3344420,225253,6.3
NC,1992,5,3588762,3360944,227818,6.3
NC,1992,6,3611185,3381256,229929,6.4
NC,1992,7,3610694,3385651,225043,6.2
NC,1992,8,3614126,3387640,226486,6.3
NC,1992,9,3606306,3383030,223276,6.2
NC,1992,10,3608118,3391258,216860,6
NC,1992,11,3604155,3387620,216535,6
NC,1992,12,3600740,3389597,211143,5.9
NC,1993,1,3615678,3409943,205735,5.7
NC,1993,2,3618376,3416913,201463,5.6
NC,1993,3,3606830,3406833,199997,5.5
NC,1993,4,3624569,3422042,202527,5.6
NC,1993,5,3621251,3425184,196067,5.4
NC,1993,6,3622599,3430100,192499,5.3
NC,1993,7,3631397,3450246,181151,5
NC,1993,8,3621246,3441858,179388,5
NC,1993,9,3614458,3438852,175606,4.9
NC,1993,10,3618529,3445945,172584,4.8
NC,1993,11,3627783,3459262,168521,4.6
NC,1993,12,3631637,3464556,167081,4.6
NC,1994,1,3621471,3458135,163336,4.5
NC,1994,2,3627147,3463151,163996,4.5
NC,1994,3,3638482,3477366,161116,4.4
NC,1994,4,3653284,3493154,160130,4.4
NC,1994,5,3661063,3498993,162070,4.4
NC,1994,6,3672934,3511090,161844,4.4
NC,1994,7,3674918,3512909,162009,4.4
NC,1994,8,3690522,3525195,165327,4.5
NC,1994,9,3704813,3538550,166263,4.5
NC,1994,10,3703221,3541283,161938,4.4
NC,1994,11,3712247,3554704,157543,4.2
NC,1994,12,3714784,3561543,153241,4.1
NC,1995,1,3712324,3561245,151079,4.1
NC,1995,2,3719257,3560433,158824,4.3
NC,1995,3,3724938,3567470,157468,4.2
NC,1995,4,3722829,3562288,160541,4.3
NC,1995,5,3722075,3556869,165206,4.4
NC,1995,6,3738438,3570120,168318,4.5
NC,1995,7,3753431,3579818,173613,4.6
NC,1995,8,3751307,3579374,171933,4.6
NC,1995,9,3764280,3592170,172110,4.6
NC,1995,10,3779749,3610151,169598,4.5
NC,1995,11,3792047,3619778,172269,4.5
NC,1995,12,3805567,3632052,173515,4.6
NC,1996,1,3826619,3636991,189628,5
NC,1996,2,3821575,3648254,173321,4.5
NC,1996,3,3833866,3661562,172304,4.5
NC,1996,4,3850342,3670908,179434,4.7
NC,1996,5,3870679,3697665,173014,4.5
NC,1996,6,3882952,3711636,171316,4.4
NC,1996,7,3876073,3706320,169753,4.4
NC,1996,8,3883336,3716150,167186,4.3
NC,1996,9,3893123,3722710,170413,4.4
NC,1996,10,3908143,3743219,164924,4.2
NC,1996,11,3923084,3760368,162716,4.1
NC,1996,12,3931706,3773513,158193,4
NC,1997,1,3939243,3784021,155222,3.9
NC,1997,2,3946670,3788768,157902,4
NC,1997,3,3956184,3804169,152015,3.8
NC,1997,4,3962246,3810180,152066,3.8
NC,1997,5,3968776,3815154,153622,3.9
NC,1997,6,3968719,3813707,155012,3.9
NC,1997,7,3960334,3804773,155561,3.9
NC,1997,8,3955208,3801261,153947,3.9
NC,1997,9,3975079,3821562,153517,3.9
NC,1997,10,3969755,3820693,149062,3.8
NC,1997,11,3976904,3826934,149970,3.8
NC,1997,12,3974198,3823984,150214,3.8
NC,1998,1,3961951,3814245,147706,3.7
NC,1998,2,3962839,3814315,148524,3.7
NC,1998,3,3961047,3815914,145133,3.7
NC,1998,4,3977898,3830285,147613,3.7
NC,1998,5,3975640,3834995,140645,3.5
NC,1998,6,3978594,3838194,140400,3.5
NC,1998,7,3981971,3846516,135455,3.4
NC,1998,8,3997891,3854025,143866,3.6
NC,1998,9,4005364,3865588,139776,3.5
NC,1998,10,4003920,3867155,136765,3.4
NC,1998,11,4007954,3874913,133041,3.3
NC,1998,12,4011804,3881354,130450,3.3
NC,1999,1,4019688,3893196,126492,3.1
NC,1999,2,4031761,3906813,124948,3.1
NC,1999,3,4035954,3909170,126784,3.1
NC,1999,4,4035721,3910616,125105,3.1
NC,1999,5,4031594,3901748,129846,3.2
NC,1999,6,4032162,3901356,130806,3.2
NC,1999,7,4057333,3926543,130790,3.2
NC,1999,8,4069568,3933352,136216,3.3
NC,1999,9,4071213,3928905,142308,3.5
NC,1999,10,4083499,3942513,140986,3.5
NC,1999,11,4086025,3946204,139821,3.4
NC,1999,12,4092864,3954508,138356,3.4
NC,2000,1,4072063,3936684,135379,3.3
NC,2000,2,4083670,3943709,139961,3.4
NC,2000,3,4102968,3965920,137048,3.3
NC,2000,4,4104207,3965882,138325,3.4
NC,2000,5,4118151,3975427,142724,3.5
NC,2000,6,4141521,3993487,148034,3.6
NC,2000,7,4129002,3982621,146381,3.5
NC,2000,8,4154109,3985158,168951,4.1
NC,2000,9,4147406,3979355,168051,4.1
NC,2000,10,4139621,3964079,175542,4.2
NC,2000,11,4143930,3968881,175049,4.2
NC,2000,12,4149101,3969621,179480,4.3
NC,2001,1,4150295,3965955,184340,4.4
NC,2001,2,4158352,3960888,197464,4.7
NC,2001,3,4155691,3949905,205786,5
NC,2001,4,4154447,3947370,207077,5
NC,2001,5,4168290,3938089,230201,5.5
NC,2001,6,4162960,3933800,229160,5.5
NC,2001,7,4167655,3925224,242431,5.8
NC,2001,8,4166823,3921246,245577,5.9
NC,2001,9,4166988,3914578,252410,6.1
NC,2001,10,4174013,3911647,262366,6.3
NC,2001,11,4179219,3900290,278929,6.7
NC,2001,12,4174188,3890727,283461,6.8
NC,2002,1,4203532,3909421,294111,7
NC,2002,2,4201374,3917938,283436,6.7
NC,2002,3,4204972,3919557,285415,6.8
NC,2002,4,4213251,3927740,285511,6.8
NC,2002,5,4210905,3930289,280616,6.7
NC,2002,6,4203067,3925022,278045,6.6
NC,2002,7,4212667,3934681,277986,6.6
NC,2002,8,4208089,3938944,269145,6.4
NC,2002,9,4212245,3938961,273284,6.5
NC,2002,10,4213620,3941432,272188,6.5
NC,2002,11,4217296,3942131,275165,6.5
NC,2002,12,4219195,3942717,276478,6.6
NC,2003,1,4227689,3956777,270912,6.4
NC,2003,2,4226288,3955567,270721,6.4
NC,2003,3,4229916,3958876,271040,6.4
NC,2003,4,4248392,3964743,283649,6.7
NC,2003,5,4255204,3979015,276189,6.5
NC,2003,6,4253653,3974131,279522,6.6
NC,2003,7,4242647,3956010,286637,6.8
NC,2003,8,4242874,3964699,278175,6.6
NC,2003,9,4253268,3979303,273965,6.4
NC,2003,10,4270692,3998277,272415,6.4
NC,2003,11,4261135,3994702,266433,6.3
NC,2003,12,4262205,4001522,260683,6.1
NC,2004,1,4255044,4003690,251354,5.9
NC,2004,2,4248189,3999474,248715,5.9
NC,2004,3,4250831,4009912,240919,5.7
NC,2004,4,4261130,4018393,242737,5.7
NC,2004,5,4259119,4021435,237684,5.6
NC,2004,6,4261419,4023238,238181,5.6
NC,2004,7,4272722,4044692,228030,5.3
NC,2004,8,4274823,4044997,229826,5.4
NC,2004,9,4276957,4047285,229672,5.4
NC,2004,10,4273462,4043757,229705,5.4
NC,2004,11,4280456,4050881,229575,5.4
NC,2004,12,4294709,4065214,229495,5.3
NC,2005,1,4300397,4076663,223734,5.2
NC,2005,2,4307283,4081903,225380,5.2
NC,2005,3,4311917,4087215,224702,5.2
NC,2005,4,4318184,4091222,226962,5.3
NC,2005,5,4316299,4087536,228763,5.3
NC,2005,6,4320156,4084537,235619,5.5
NC,2005,7,4337969,4100935,237034,5.5
NC,2005,8,4352030,4115402,236628,5.4
NC,2005,9,4364419,4131035,233384,5.3
NC,2005,10,4367717,4137016,230701,5.3
NC,2005,11,4370078,4147401,222677,5.1
NC,2005,12,4378268,4158808,219460,5
NC,2006,1,4392752,4184069,208683,4.8
NC,2006,2,4393134,4185463,207671,4.7
NC,2006,3,4397436,4193112,204324,4.6
NC,2006,4,4428684,4223473,205211,4.6
NC,2006,5,4436141,4226710,209431,4.7
NC,2006,6,4445610,4231850,213760,4.8
NC,2006,7,4460877,4248947,211930,4.8
NC,2006,8,4470618,4253862,216756,4.8
NC,2006,9,4468569,4250270,218299,4.9
NC,2006,10,4484065,4267920,216145,4.8
NC,2006,11,4504883,4289924,214959,4.8
NC,2006,12,4508373,4297148,211225,4.7
NC,2007,1,4491482,4289064,202418,4.5
NC,2007,2,4497065,4295485,201580,4.5
NC,2007,3,4500221,4300413,199808,4.4
NC,2007,4,4499363,4288382,210981,4.7
NC,2007,5,4508290,4293258,215032,4.8
NC,2007,6,4515668,4302020,213648,4.7
NC,2007,7,4497795,4286103,211692,4.7
NC,2007,8,4508110,4292503,215607,4.8
NC,2007,9,4508999,4289997,219002,4.9
NC,2007,10,4501431,4281475,219956,4.9
NC,2007,11,4519727,4295412,224315,5
NC,2007,12,4525570,4299675,225895,5
NC,2008,1,4516900,4289193,227707,5
NC,2008,2,4525319,4288102,237217,5.2
NC,2008,3,4520484,4276428,244056,5.4
NC,2008,4,4517957,4259593,258364,5.7
NC,2008,5,4523232,4256906,266326,5.9
NC,2008,6,4529795,4252189,277606,6.1
NC,2008,7,4536387,4248544,287843,6.3
NC,2008,8,4549056,4249334,299722,6.6
NC,2008,9,4570956,4262131,308825,6.8
NC,2008,10,4585464,4263369,322095,7
NC,2008,11,4572175,4228345,343830,7.5
NC,2008,12,4577313,4207640,369673,8.1
NC,2009,1,4552085,4109016,443069,9.7
ND,1976,1,275050,266373,8677,3.2
ND,1976,2,275240,266325,8915,3.2
ND,1976,3,275349,266363,8986,3.3
ND,1976,4,275324,266487,8837,3.2
ND,1976,5,276712,266698,10014,3.6
ND,1976,6,277369,266997,10372,3.7
ND,1976,7,277687,267383,10304,3.7
ND,1976,8,278633,267857,10776,3.9
ND,1976,9,279604,268419,11185,4
ND,1976,10,280750,269071,11679,4.2
ND,1976,11,281859,269814,12045,4.3
ND,1976,12,282923,270648,12275,4.3
ND,1977,1,284254,271575,12679,4.5
ND,1977,2,285410,272471,12939,4.5
ND,1977,3,287208,273338,13870,4.8
ND,1977,4,287275,274173,13102,4.6
ND,1977,5,287769,274977,12792,4.4
ND,1977,6,288806,275751,13055,4.5
ND,1977,7,289680,276492,13188,4.6
ND,1977,8,290695,277203,13492,4.6
ND,1977,9,291426,277883,13543,4.6
ND,1977,10,292419,278531,13888,4.7
ND,1977,11,292148,279145,13003,4.5
ND,1977,12,293001,279727,13274,4.5
ND,1978,1,293902,280275,13627,4.6
ND,1978,2,293749,280826,12923,4.4
ND,1978,3,293746,281378,12368,4.2
ND,1978,4,294335,281932,12403,4.2
ND,1978,5,294224,282486,11738,4
ND,1978,6,295370,283039,12331,4.2
ND,1978,7,295856,283589,12267,4.1
ND,1978,8,296518,284137,12381,4.2
ND,1978,9,296994,284681,12313,4.1
ND,1978,10,297471,285223,12248,4.1
ND,1978,11,298571,285762,12809,4.3
ND,1978,12,299633,286299,13334,4.5
ND,1979,1,299168,286835,12333,4.1
ND,1979,2,300343,287344,12999,4.3
ND,1979,3,300220,287826,12394,4.1
ND,1979,4,301830,288280,13550,4.5
ND,1979,5,301910,288707,13203,4.4
ND,1979,6,300090,289105,10985,3.7
ND,1979,7,300311,289473,10838,3.6
ND,1979,8,300570,289810,10760,3.6
ND,1979,9,301423,290118,11305,3.8
ND,1979,10,301717,290398,11319,3.8
ND,1979,11,303013,290649,12364,4.1
ND,1979,12,302908,290874,12034,4
ND,1980,1,303633,291072,12561,4.1
ND,1980,2,304065,291278,12787,4.2
ND,1980,3,305038,291492,13546,4.4
ND,1980,4,306610,291715,14895,4.9
ND,1980,5,306752,291947,14805,4.8
ND,1980,6,308619,292189,16430,5.3
ND,1980,7,309750,292442,17308,5.6
ND,1980,8,309800,292707,17093,5.5
ND,1980,9,309905,292985,16920,5.5
ND,1980,10,309240,293276,15964,5.2
ND,1980,11,309404,293578,15826,5.1
ND,1980,12,309885,293890,15995,5.2
ND,1981,1,310078,294212,15866,5.1
ND,1981,2,310834,294523,16311,5.2
ND,1981,3,310676,294823,15853,5.1
ND,1981,4,309293,295112,14181,4.6
ND,1981,5,310230,295388,14842,4.8
ND,1981,6,310746,295652,15094,4.9
ND,1981,7,310730,295903,14827,4.8
ND,1981,8,310608,296141,14467,4.7
ND,1981,9,310877,296365,14512,4.7
ND,1981,10,310774,296572,14202,4.6
ND,1981,11,310816,296763,14053,4.5
ND,1981,12,312011,296937,15074,4.8
ND,1982,1,313298,297094,16204,5.2
ND,1982,2,313237,297255,15982,5.1
ND,1982,3,313874,297420,16454,5.2
ND,1982,4,315560,297588,17972,5.7
ND,1982,5,315868,297762,18106,5.7
ND,1982,6,315697,297942,17755,5.6
ND,1982,7,316231,298126,18105,5.7
ND,1982,8,316862,298317,18545,5.9
ND,1982,9,317236,298513,18723,5.9
ND,1982,10,318581,298716,19865,6.2
ND,1982,11,318656,298928,19728,6.2
ND,1982,12,319212,299149,20063,6.3
ND,1983,1,320486,299378,21108,6.6
ND,1983,2,321632,299634,21998,6.8
ND,1983,3,322029,299916,22113,6.9
ND,1983,4,321679,300226,21453,6.7
ND,1983,5,320272,300562,19710,6.2
ND,1983,6,319924,300924,19000,5.9
ND,1983,7,319439,301312,18127,5.7
ND,1983,8,319791,301724,18067,5.6
ND,1983,9,319710,302160,17550,5.5
ND,1983,10,319595,302618,16977,5.3
ND,1983,11,320101,303099,17002,5.3
ND,1983,12,320987,303602,17385,5.4
ND,1984,1,321337,304126,17211,5.4
ND,1984,2,321712,304621,17091,5.3
ND,1984,3,322135,305086,17049,5.3
ND,1984,4,322962,305521,17441,5.4
ND,1984,5,323810,305924,17886,5.5
ND,1984,6,323823,306297,17526,5.4
ND,1984,7,323943,306639,17304,5.3
ND,1984,8,323970,306950,17020,5.3
ND,1984,9,324295,307229,17066,5.3
ND,1984,10,324924,307475,17449,5.4
ND,1984,11,325514,307690,17824,5.5
ND,1984,12,325750,307873,17877,5.5
ND,1985,1,326515,308024,18491,5.7
ND,1985,2,327171,308182,18989,5.8
ND,1985,3,327948,308346,19602,6
ND,1985,4,327380,308517,18863,5.8
ND,1985,5,326545,308694,17851,5.5
ND,1985,6,327047,308878,18169,5.6
ND,1985,7,327126,309067,18059,5.5
ND,1985,8,327260,309261,17999,5.5
ND,1985,9,327588,309461,18127,5.5
ND,1985,10,328611,309668,18943,5.8
ND,1985,11,328866,309881,18985,5.8
ND,1985,12,329421,310100,19321,5.9
ND,1986,1,329950,310326,19624,5.9
ND,1986,2,330451,310535,19916,6
ND,1986,3,331050,310727,20323,6.1
ND,1986,4,331273,310903,20370,6.1
ND,1986,5,331167,311064,20103,6.1
ND,1986,6,330727,311209,19518,5.9
ND,1986,7,330505,311340,19165,5.8
ND,1986,8,330326,311458,18868,5.7
ND,1986,9,330027,311561,18466,5.6
ND,1986,10,329721,311652,18069,5.5
ND,1986,11,330601,311729,18872,5.7
ND,1986,12,330570,311794,18776,5.7
ND,1987,1,329989,311846,18143,5.5
ND,1987,2,329393,311895,17498,5.3
ND,1987,3,329038,311939,17099,5.2
ND,1987,4,328767,311980,16787,5.1
ND,1987,5,328090,312015,16075,4.9
ND,1987,6,328316,312047,16269,5
ND,1987,7,328368,312073,16295,5
ND,1987,8,328643,312095,16548,5
ND,1987,9,328677,312111,16566,5
ND,1987,10,328877,312121,16756,5.1
ND,1987,11,329018,312126,16892,5.1
ND,1987,12,328817,312126,16691,5.1
ND,1988,1,328642,312119,16523,5
ND,1988,2,328465,312128,16337,5
ND,1988,3,327612,312150,15462,4.7
ND,1988,4,326610,312186,14424,4.4
ND,1988,5,327430,312236,15194,4.6
ND,1988,6,327401,312301,15100,4.6
ND,1988,7,327711,312380,15331,4.7
ND,1988,8,328268,312473,15795,4.8
ND,1988,9,328250,312580,15670,4.8
ND,1988,10,328137,312702,15435,4.7
ND,1988,11,327704,312838,14866,4.5
ND,1988,12,327906,312989,14917,4.5
ND,1989,1,327847,313155,14692,4.5
ND,1989,2,327587,313236,14351,4.4
ND,1989,3,327081,313233,13848,4.2
ND,1989,4,327403,313145,14258,4.4
ND,1989,5,326787,312973,13814,4.2
ND,1989,6,326637,312717,13920,4.3
ND,1989,7,326730,312377,14353,4.4
ND,1989,8,326262,311954,14308,4.4
ND,1989,9,326173,311450,14723,4.5
ND,1989,10,325243,310866,14377,4.4
ND,1989,11,324109,310203,13906,4.3
ND,1989,12,323272,309462,13810,4.3
ND,1990,1,321580,308641,12939,4
ND,1990,2,320298,307896,12402,3.9
ND,1990,3,319491,307227,12264,3.8
ND,1990,4,319012,306632,12380,3.9
ND,1990,5,318973,306113,12860,4
ND,1990,6,318859,305670,13189,4.1
ND,1990,7,318545,305303,13242,4.2
ND,1990,8,318069,305014,13055,4.1
ND,1990,9,318182,304802,13380,4.2
ND,1990,10,317831,304669,13162,4.1
ND,1990,11,317731,304613,13118,4.1
ND,1990,12,316965,304634,12331,3.9
ND,1991,1,317064,304734,12330,3.9
ND,1991,2,317750,304820,12930,4.1
ND,1991,3,318227,304894,13333,4.2
ND,1991,4,319029,304956,14073,4.4
ND,1991,5,319237,305006,14231,4.5
ND,1991,6,319209,305047,14162,4.4
ND,1991,7,318968,305078,13890,4.4
ND,1991,8,319337,305101,14236,4.5
ND,1991,9,319269,305114,14155,4.4
ND,1991,10,319253,305119,14134,4.4
ND,1991,11,319682,305115,14567,4.6
ND,1991,12,319366,305102,14264,4.5
ND,1992,1,319701,305082,14619,4.6
ND,1992,2,319996,305066,14930,4.7
ND,1992,3,320204,305052,15152,4.7
ND,1992,4,319734,305042,14692,4.6
ND,1992,5,320159,305035,15124,4.7
ND,1992,6,320417,305033,15384,4.8
ND,1992,7,320496,305034,15462,4.8
ND,1992,8,320711,305040,15671,4.9
ND,1992,9,320549,305049,15500,4.8
ND,1992,10,320655,305063,15592,4.9
ND,1992,11,320589,305079,15510,4.8
ND,1992,12,319949,305098,14851,4.6
ND,1993,1,319414,305120,14294,4.5
ND,1993,2,318986,305177,13809,4.3
ND,1993,3,319384,305271,14113,4.4
ND,1993,4,319576,305400,14176,4.4
ND,1993,5,320060,305565,14495,4.5
ND,1993,6,320316,305765,14551,4.5
ND,1993,7,320565,306000,14565,4.5
ND,1993,8,320919,306269,14650,4.6
ND,1993,9,321085,306574,14511,4.5
ND,1993,10,321398,306914,14484,4.5
ND,1993,11,338325,324248,14077,4.2
ND,1993,12,338464,324671,13793,4.1
ND,1994,1,338546,325133,13413,4
ND,1994,2,338965,325583,13382,3.9
ND,1994,3,339347,326022,13325,3.9
ND,1994,4,338837,326448,12389,3.7
ND,1994,5,339467,326862,12605,3.7
ND,1994,6,340012,327263,12749,3.7
ND,1994,7,340533,327650,12883,3.8
ND,1994,8,340626,328023,12603,3.7
ND,1994,9,340898,328382,12516,3.7
ND,1994,10,341127,328727,12400,3.6
ND,1994,11,340617,329059,11558,3.4
ND,1994,12,341395,329377,12018,3.5
ND,1995,1,341630,329681,11949,3.5
ND,1995,2,341504,329982,11522,3.4
ND,1995,3,340862,330280,10582,3.1
ND,1995,4,341287,330573,10714,3.1
ND,1995,5,342018,330862,11156,3.3
ND,1995,6,342503,331146,11357,3.3
ND,1995,7,342816,331425,11391,3.3
ND,1995,8,342869,331697,11172,3.3
ND,1995,9,343530,331963,11567,3.4
ND,1995,10,343919,332222,11697,3.4
ND,1995,11,344036,332475,11561,3.4
ND,1995,12,343730,332719,11011,3.2
ND,1996,1,343944,332956,10988,3.2
ND,1996,2,344068,333186,10882,3.2
ND,1996,3,344167,333410,10757,3.1
ND,1996,4,345264,333627,11637,3.4
ND,1996,5,344798,333837,10961,3.2
ND,1996,6,345158,334039,11119,3.2
ND,1996,7,345347,334233,11114,3.2
ND,1996,8,345355,334417,10938,3.2
ND,1996,9,345509,334592,10917,3.2
ND,1996,10,345455,334758,10697,3.1
ND,1996,11,345836,334914,10922,3.2
ND,1996,12,345909,335061,10848,3.1
ND,1997,1,345618,335199,10419,3
ND,1997,2,344842,335332,9510,2.8
ND,1997,3,345030,335461,9569,2.8
ND,1997,4,346547,335585,10962,3.2
ND,1997,5,348115,335706,12409,3.6
ND,1997,6,346737,335822,10915,3.1
ND,1997,7,346079,335935,10144,2.9
ND,1997,8,345491,336044,9447,2.7
ND,1997,9,345607,336148,9459,2.7
ND,1997,10,345436,336246,9190,2.7
ND,1997,11,345251,336339,8912,2.6
ND,1997,12,345502,336426,9076,2.6
ND,1998,1,345173,336506,8667,2.5
ND,1998,2,345650,336571,9079,2.6
ND,1998,3,346615,336623,9992,2.9
ND,1998,4,346053,336662,9391,2.7
ND,1998,5,346253,336688,9565,2.8
ND,1998,6,347219,336702,10517,3
ND,1998,7,347343,336705,10638,3.1
ND,1998,8,347949,336697,11252,3.2
ND,1998,9,347936,336682,11254,3.2
ND,1998,10,347970,336658,11312,3.3
ND,1998,11,348005,336625,11380,3.3
ND,1998,12,348076,336584,11492,3.3
ND,1999,1,348285,336536,11749,3.4
ND,1999,2,348666,336495,12171,3.5
ND,1999,3,348380,336463,11917,3.4
ND,1999,4,347377,336440,10937,3.1
ND,1999,5,347560,336427,11133,3.2
ND,1999,6,347291,336422,10869,3.1
ND,1999,7,348275,336428,11847,3.4
ND,1999,8,347317,336443,10874,3.1
ND,1999,9,347456,336468,10988,3.2
ND,1999,10,347463,336502,10961,3.2
ND,1999,11,346863,336546,10317,3
ND,1999,12,346674,336600,10074,2.9
ND,2000,1,346064,335474,10590,3.1
ND,2000,2,345603,335527,10076,2.9
ND,2000,3,345738,335582,10156,2.9
ND,2000,4,345532,335637,9895,2.9
ND,2000,5,345467,335692,9775,2.8
ND,2000,6,345921,335749,10172,2.9
ND,2000,7,345831,335806,10025,2.9
ND,2000,8,346708,335863,10845,3.1
ND,2000,9,345886,335920,9966,2.9
ND,2000,10,345567,335978,9589,2.8
ND,2000,11,346417,336036,10381,3
ND,2000,12,345840,336095,9745,2.8
ND,2001,1,345083,336155,8928,2.6
ND,2001,2,345470,336203,9267,2.7
ND,2001,3,345198,336239,8959,2.6
ND,2001,4,345910,336264,9646,2.8
ND,2001,5,345538,336278,9260,2.7
ND,2001,6,345809,336282,9527,2.8
ND,2001,7,345743,336277,9466,2.7
ND,2001,8,345685,336264,9421,2.7
ND,2001,9,345577,336243,9334,2.7
ND,2001,10,346285,336214,10071,2.9
ND,2001,11,346385,336179,10206,2.9
ND,2001,12,347150,336137,11013,3.2
ND,2002,1,345040,333590,11450,3.3
ND,2002,2,345014,333512,11502,3.3
ND,2002,3,345520,333456,12064,3.5
ND,2002,4,346179,333424,12755,3.7
ND,2002,5,345941,333417,12524,3.6
ND,2002,6,345755,333434,12321,3.6
ND,2002,7,345808,333477,12331,3.6
ND,2002,8,345605,333546,12059,3.5
ND,2002,9,346037,333642,12395,3.6
ND,2002,10,346205,333764,12441,3.6
ND,2002,11,346695,333913,12782,3.7
ND,2002,12,346240,334088,12152,3.5
ND,2003,1,347852,334955,12897,3.7
ND,2003,2,348050,335190,12860,3.7
ND,2003,3,348529,335431,13098,3.8
ND,2003,4,348526,335678,12848,3.7
ND,2003,5,348352,335931,12421,3.6
ND,2003,6,348536,336191,12345,3.5
ND,2003,7,348897,336456,12441,3.6
ND,2003,8,349426,336727,12699,3.6
ND,2003,9,349283,337002,12281,3.5
ND,2003,10,349480,337279,12201,3.5
ND,2003,11,350037,337558,12479,3.6
ND,2003,12,350185,337838,12347,3.5
ND,2004,1,350325,337902,12423,3.5
ND,2004,2,350690,338184,12506,3.6
ND,2004,3,350742,338473,12269,3.5
ND,2004,4,350403,338768,11635,3.3
ND,2004,5,350965,339066,11899,3.4
ND,2004,6,351344,339368,11976,3.4
ND,2004,7,351772,339673,12099,3.4
ND,2004,8,352327,339981,12346,3.5
ND,2004,9,352757,340293,12464,3.5
ND,2004,10,353100,340608,12492,3.5
ND,2004,11,353067,340926,12141,3.4
ND,2004,12,354117,341246,12871,3.6
ND,2005,1,354208,341570,12638,3.6
ND,2005,2,354326,341913,12413,3.5
ND,2005,3,354616,342273,12343,3.5
ND,2005,4,354751,342651,12100,3.4
ND,2005,5,355559,343047,12512,3.5
ND,2005,6,355965,343461,12504,3.5
ND,2005,7,356062,343893,12169,3.4
ND,2005,8,356522,344345,12177,3.4
ND,2005,9,357290,344815,12475,3.5
ND,2005,10,357572,345303,12269,3.4
ND,2005,11,357410,345809,11601,3.2
ND,2005,12,358191,346334,11857,3.3
ND,2006,1,358383,346876,11507,3.2
ND,2006,2,358785,347412,11373,3.2
ND,2006,3,359184,347939,11245,3.1
ND,2006,4,359783,348457,11326,3.1
ND,2006,5,360568,348967,11601,3.2
ND,2006,6,360999,349468,11531,3.2
ND,2006,7,361531,349959,11572,3.2
ND,2006,8,362044,350443,11601,3.2
ND,2006,9,362262,350918,11344,3.1
ND,2006,10,363291,351384,11907,3.3
ND,2006,11,364271,351839,12432,3.4
ND,2006,12,363421,352283,11138,3.1
ND,2007,1,363906,352715,11191,3.1
ND,2007,2,364672,353129,11543,3.2
ND,2007,3,365003,353524,11479,3.1
ND,2007,4,365619,353901,11718,3.2
ND,2007,5,365670,354260,11410,3.1
ND,2007,6,366053,354602,11451,3.1
ND,2007,7,366082,354925,11157,3
ND,2007,8,366558,355230,11328,3.1
ND,2007,9,367226,355518,11708,3.2
ND,2007,10,367218,355789,11429,3.1
ND,2007,11,366872,356041,10831,3
ND,2007,12,367626,356274,11352,3.1
ND,2008,1,367648,356487,11161,3
ND,2008,2,367766,356713,11053,3
ND,2008,3,367937,356954,10983,3
ND,2008,4,368411,357209,11202,3
ND,2008,5,368799,357479,11320,3.1
ND,2008,6,369350,357763,11587,3.1
ND,2008,7,370205,358062,12143,3.3
ND,2008,8,370499,358376,12123,3.3
ND,2008,9,370916,358706,12210,3.3
ND,2008,10,371007,359052,11955,3.2
ND,2008,11,371465,359414,12051,3.2
ND,2008,12,372052,359794,12258,3.3
ND,2009,1,371470,355898,15572,4.2
OH,1976,1,4777211,4387499,389712,8.2
OH,1976,2,4774384,4389079,385305,8.1
OH,1976,3,4773914,4390884,383030,8
OH,1976,4,4769857,4392875,376982,7.9
OH,1976,5,4766110,4395034,371076,7.8
OH,1976,6,4761307,4397760,363547,7.6
OH,1976,7,4757345,4401250,356095,7.5
OH,1976,8,4761516,4405767,355749,7.5
OH,1976,9,4765423,4411427,353996,7.4
OH,1976,10,4778367,4418018,360349,7.5
OH,1976,11,4789664,4426153,363511,7.6
OH,1976,12,4794344,4435611,358733,7.5
OH,1977,1,4793084,4446251,346833,7.2
OH,1977,2,4830511,4457383,373128,7.7
OH,1977,3,4808095,4469606,338489,7
OH,1977,4,4795858,4482417,313441,6.5
OH,1977,5,4802082,4495265,306817,6.4
OH,1977,6,4811155,4507940,303215,6.3
OH,1977,7,4814348,4520336,294012,6.1
OH,1977,8,4822367,4531967,290400,6
OH,1977,9,4835443,4542873,292570,6.1
OH,1977,10,4844891,4553425,291466,6
OH,1977,11,4852046,4563761,288285,5.9
OH,1977,12,4862853,4574004,288849,5.9
OH,1978,1,4860811,4584530,276281,5.7
OH,1978,2,4878277,4596042,282235,5.8
OH,1978,3,4893099,4608432,284667,5.8
OH,1978,4,4891548,4621882,269666,5.5
OH,1978,5,4901018,4635388,265630,5.4
OH,1978,6,4911590,4648551,263039,5.4
OH,1978,7,4924170,4660821,263349,5.3
OH,1978,8,4938380,4672376,266004,5.4
OH,1978,9,4954895,4683336,271559,5.5
OH,1978,10,4962864,4694336,268528,5.4
OH,1978,11,4973620,4704987,268633,5.4
OH,1978,12,4985827,4714970,270857,5.4
OH,1979,1,5007407,4723967,283440,5.7
OH,1979,2,5010697,4731047,279650,5.6
OH,1979,3,5013781,4736208,277573,5.5
OH,1979,4,5029550,4739254,290296,5.8
OH,1979,5,5023453,4740777,282676,5.6
OH,1979,6,5022393,4740317,282076,5.6
OH,1979,7,5029795,4737727,292068,5.8
OH,1979,8,5040503,4733266,307237,6.1
OH,1979,9,5027289,4727356,299933,6
OH,1979,10,5022186,4719692,302494,6
OH,1979,11,5021247,4710278,310969,6.2
OH,1979,12,5016497,4699266,317231,6.3
OH,1980,1,5013296,4686435,326861,6.5
OH,1980,2,5003998,4673873,330125,6.6
OH,1980,3,4994612,4661405,333207,6.7
OH,1980,4,5009473,4649152,360321,7.2
OH,1980,5,5111879,4637900,473979,9.3
OH,1980,6,5126987,4628534,498453,9.7
OH,1980,7,5128491,4621778,506713,9.9
OH,1980,8,5113571,4618237,495334,9.7
OH,1980,9,5101437,4617458,483979,9.5
OH,1980,10,5086738,4619055,467683,9.2
OH,1980,11,5076914,4622163,454751,9
OH,1980,12,5082458,4626372,456086,9
OH,1981,1,5105671,4631452,474219,9.3
OH,1981,2,5102725,4635203,467522,9.2
OH,1981,3,5100516,4637599,462917,9.1
OH,1981,4,5093528,4638409,455119,8.9
OH,1981,5,5099502,4637627,461875,9.1
OH,1981,6,5101617,4635277,466340,9.1
OH,1981,7,5104243,4631190,473053,9.3
OH,1981,8,5111380,4625118,486262,9.5
OH,1981,9,5111907,4616951,494956,9.7
OH,1981,10,5122138,4606635,515503,10.1
OH,1981,11,5140525,4594395,546130,10.6
OH,1981,12,5152499,4580806,571693,11.1
OH,1982,1,5162412,4566462,595950,11.5
OH,1982,2,5162177,4552593,609584,11.8
OH,1982,3,5163582,4539242,624340,12.1
OH,1982,4,5161822,4526596,635226,12.3
OH,1982,5,5149200,4514968,634232,12.3
OH,1982,6,5139449,4504106,635343,12.4
OH,1982,7,5139913,4493903,646010,12.6
OH,1982,8,5143551,4484581,658970,12.8
OH,1982,9,5153407,4476251,677156,13.1
OH,1982,10,5159947,4469194,690753,13.4
OH,1982,11,5175105,4463993,711112,13.7
OH,1982,12,5176383,4461205,715178,13.8
OH,1983,1,5175901,4460863,715038,13.8
OH,1983,2,5166500,4462376,704124,13.6
OH,1983,3,5167163,4465576,701587,13.6
OH,1983,4,5163034,4470416,692618,13.4
OH,1983,5,5159367,4476961,682406,13.2
OH,1983,6,5154074,4485338,668736,13
OH,1983,7,5071298,4495483,575815,11.4
OH,1983,8,5075809,4506657,569152,11.2
OH,1983,9,5078710,4519033,559677,11
OH,1983,10,5084465,4531987,552478,10.9
OH,1983,11,5088210,4545707,542503,10.7
OH,1983,12,5090616,4560158,530458,10.4
OH,1984,1,5090750,4575340,515410,10.1
OH,1984,2,5086406,4589445,496961,9.8
OH,1984,3,5102654,4602182,500472,9.8
OH,1984,4,5109162,4614067,495095,9.7
OH,1984,5,5114136,4625140,488996,9.6
OH,1984,6,5112085,4635410,476675,9.3
OH,1984,7,5113359,4644651,468708,9.2
OH,1984,8,5121840,4652693,469147,9.2
OH,1984,9,5127816,4659253,468563,9.1
OH,1984,10,5131699,4664645,467054,9.1
OH,1984,11,5138020,4668733,469287,9.1
OH,1984,12,5137956,4671536,466420,9.1
OH,1985,1,5132073,4673083,458990,8.9
OH,1985,2,5138939,4675263,463676,9
OH,1985,3,5142405,4678264,464141,9
OH,1985,4,5143460,4681884,461576,9
OH,1985,5,5135483,4685952,449531,8.8
OH,1985,6,5144476,4690305,454171,8.8
OH,1985,7,5152951,4695396,457555,8.9
OH,1985,8,5162934,4701255,461679,8.9
OH,1985,9,5172730,4707824,464906,9
OH,1985,10,5178472,4715204,463268,8.9
OH,1985,11,5186902,4723368,463534,8.9
OH,1985,12,5185670,4732268,453402,8.7
OH,1986,1,5185803,4741755,444048,8.6
OH,1986,2,5192195,4750710,441485,8.5
OH,1986,3,5199391,4759346,440045,8.5
OH,1986,4,5203558,4767893,435665,8.4
OH,1986,5,5208572,4776042,432530,8.3
OH,1986,6,5215407,4784024,431383,8.3
OH,1986,7,5215294,4792076,423218,8.1
OH,1986,8,5227524,4800033,427491,8.2
OH,1986,9,5235312,4807910,427402,8.2
OH,1986,10,5243988,4815842,428146,8.2
OH,1986,11,5237949,4823809,414140,7.9
OH,1986,12,5245059,4831688,413371,7.9
OH,1987,1,5245282,4839528,405754,7.7
OH,1987,2,5246812,4847233,399579,7.6
OH,1987,3,5249543,4854772,394771,7.5
OH,1987,4,5247484,4862417,385067,7.3
OH,1987,5,5250773,4870319,380454,7.2
OH,1987,6,5252761,4878468,374293,7.1
OH,1987,7,5256676,4887042,369634,7
OH,1987,8,5256423,4895991,360432,6.9
OH,1987,9,5254640,4905275,349365,6.6
OH,1987,10,5261514,4914815,346699,6.6
OH,1987,11,5263199,4924164,339035,6.4
OH,1987,12,5268818,4933200,335618,6.4
OH,1988,1,5278659,4941867,336792,6.4
OH,1988,2,5290108,4950748,339360,6.4
OH,1988,3,5301327,4960136,341191,6.4
OH,1988,4,5299302,4970127,329175,6.2
OH,1988,5,5306940,4979962,326978,6.2
OH,1988,6,5311008,4989802,321206,6
OH,1988,7,5312331,4999475,312856,5.9
OH,1988,8,5327293,5008964,318329,6
OH,1988,9,5338282,5018596,319686,6
OH,1988,10,5341843,5028218,313625,5.9
OH,1988,11,5341747,5037924,303823,5.7
OH,1988,12,5346253,5047713,298540,5.6
OH,1989,1,5343086,5057483,285603,5.3
OH,1989,2,5345241,5066156,279085,5.2
OH,1989,3,5355915,5073621,282294,5.3
OH,1989,4,5366759,5079659,287100,5.3
OH,1989,5,5382661,5084845,297816,5.5
OH,1989,6,5388663,5089315,299348,5.6
OH,1989,7,5391163,5092824,298339,5.5
OH,1989,8,5395865,5095268,300597,5.6
OH,1989,9,5404657,5096443,308214,5.7
OH,1989,10,5412805,5096450,316355,5.8
OH,1989,11,5408433,5095651,312782,5.8
OH,1989,12,5402126,5094008,308118,5.7
OH,1990,1,5405782,5091612,314170,5.8
OH,1990,2,5377391,5089972,287419,5.3
OH,1990,3,5373429,5088483,284946,5.3
OH,1990,4,5404490,5086893,317597,5.9
OH,1990,5,5401039,5085284,315755,5.8
OH,1990,6,5391925,5083350,308575,5.7
OH,1990,7,5387130,5080798,306332,5.7
OH,1990,8,5383291,5077844,305447,5.7
OH,1990,9,5381345,5074179,307166,5.7
OH,1990,10,5380976,5069836,311140,5.8
OH,1990,11,5390178,5065139,325039,6
OH,1990,12,5392387,5060276,332111,6.2
OH,1991,1,5393831,5055253,338578,6.3
OH,1991,2,5413595,5050560,363035,6.7
OH,1991,3,5416776,5046821,369955,6.8
OH,1991,4,5409120,5043919,365201,6.8
OH,1991,5,5390413,5042142,348271,6.5
OH,1991,6,5389754,5041439,348315,6.5
OH,1991,7,5389343,5041679,347664,6.5
OH,1991,8,5390011,5042457,347554,6.4
OH,1991,9,5394906,5043721,351185,6.5
OH,1991,10,5398034,5045350,352684,6.5
OH,1991,11,5404666,5047491,357175,6.6
OH,1991,12,5424493,5049936,374557,6.9
OH,1992,1,5443510,5052990,390520,7.2
OH,1992,2,5456943,5056278,400665,7.3
OH,1992,3,5465135,5059836,405299,7.4
OH,1992,4,5468312,5063676,404636,7.4
OH,1992,5,5474940,5067281,407659,7.4
OH,1992,6,5480228,5070576,409652,7.5
OH,1992,7,5476131,5073989,402142,7.3
OH,1992,8,5485931,5077364,408567,7.4
OH,1992,9,5485940,5081045,404895,7.4
OH,1992,10,5490527,5085251,405276,7.4
OH,1992,11,5487433,5089424,398009,7.3
OH,1992,12,5486517,5094082,392435,7.2
OH,1993,1,5485385,5099169,386216,7
OH,1993,2,5479358,5104301,375057,6.8
OH,1993,3,5484663,5109619,375044,6.8
OH,1993,4,5491995,5115739,376256,6.9
OH,1993,5,5497102,5122745,374357,6.8
OH,1993,6,5500106,5130558,369548,6.7
OH,1993,7,5510480,5139194,371286,6.7
OH,1993,8,5519359,5148408,370951,6.7
OH,1993,9,5527193,5158165,369028,6.7
OH,1993,10,5533313,5168426,364887,6.6
OH,1993,11,5538788,5179140,359648,6.5
OH,1993,12,5548837,5190354,358483,6.5
OH,1994,1,5542437,5202100,340337,6.1
OH,1994,2,5553676,5213370,340306,6.1
OH,1994,3,5565277,5223901,341376,6.1
OH,1994,4,5569655,5233584,336071,6
OH,1994,5,5576436,5242830,333606,6
OH,1994,6,5572366,5251623,320743,5.8
OH,1994,7,5576236,5260036,316200,5.7
OH,1994,8,5575006,5268432,306574,5.5
OH,1994,9,5576258,5276940,299318,5.4
OH,1994,10,5571539,5285135,286404,5.1
OH,1994,11,5567372,5292762,274610,4.9
OH,1994,12,5571809,5299670,272139,4.9
OH,1995,1,5569999,5305691,264308,4.7
OH,1995,2,5572729,5311420,261309,4.7
OH,1995,3,5575169,5316842,258327,4.6
OH,1995,4,5584351,5321587,262764,4.7
OH,1995,5,5596259,5325864,270395,4.8
OH,1995,6,5603145,5329906,273239,4.9
OH,1995,7,5611944,5333499,278445,5
OH,1995,8,5621289,5337308,283981,5.1
OH,1995,9,5622631,5341155,281476,5
OH,1995,10,5625041,5344598,280443,5
OH,1995,11,5634286,5347987,286299,5.1
OH,1995,12,5636477,5351230,285247,5.1
OH,1996,1,5640998,5354314,286684,5.1
OH,1996,2,5639466,5357814,281652,5
OH,1996,3,5650381,5361397,288984,5.1
OH,1996,4,5645472,5365398,280074,5
OH,1996,5,5653250,5369790,283460,5
OH,1996,6,5658578,5374401,284177,5
OH,1996,7,5658447,5379163,279284,4.9
OH,1996,8,5662837,5384222,278615,4.9
OH,1996,9,5670279,5389489,280790,5
OH,1996,10,5675425,5395365,280060,4.9
OH,1996,11,5687151,5401832,285319,5
OH,1996,12,5687373,5408706,278667,4.9
OH,1997,1,5693064,5416056,277008,4.9
OH,1997,2,5700638,5423079,277559,4.9
OH,1997,3,5699459,5429961,269498,4.7
OH,1997,4,5705908,5436440,269468,4.7
OH,1997,5,5707414,5442643,264771,4.6
OH,1997,6,5710182,5448326,261856,4.6
OH,1997,7,5714090,5453498,260592,4.6
OH,1997,8,5717696,5458100,259596,4.5
OH,1997,9,5723731,5462268,261463,4.6
OH,1997,10,5725376,5466021,259355,4.5
OH,1997,11,5727387,5469325,258062,4.5
OH,1997,12,5726440,5472213,254227,4.4
OH,1998,1,5716698,5474604,242094,4.2
OH,1998,2,5718391,5476837,241554,4.2
OH,1998,3,5722821,5479122,243699,4.3
OH,1998,4,5719391,5481551,237840,4.2
OH,1998,5,5729971,5483984,245987,4.3
OH,1998,6,5736542,5486254,250288,4.4
OH,1998,7,5765534,5488603,276931,4.8
OH,1998,8,5744841,5491809,253032,4.4
OH,1998,9,5745816,5495306,250510,4.4
OH,1998,10,5747044,5499026,248018,4.3
OH,1998,11,5747644,5502801,244843,4.3
OH,1998,12,5746120,5506631,239489,4.2
OH,1999,1,5753584,5510550,243034,4.2
OH,1999,2,5753242,5515021,238221,4.1
OH,1999,3,5760684,5519485,241199,4.2
OH,1999,4,5765493,5524072,241421,4.2
OH,1999,5,5773875,5528388,245487,4.3
OH,1999,6,5784975,5532811,252164,4.4
OH,1999,7,5790634,5537449,253185,4.4
OH,1999,8,5795153,5541498,253655,4.4
OH,1999,9,5799425,5545387,254038,4.4
OH,1999,10,5799448,5549163,250285,4.3
OH,1999,11,5797001,5552773,244228,4.2
OH,1999,12,5795195,5555920,239275,4.1
OH,2000,1,5794989,5560846,234143,4
OH,2000,2,5800956,5563491,237465,4.1
OH,2000,3,5793988,5566106,227882,3.9
OH,2000,4,5798471,5568463,230008,4
OH,2000,5,5806155,5570794,235361,4.1
OH,2000,6,5812747,5572947,239800,4.1
OH,2000,7,5813234,5574801,238433,4.1
OH,2000,8,5817722,5576496,241226,4.1
OH,2000,9,5816017,5578251,237766,4.1
OH,2000,10,5812311,5580084,232227,4
OH,2000,11,5808838,5581963,226875,3.9
OH,2000,12,5808997,5583603,225394,3.9
OH,2001,1,5815211,5584969,230242,4
OH,2001,2,5812663,5585116,227547,3.9
OH,2001,3,5811895,5584040,227855,3.9
OH,2001,4,5820530,5581731,238799,4.1
OH,2001,5,5824972,5578418,246554,4.2
OH,2001,6,5832256,5574243,258013,4.4
OH,2001,7,5833279,5568951,264328,4.5
OH,2001,8,5830191,5562943,267248,4.6
OH,2001,9,5828519,5556233,272286,4.7
OH,2001,10,5832374,5549083,283291,4.9
OH,2001,11,5834722,5541528,293194,5
OH,2001,12,5831180,5533566,297614,5.1
OH,2002,1,5838502,5524406,314096,5.4
OH,2002,2,5838214,5517316,320898,5.5
OH,2002,3,5842106,5511176,330930,5.7
OH,2002,4,5847376,5506025,341351,5.8
OH,2002,5,5842808,5502105,340703,5.8
OH,2002,6,5838304,5499228,339076,5.8
OH,2002,7,5835861,5497326,338535,5.8
OH,2002,8,5829729,5496134,333595,5.7
OH,2002,9,5832457,5495490,336967,5.8
OH,2002,10,5835130,5495344,339786,5.8
OH,2002,11,5835098,5495836,339262,5.8
OH,2002,12,5841037,5496920,344117,5.9
OH,2003,1,5845270,5495322,349948,6
OH,2003,2,5855397,5496342,359055,6.1
OH,2003,3,5862028,5497243,364785,6.2
OH,2003,4,5867335,5498196,369139,6.3
OH,2003,5,5863425,5498952,364473,6.2
OH,2003,6,5868397,5499421,368976,6.3
OH,2003,7,5872159,5499906,372253,6.3
OH,2003,8,5860709,5500304,360405,6.1
OH,2003,9,5858897,5500454,358443,6.1
OH,2003,10,5854608,5500554,354054,6
OH,2003,11,5854376,5500373,354003,6
OH,2003,12,5857650,5500158,357492,6.1
OH,2004,1,5854961,5496174,358787,6.1
OH,2004,2,5855831,5496332,359499,6.1
OH,2004,3,5854298,5496969,357329,6.1
OH,2004,4,5857038,5497801,359237,6.1
OH,2004,5,5857285,5498852,358433,6.1
OH,2004,6,5864835,5500336,364499,6.2
OH,2004,7,5865762,5502145,363617,6.2
OH,2004,8,5865480,5503949,361531,6.2
OH,2004,9,5866817,5505948,360869,6.2
OH,2004,10,5873070,5508213,364857,6.2
OH,2004,11,5872042,5510565,361477,6.2
OH,2004,12,5866256,5513108,353148,6
OH,2005,1,5870374,5515858,354516,6
OH,2005,2,5875745,5519527,356218,6.1
OH,2005,3,5882608,5523848,358760,6.1
OH,2005,4,5876633,5528754,347879,5.9
OH,2005,5,5884216,5533772,350444,6
OH,2005,6,5888840,5539167,349673,5.9
OH,2005,7,5886122,5545185,340937,5.8
OH,2005,8,5896364,5551541,344823,5.8
OH,2005,9,5899968,5558334,341634,5.8
OH,2005,10,5900508,5565325,335183,5.7
OH,2005,11,5901290,5572822,328468,5.6
OH,2005,12,5910746,5580700,330046,5.6
OH,2006,1,5912008,5589030,322978,5.5
OH,2006,2,5912118,5596863,315255,5.3
OH,2006,3,5917901,5603981,313920,5.3
OH,2006,4,5927533,5610194,317339,5.4
OH,2006,5,5935799,5615754,320045,5.4
OH,2006,6,5941056,5620769,320287,5.4
OH,2006,7,5952326,5625068,327258,5.5
OH,2006,8,5957590,5629002,328588,5.5
OH,2006,9,5957510,5632526,324984,5.5
OH,2006,10,5959110,5635514,323596,5.4
OH,2006,11,5963594,5638251,325343,5.5
OH,2006,12,5968086,5640767,327319,5.5
OH,2007,1,5966466,5642843,323623,5.4
OH,2007,2,5971279,5644300,326979,5.5
OH,2007,3,5974389,5645534,328855,5.5
OH,2007,4,5982863,5646149,336714,5.6
OH,2007,5,5982544,5646274,336270,5.6
OH,2007,6,5985760,5645679,340081,5.7
OH,2007,7,5976270,5644127,332143,5.6
OH,2007,8,5979998,5641995,338003,5.7
OH,2007,9,5979340,5639221,340119,5.7
OH,2007,10,5978932,5635869,343063,5.7
OH,2007,11,5970608,5631990,338618,5.7
OH,2007,12,5972245,5627276,344969,5.8
OH,2008,1,5964635,5621702,342933,5.7
OH,2008,2,5964848,5615671,349177,5.9
OH,2008,3,5975797,5609065,366732,6.1
OH,2008,4,5975843,5602606,373237,6.2
OH,2008,5,5974256,5595895,378361,6.3
OH,2008,6,5971795,5588687,383108,6.4
OH,2008,7,5979879,5581169,398710,6.7
OH,2008,8,5975291,5573045,402246,6.7
OH,2008,9,5968586,5564219,404367,6.8
OH,2008,10,5963400,5554765,408635,6.9
OH,2008,11,5968907,5544534,424373,7.1
OH,2008,12,5979250,5534164,445086,7.4
OH,2009,1,5958286,5434237,524049,8.8
OK,1976,1,1179265,1104543,74722,6.3
OK,1976,2,1179750,1107563,72187,6.1
OK,1976,3,1183730,1110681,73049,6.2
OK,1976,4,1185530,1113900,71630,6
OK,1976,5,1186119,1117264,68855,5.8
OK,1976,6,1188277,1120685,67592,5.7
OK,1976,7,1192921,1124254,68667,5.8
OK,1976,8,1195102,1127914,67188,5.6
OK,1976,9,1196981,1131752,65229,5.4
OK,1976,10,1200378,1135727,64651,5.4
OK,1976,11,1206155,1139842,66313,5.5
OK,1976,12,1210570,1144075,66495,5.5
OK,1977,1,1217657,1148441,69216,5.7
OK,1977,2,1220013,1152873,67140,5.5
OK,1977,3,1225786,1157313,68473,5.6
OK,1977,4,1228005,1161719,66286,5.4
OK,1977,5,1234133,1166111,68022,5.5
OK,1977,6,1235808,1170576,65232,5.3
OK,1977,7,1234394,1175033,59361,4.8
OK,1977,8,1237249,1179439,57810,4.7
OK,1977,9,1241823,1183794,58029,4.7
OK,1977,10,1244104,1188114,55990,4.5
OK,1977,11,1245918,1192438,53480,4.3
OK,1977,12,1248568,1196700,51868,4.2
OK,1978,1,1251701,1200892,50809,4.1
OK,1978,2,1267259,1205093,62166,4.9
OK,1978,3,1263050,1209362,53688,4.3
OK,1978,4,1263002,1213619,49383,3.9
OK,1978,5,1261993,1217860,44133,3.5
OK,1978,6,1262354,1222113,40241,3.2
OK,1978,7,1265675,1226295,39380,3.1
OK,1978,8,1267153,1230496,36657,2.9
OK,1978,9,1275130,1234680,40450,3.2
OK,1978,10,1280596,1238924,41672,3.3
OK,1978,11,1288712,1243166,45546,3.5
OK,1978,12,1292274,1247441,44833,3.5
OK,1979,1,1294317,1251764,42553,3.3
OK,1979,2,1302592,1256060,46532,3.6
OK,1979,3,1303649,1260294,43355,3.3
OK,1979,4,1306323,1264508,41815,3.2
OK,1979,5,1309482,1268634,40848,3.1
OK,1979,6,1314730,1272669,42061,3.2
OK,1979,7,1318416,1276640,41776,3.2
OK,1979,8,1323343,1280467,42876,3.2
OK,1979,9,1326175,1284167,42008,3.2
OK,1979,10,1330708,1287754,42954,3.2
OK,1979,11,1334869,1291288,43581,3.3
OK,1979,12,1339902,1294735,45167,3.4
OK,1980,1,1340227,1298113,42114,3.1
OK,1980,2,1343880,1301589,42291,3.1
OK,1980,3,1346954,1305278,41676,3.1
OK,1980,4,1354235,1309102,45133,3.3
OK,1980,5,1359256,1313156,46100,3.4
OK,1980,6,1396918,1317417,79501,5.7
OK,1980,7,1400363,1321911,78452,5.6
OK,1980,8,1404468,1326556,77912,5.5
OK,1980,9,1408841,1331385,77456,5.5
OK,1980,10,1410823,1336366,74457,5.3
OK,1980,11,1409503,1341526,67977,4.8
OK,1980,12,1408690,1346836,61854,4.4
OK,1981,1,1407214,1352331,54883,3.9
OK,1981,2,1407308,1357647,49661,3.5
OK,1981,3,1407212,1362731,44481,3.2
OK,1981,4,1417259,1367586,49673,3.5
OK,1981,5,1421515,1372187,49328,3.5
OK,1981,6,1425764,1376513,49251,3.5
OK,1981,7,1429288,1380541,48747,3.4
OK,1981,8,1435015,1384233,50782,3.5
OK,1981,9,1443939,1387548,56391,3.9
OK,1981,10,1450435,1390533,59902,4.1
OK,1981,11,1455924,1393150,62774,4.3
OK,1981,12,1462431,1395457,66974,4.6
OK,1982,1,1464772,1397375,67397,4.6
OK,1982,2,1467897,1399072,68825,4.7
OK,1982,3,1471134,1400544,70590,4.8
OK,1982,4,1476887,1401806,75081,5.1
OK,1982,5,1479524,1402836,76688,5.2
OK,1982,6,1485367,1403685,81682,5.5
OK,1982,7,1499113,1404395,94718,6.3
OK,1982,8,1500831,1404981,95850,6.4
OK,1982,9,1513269,1405412,107857,7.1
OK,1982,10,1523104,1405750,117354,7.7
OK,1982,11,1530022,1406107,123915,8.1
OK,1982,12,1535799,1406479,129320,8.4
OK,1983,1,1537662,1406835,130827,8.5
OK,1983,2,1547812,1407459,140353,9.1
OK,1983,3,1551198,1408375,142823,9.2
OK,1983,4,1548558,1409611,138947,9
OK,1983,5,1553717,1411079,142638,9.2
OK,1983,6,1553847,1412826,141021,9.1
OK,1983,7,1551409,1414832,136577,8.8
OK,1983,8,1548913,1417047,131866,8.5
OK,1983,9,1548654,1419526,129128,8.3
OK,1983,10,1548976,1422241,126735,8.2
OK,1983,11,1547456,1425195,122261,7.9
OK,1983,12,1546357,1428273,118084,7.6
OK,1984,1,1547695,1431592,116103,7.5
OK,1984,2,1544374,1434800,109574,7.1
OK,1984,3,1546604,1437820,108784,7
OK,1984,4,1550537,1440662,109875,7.1
OK,1984,5,1550715,1443376,107339,6.9
OK,1984,6,1551543,1445948,105595,6.8
OK,1984,7,1555892,1448337,107555,6.9
OK,1984,8,1561880,1450563,111317,7.1
OK,1984,9,1562177,1452605,109572,7
OK,1984,10,1561846,1454509,107337,6.9
OK,1984,11,1564296,1456200,108096,6.9
OK,1984,12,1564537,1457692,106845,6.8
OK,1985,1,1574656,1458959,115697,7.3
OK,1985,2,1579542,1459814,119728,7.6
OK,1985,3,1578289,1460277,118012,7.5
OK,1985,4,1575737,1460314,115423,7.3
OK,1985,5,1574943,1459994,114949,7.3
OK,1985,6,1574763,1459265,115498,7.3
OK,1985,7,1572509,1458201,114308,7.3
OK,1985,8,1569003,1456788,112215,7.2
OK,1985,9,1570132,1455035,115097,7.3
OK,1985,10,1568509,1452836,115673,7.4
OK,1985,11,1567272,1450234,117038,7.5
OK,1985,12,1566416,1447223,119193,7.6
OK,1986,1,1560923,1443831,117092,7.5
OK,1986,2,1564241,1440635,123606,7.9
OK,1986,3,1568634,1437720,130914,8.3
OK,1986,4,1570554,1435079,135475,8.6
OK,1986,5,1573855,1432756,141099,9
OK,1986,6,1570708,1430809,139899,8.9
OK,1986,7,1566637,1429197,137440,8.8
OK,1986,8,1576182,1428026,148156,9.4
OK,1986,9,1563980,1427310,136670,8.7
OK,1986,10,1560386,1427070,133316,8.5
OK,1986,11,1558645,1427226,131419,8.4
OK,1986,12,1556891,1427771,129120,8.3
OK,1987,1,1554639,1428724,125915,8.1
OK,1987,2,1556408,1429562,126846,8.1
OK,1987,3,1557733,1430261,127472,8.2
OK,1987,4,1554188,1430872,123316,7.9
OK,1987,5,1551284,1431310,119974,7.7
OK,1987,6,1549110,1431614,117496,7.6
OK,1987,7,1545413,1431858,113555,7.3
OK,1987,8,1539481,1432015,107466,7
OK,1987,9,1540101,1432008,108093,7
OK,1987,10,1542038,1431892,110146,7.1
OK,1987,11,1538796,1431616,107180,7
OK,1987,12,1535961,1431244,104717,6.8
OK,1988,1,1540150,1430717,109433,7.1
OK,1988,2,1532581,1430306,102275,6.7
OK,1988,3,1531831,1429953,101878,6.7
OK,1988,4,1530476,1429667,100809,6.6
OK,1988,5,1528495,1429432,99063,6.5
OK,1988,6,1527418,1429304,98114,6.4
OK,1988,7,1529615,1429276,100339,6.6
OK,1988,8,1529817,1429363,100454,6.6
OK,1988,9,1527627,1429593,98034,6.4
OK,1988,10,1527134,1429865,97269,6.4
OK,1988,11,1525895,1430209,95686,6.3
OK,1988,12,1526213,1430640,95573,6.3
OK,1989,1,1524709,1431158,93551,6.1
OK,1989,2,1525696,1431659,94037,6.2
OK,1989,3,1522887,1432164,90723,6
OK,1989,4,1522454,1432720,89734,5.9
OK,1989,5,1521044,1433219,87825,5.8
OK,1989,6,1520587,1433719,86868,5.7
OK,1989,7,1520150,1434175,85975,5.7
OK,1989,8,1519789,1434561,85228,5.6
OK,1989,9,1519156,1434856,84300,5.5
OK,1989,10,1514800,1435162,79638,5.3
OK,1989,11,1516066,1435484,80582,5.3
OK,1989,12,1520586,1435763,84823,5.6
OK,1990,1,1529479,1436002,93477,6.1
OK,1990,2,1518447,1436192,82255,5.4
OK,1990,3,1519004,1436268,82736,5.4
OK,1990,4,1518886,1436161,82725,5.4
OK,1990,5,1520384,1435952,84432,5.6
OK,1990,6,1518034,1435613,82421,5.4
OK,1990,7,1517804,1435109,82695,5.4
OK,1990,8,1521466,1434468,86998,5.7
OK,1990,9,1515185,1433717,81468,5.4
OK,1990,10,1521392,1432820,88572,5.8
OK,1990,11,1523668,1431801,91867,6
OK,1990,12,1526473,1430688,95785,6.3
OK,1991,1,1531804,1429481,102323,6.7
OK,1991,2,1519291,1428408,90883,6
OK,1991,3,1517373,1427487,89886,5.9
OK,1991,4,1520287,1426683,93604,6.2
OK,1991,5,1519582,1425998,93584,6.2
OK,1991,6,1518676,1425480,93196,6.1
OK,1991,7,1517139,1425082,92057,6.1
OK,1991,8,1518499,1424919,93580,6.2
OK,1991,9,1519132,1424916,94216,6.2
OK,1991,10,1520217,1425099,95118,6.3
OK,1991,11,1521618,1425404,96214,6.3
OK,1991,12,1522671,1425921,96750,6.4
OK,1992,1,1524031,1426560,97471,6.4
OK,1992,2,1530530,1427253,103277,6.7
OK,1992,3,1531199,1428043,103156,6.7
OK,1992,4,1524744,1428945,95799,6.3
OK,1992,5,1524925,1429906,95019,6.2
OK,1992,6,1526957,1430896,96061,6.3
OK,1992,7,1525737,1432043,93694,6.1
OK,1992,8,1525333,1433292,92041,6
OK,1992,9,1529529,1434709,94820,6.2
OK,1992,10,1523072,1436208,86864,5.7
OK,1992,11,1524617,1437759,86858,5.7
OK,1992,12,1532490,1439360,93130,6.1
OK,1993,1,1531014,1441050,89964,5.9
OK,1993,2,1531929,1442734,89195,5.8
OK,1993,3,1536492,1444380,92112,6
OK,1993,4,1541078,1446006,95072,6.2
OK,1993,5,1543571,1447658,95913,6.2
OK,1993,6,1545099,1449333,95766,6.2
OK,1993,7,1546041,1450964,95077,6.1
OK,1993,8,1547197,1452614,94583,6.1
OK,1993,9,1546657,1454182,92475,6
OK,1993,10,1548364,1455759,92605,6
OK,1993,11,1549581,1457322,92259,6
OK,1993,12,1548648,1458911,89737,5.8
OK,1994,1,1552922,1460458,92464,6
OK,1994,2,1554469,1461992,92477,5.9
OK,1994,3,1555663,1463573,92090,5.9
OK,1994,4,1556874,1465211,91663,5.9
OK,1994,5,1556111,1466869,89242,5.7
OK,1994,6,1555922,1468525,87397,5.6
OK,1994,7,1556490,1470224,86266,5.5
OK,1994,8,1558679,1471944,86735,5.6
OK,1994,9,1556943,1473682,83261,5.3
OK,1994,10,1557026,1475397,81629,5.2
OK,1994,11,1557476,1477129,80347,5.2
OK,1994,12,1558612,1478845,79767,5.1
OK,1995,1,1556173,1480599,75574,4.9
OK,1995,2,1556028,1482361,73667,4.7
OK,1995,3,1557322,1484129,73193,4.7
OK,1995,4,1556269,1485902,70367,4.5
OK,1995,5,1559096,1487734,71362,4.6
OK,1995,6,1560911,1489564,71347,4.6
OK,1995,7,1564330,1491430,72900,4.7
OK,1995,8,1566114,1493283,72831,4.7
OK,1995,9,1569371,1495161,74210,4.7
OK,1995,10,1570580,1497076,73504,4.7
OK,1995,11,1569643,1499022,70621,4.5
OK,1995,12,1567684,1500965,66719,4.3
OK,1996,1,1573557,1502922,70635,4.5
OK,1996,2,1575524,1504944,70580,4.5
OK,1996,3,1572030,1507034,64996,4.1
OK,1996,4,1575496,1509176,66320,4.2
OK,1996,5,1576675,1511386,65289,4.1
OK,1996,6,1577290,1513626,63664,4
OK,1996,7,1580286,1515846,64440,4.1
OK,1996,8,1582567,1518102,64465,4.1
OK,1996,9,1585078,1520380,64698,4.1
OK,1996,10,1587068,1522697,64371,4.1
OK,1996,11,1591516,1525019,66497,4.2
OK,1996,12,1592692,1527422,65270,4.1
OK,1997,1,1599302,1529884,69418,4.3
OK,1997,2,1596184,1532343,63841,4
OK,1997,3,1599764,1534747,65017,4.1
OK,1997,4,1602481,1537156,65325,4.1
OK,1997,5,1607868,1539570,68298,4.2
OK,1997,6,1610874,1541977,68897,4.3
OK,1997,7,1614486,1544393,70093,4.3
OK,1997,8,1616485,1546761,69724,4.3
OK,1997,9,1618928,1549130,69798,4.3
OK,1997,10,1619319,1551467,67852,4.2
OK,1997,11,1620108,1553797,66311,4.1
OK,1997,12,1620693,1556034,64659,4
OK,1998,1,1621224,1558247,62977,3.9
OK,1998,2,1625808,1560419,65389,4
OK,1998,3,1629957,1562561,67396,4.1
OK,1998,4,1635624,1564644,70980,4.3
OK,1998,5,1637760,1566711,71049,4.3
OK,1998,6,1643306,1568709,74597,4.5
OK,1998,7,1651289,1570695,80594,4.9
OK,1998,8,1648419,1572632,75787,4.6
OK,1998,9,1649607,1574558,75049,4.5
OK,1998,10,1650191,1576441,73750,4.5
OK,1998,11,1649125,1578276,70849,4.3
OK,1998,12,1649438,1580079,69359,4.2
OK,1999,1,1648406,1581846,66560,4
OK,1999,2,1649167,1583568,65599,4
OK,1999,3,1649849,1585250,64599,3.9
OK,1999,4,1649797,1586894,62903,3.8
OK,1999,5,1647729,1588561,59168,3.6
OK,1999,6,1648743,1590217,58526,3.5
OK,1999,7,1649374,1591823,57551,3.5
OK,1999,8,1649690,1593377,56313,3.4
OK,1999,9,1650875,1594906,55969,3.4
OK,1999,10,1652028,1596408,55620,3.4
OK,1999,11,1653254,1597885,55369,3.3
OK,1999,12,1654709,1599320,55389,3.3
OK,2000,1,1653050,1603186,49864,3
OK,2000,2,1655168,1604458,50710,3.1
OK,2000,3,1657646,1605776,51870,3.1
OK,2000,4,1658539,1607074,51465,3.1
OK,2000,5,1659978,1608318,51660,3.1
OK,2000,6,1662654,1609478,53176,3.2
OK,2000,7,1664088,1610527,53561,3.2
OK,2000,8,1665500,1611511,53989,3.2
OK,2000,9,1664916,1612413,52503,3.2
OK,2000,10,1664699,1613188,51511,3.1
OK,2000,11,1664083,1613877,50206,3
OK,2000,12,1662225,1614460,47765,2.9
OK,2001,1,1660016,1614965,45051,2.7
OK,2001,2,1666682,1615384,51298,3.1
OK,2001,3,1671619,1615661,55958,3.3
OK,2001,4,1668963,1615813,53150,3.2
OK,2001,5,1670158,1615783,54375,3.3
OK,2001,6,1675461,1615654,59807,3.6
OK,2001,7,1678364,1615250,63114,3.8
OK,2001,8,1680592,1614782,65810,3.9
OK,2001,9,1681803,1614194,67609,4
OK,2001,10,1685078,1613474,71604,4.2
OK,2001,11,1687364,1612732,74632,4.4
OK,2001,12,1688950,1611832,77118,4.6
OK,2002,1,1682099,1607365,74734,4.4
OK,2002,2,1682788,1606271,76517,4.5
OK,2002,3,1683675,1605245,78430,4.7
OK,2002,4,1685855,1604278,81577,4.8
OK,2002,5,1684521,1603345,81176,4.8
OK,2002,6,1680366,1602356,78010,4.6
OK,2002,7,1681176,1601413,79763,4.7
OK,2002,8,1681394,1600571,80823,4.8
OK,2002,9,1681891,1599711,82180,4.9
OK,2002,10,1682901,1598922,83979,5
OK,2002,11,1683785,1598250,85535,5.1
OK,2002,12,1687778,1597684,90094,5.3
OK,2003,1,1689212,1598493,90719,5.4
OK,2003,2,1690123,1598073,92050,5.4
OK,2003,3,1690906,1597727,93179,5.5
OK,2003,4,1692948,1597567,95381,5.6
OK,2003,5,1698672,1597556,101116,6
OK,2003,6,1698574,1597617,100957,5.9
OK,2003,7,1697255,1597897,99358,5.9
OK,2003,8,1695041,1598309,96732,5.7
OK,2003,9,1694234,1598886,95348,5.6
OK,2003,10,1694478,1599579,94899,5.6
OK,2003,11,1693968,1600360,93608,5.5
OK,2003,12,1693620,1601310,92310,5.5
OK,2004,1,1688583,1598476,90107,5.3
OK,2004,2,1688090,1599623,88467,5.2
OK,2004,3,1688137,1600841,87296,5.2
OK,2004,4,1688866,1602104,86762,5.1
OK,2004,5,1688322,1603372,84950,5
OK,2004,6,1692782,1604722,88060,5.2
OK,2004,7,1688764,1606158,82606,4.9
OK,2004,8,1687489,1607548,79941,4.7
OK,2004,9,1690571,1608993,81578,4.8
OK,2004,10,1691948,1610484,81464,4.8
OK,2004,11,1692831,1611933,80898,4.8
OK,2004,12,1690558,1613432,77126,4.6
OK,2005,1,1693551,1614909,78642,4.6
OK,2005,2,1692151,1616520,75631,4.5
OK,2005,3,1696457,1618213,78244,4.6
OK,2005,4,1696590,1620027,76563,4.5
OK,2005,5,1698060,1621837,76223,4.5
OK,2005,6,1702189,1623729,78460,4.6
OK,2005,7,1702260,1625687,76573,4.5
OK,2005,8,1704872,1627712,77160,4.5
OK,2005,9,1707349,1629788,77561,4.5
OK,2005,10,1708885,1631911,76974,4.5
OK,2005,11,1708718,1634115,74603,4.4
OK,2005,12,1709347,1636291,73056,4.3
OK,2006,1,1707251,1638386,68865,4
OK,2006,2,1707469,1640483,66986,3.9
OK,2006,3,1712399,1642504,69895,4.1
OK,2006,4,1714165,1644431,69734,4.1
OK,2006,5,1717077,1646379,70698,4.1
OK,2006,6,1717990,1648292,69698,4.1
OK,2006,7,1720418,1650061,70357,4.1
OK,2006,8,1724941,1651816,73125,4.2
OK,2006,9,1726379,1653518,72861,4.2
OK,2006,10,1727012,1655106,71906,4.2
OK,2006,11,1729415,1656672,72743,4.2
OK,2006,12,1730838,1658283,72555,4.2
OK,2007,1,1730982,1659774,71208,4.1
OK,2007,2,1733617,1661293,72324,4.2
OK,2007,3,1735206,1662792,72414,4.2
OK,2007,4,1737829,1664165,73664,4.2
OK,2007,5,1739860,1665531,74329,4.3
OK,2007,6,1740169,1666956,73213,4.2
OK,2007,7,1741487,1668271,73216,4.2
OK,2007,8,1739401,1669647,69754,4
OK,2007,9,1740221,1670965,69256,4
OK,2007,10,1740322,1672253,68069,3.9
OK,2007,11,1740217,1673536,66681,3.8
OK,2007,12,1736817,1674739,62078,3.6
OK,2008,1,1733291,1676022,57269,3.3
OK,2008,2,1732653,1677201,55452,3.2
OK,2008,3,1735230,1678299,56931,3.3
OK,2008,4,1739958,1679410,60548,3.5
OK,2008,5,1743609,1680478,63131,3.6
OK,2008,6,1748153,1681438,66715,3.8
OK,2008,7,1749922,1682477,67445,3.9
OK,2008,8,1751967,1683481,68486,3.9
OK,2008,9,1754445,1684466,69979,4
OK,2008,10,1760010,1685451,74559,4.2
OK,2008,11,1763972,1686325,77647,4.4
OK,2008,12,1767781,1687198,80583,4.6
OK,2009,1,1759834,1672133,87701,5
OR,1976,1,1082700,972262,110438,10.2
OR,1976,2,1079033,974974,104059,9.6
OR,1976,3,1080736,976842,103894,9.6
OR,1976,4,1083059,980549,102510,9.5
OR,1976,5,1084367,986022,98345,9.1
OR,1976,6,1087400,989113,98287,9
OR,1976,7,1096218,996113,100105,9.1
OR,1976,8,1102533,1001992,100541,9.1
OR,1976,9,1110189,1007458,102731,9.3
OR,1976,10,1114503,1013507,100996,9.1
OR,1976,11,1117655,1016208,101447,9.1
OR,1976,12,1120054,1021017,99037,8.8
OR,1977,1,1129520,1029768,99752,8.8
OR,1977,2,1135396,1035999,99397,8.8
OR,1977,3,1138228,1040045,98183,8.6
OR,1977,4,1141048,1048177,92871,8.1
OR,1977,5,1145537,1054887,90650,7.9
OR,1977,6,1148699,1062960,85739,7.5
OR,1977,7,1154839,1072565,82274,7.1
OR,1977,8,1159071,1077289,81782,7.1
OR,1977,9,1162825,1082305,80520,6.9
OR,1977,10,1166715,1089800,76915,6.6
OR,1977,11,1169068,1096720,72348,6.2
OR,1977,12,1174213,1101876,72337,6.2
OR,1978,1,1178632,1110822,67810,5.8
OR,1978,2,1184500,1116478,68022,5.7
OR,1978,3,1190122,1122172,67950,5.7
OR,1978,4,1195746,1126355,69391,5.8
OR,1978,5,1201264,1129567,71697,6
OR,1978,6,1207235,1135705,71530,5.9
OR,1978,7,1211183,1137980,73203,6
OR,1978,8,1216272,1142195,74077,6.1
OR,1978,9,1224132,1143694,80438,6.6
OR,1978,10,1227135,1146541,80594,6.6
OR,1978,11,1228153,1147788,80365,6.5
OR,1978,12,1230975,1149916,81059,6.6
OR,1979,1,1235667,1148222,87445,7.1
OR,1979,2,1239308,1154515,84793,6.8
OR,1979,3,1244029,1159035,84994,6.8
OR,1979,4,1244432,1159962,84470,6.8
OR,1979,5,1250114,1165473,84641,6.8
OR,1979,6,1253333,1171712,81621,6.5
OR,1979,7,1256846,1173577,83269,6.6
OR,1979,8,1262315,1178022,84293,6.7
OR,1979,9,1262342,1179661,82681,6.5
OR,1979,10,1262641,1181567,81074,6.4
OR,1979,11,1265574,1185028,80546,6.4
OR,1979,12,1272182,1188830,83352,6.6
OR,1980,1,1280993,1190853,90140,7
OR,1980,2,1276768,1190843,85925,6.7
OR,1980,3,1281330,1188656,92674,7.2
OR,1980,4,1295624,1188252,107372,8.3
OR,1980,5,1303757,1184825,118932,9.1
OR,1980,6,1303101,1182170,120931,9.3
OR,1980,7,1300918,1179671,121247,9.3
OR,1980,8,1299778,1182865,116913,9
OR,1980,9,1300662,1185276,115386,8.9
OR,1980,10,1303675,1189612,114063,8.7
OR,1980,11,1308426,1194087,114339,8.7
OR,1980,12,1316313,1198609,117704,8.9
OR,1981,1,1321327,1202337,118990,9
OR,1981,2,1324393,1199065,125328,9.5
OR,1981,3,1328082,1203192,124890,9.4
OR,1981,4,1329484,1203538,125946,9.5
OR,1981,5,1329356,1203916,125440,9.4
OR,1981,6,1329420,1201000,128420,9.7
OR,1981,7,1325930,1199357,126573,9.5
OR,1981,8,1329529,1197937,131592,9.9
OR,1981,9,1328967,1197332,131635,9.9
OR,1981,10,1329533,1191719,137814,10.4
OR,1981,11,1327233,1185411,141822,10.7
OR,1981,12,1336446,1185270,151176,11.3
OR,1982,1,1329061,1178849,150212,11.3
OR,1982,2,1329674,1176873,152801,11.5
OR,1982,3,1330190,1173848,156342,11.8
OR,1982,4,1327850,1172543,155307,11.7
OR,1982,5,1325777,1171788,153989,11.6
OR,1982,6,1321074,1169670,151404,11.5
OR,1982,7,1317685,1170650,147035,11.2
OR,1982,8,1318507,1167609,150898,11.4
OR,1982,9,1321775,1168517,153258,11.6
OR,1982,10,1320850,1167638,153212,11.6
OR,1982,11,1329307,1168960,160347,12.1
OR,1982,12,1330191,1171460,158731,11.9
OR,1983,1,1336902,1176783,160119,12
OR,1983,2,1335962,1179121,156841,11.7
OR,1983,3,1334109,1180728,153381,11.5
OR,1983,4,1332404,1183563,148841,11.2
OR,1983,5,1332909,1185293,147616,11.1
OR,1983,6,1331136,1189988,141148,10.6
OR,1983,7,1329176,1185658,143518,10.8
OR,1983,8,1325439,1183604,141835,10.7
OR,1983,9,1324576,1186689,137887,10.4
OR,1983,10,1327734,1189286,138448,10.4
OR,1983,11,1327258,1191593,135665,10.2
OR,1983,12,1328065,1192644,135421,10.2
OR,1984,1,1331373,1197786,133587,10
OR,1984,2,1330312,1204265,126047,9.5
OR,1984,3,1330616,1206188,124428,9.4
OR,1984,4,1334921,1206930,127991,9.6
OR,1984,5,1333815,1206835,126980,9.5
OR,1984,6,1330639,1205779,124860,9.4
OR,1984,7,1333693,1213402,120291,9
OR,1984,8,1334018,1214832,119186,8.9
OR,1984,9,1333528,1213229,120299,9
OR,1984,10,1335615,1211376,124239,9.3
OR,1984,11,1336536,1212403,124133,9.3
OR,1984,12,1336287,1211246,125041,9.4
OR,1985,1,1332426,1211999,120427,9
OR,1985,2,1333624,1211542,122082,9.2
OR,1985,3,1335482,1214238,121244,9.1
OR,1985,4,1334873,1213083,121790,9.1
OR,1985,5,1331031,1214846,116185,8.7
OR,1985,6,1330609,1215441,115168,8.7
OR,1985,7,1331001,1216051,114950,8.6
OR,1985,8,1330656,1219640,111016,8.3
OR,1985,9,1334429,1221730,112699,8.4
OR,1985,10,1338493,1227027,111466,8.3
OR,1985,11,1343885,1229811,114074,8.5
OR,1985,12,1347084,1232390,114694,8.5
OR,1986,1,1350382,1235201,115181,8.5
OR,1986,2,1355727,1239159,116568,8.6
OR,1986,3,1358453,1241512,116941,8.6
OR,1986,4,1361211,1245550,115661,8.5
OR,1986,5,1363646,1249992,113654,8.3
OR,1986,6,1364316,1253945,110371,8.1
OR,1986,7,1365500,1255670,109830,8
OR,1986,8,1366991,1259164,107827,7.9
OR,1986,9,1368847,1263988,104859,7.7
OR,1986,10,1369438,1268579,100859,7.4
OR,1986,11,1367644,1270595,97049,7.1
OR,1986,12,1367630,1275378,92252,6.7
OR,1987,1,1373007,1282254,90753,6.6
OR,1987,2,1375099,1286826,88273,6.4
OR,1987,3,1378638,1288552,90086,6.5
OR,1987,4,1378820,1291734,87086,6.3
OR,1987,5,1380598,1296031,84567,6.1
OR,1987,6,1384419,1299809,84610,6.1
OR,1987,7,1390198,1305608,84590,6.1
OR,1987,8,1392626,1307586,85040,6.1
OR,1987,9,1401676,1311120,90556,6.5
OR,1987,10,1405594,1315547,90047,6.4
OR,1987,11,1406175,1321285,84890,6
OR,1987,12,1408763,1323080,85683,6.1
OR,1988,1,1409336,1325627,83709,5.9
OR,1988,2,1415366,1331679,83687,5.9
OR,1988,3,1417959,1335013,82946,5.8
OR,1988,4,1420236,1337363,82873,5.8
OR,1988,5,1422654,1338120,84534,5.9
OR,1988,6,1427503,1342924,84579,5.9
OR,1988,7,1427367,1345939,81428,5.7
OR,1988,8,1431754,1349892,81862,5.7
OR,1988,9,1437040,1352720,84320,5.9
OR,1988,10,1437700,1357542,80158,5.6
OR,1988,11,1440624,1362075,78549,5.5
OR,1988,12,1443737,1366617,77120,5.3
OR,1989,1,1447381,1368072,79309,5.5
OR,1989,2,1448488,1368614,79874,5.5
OR,1989,3,1453318,1371341,81977,5.6
OR,1989,4,1452664,1373488,79176,5.5
OR,1989,5,1454965,1376722,78243,5.4
OR,1989,6,1460280,1382186,78094,5.3
OR,1989,7,1462245,1383449,78796,5.4
OR,1989,8,1464786,1385413,79373,5.4
OR,1989,9,1468314,1388743,79571,5.4
OR,1989,10,1467660,1389196,78464,5.3
OR,1989,11,1472173,1392626,79547,5.4
OR,1989,12,1474975,1399359,75616,5.1
OR,1990,1,1478917,1406026,72891,4.9
OR,1990,2,1486130,1406910,79220,5.3
OR,1990,3,1487636,1412165,75471,5.1
OR,1990,4,1494319,1419737,74582,5
OR,1990,5,1502778,1425984,76794,5.1
OR,1990,6,1510693,1428636,82057,5.4
OR,1990,7,1513938,1430160,83778,5.5
OR,1990,8,1521156,1437240,83916,5.5
OR,1990,9,1520083,1434368,85715,5.6
OR,1990,10,1520347,1433191,87156,5.7
OR,1990,11,1521191,1433436,87755,5.8
OR,1990,12,1517700,1430519,87181,5.7
OR,1991,1,1511893,1424534,87359,5.8
OR,1991,2,1513741,1425180,88561,5.9
OR,1991,3,1513855,1424111,89744,5.9
OR,1991,4,1515583,1422901,92682,6.1
OR,1991,5,1515205,1422928,92277,6.1
OR,1991,6,1519064,1424443,94621,6.2
OR,1991,7,1520964,1425113,95851,6.3
OR,1991,8,1523332,1425265,98067,6.4
OR,1991,9,1526606,1426463,100143,6.6
OR,1991,10,1533670,1428365,105305,6.9
OR,1991,11,1533418,1426144,107274,7
OR,1991,12,1536962,1427323,109639,7.1
OR,1992,1,1543897,1431086,112811,7.3
OR,1992,2,1547672,1431913,115759,7.5
OR,1992,3,1550434,1433998,116436,7.5
OR,1992,4,1554814,1440679,114135,7.3
OR,1992,5,1558325,1445777,112548,7.2
OR,1992,6,1559227,1446908,112319,7.2
OR,1992,7,1568839,1453864,114975,7.3
OR,1992,8,1567188,1453673,113515,7.2
OR,1992,9,1570866,1455889,114977,7.3
OR,1992,10,1574857,1459550,115307,7.3
OR,1992,11,1575778,1461659,114119,7.2
OR,1992,12,1576451,1461205,115246,7.3
OR,1993,1,1578124,1463109,115015,7.3
OR,1993,2,1581908,1470180,111728,7.1
OR,1993,3,1587069,1474705,112364,7.1
OR,1993,4,1592246,1477984,114262,7.2
OR,1993,5,1592850,1479222,113628,7.1
OR,1993,6,1599303,1485963,113340,7.1
OR,1993,7,1604856,1490043,114813,7.2
OR,1993,8,1605889,1493885,112004,7
OR,1993,9,1610830,1501002,109828,6.8
OR,1993,10,1614626,1508335,106291,6.6
OR,1993,11,1618223,1514135,104088,6.4
OR,1993,12,1623143,1519128,104015,6.4
OR,1994,1,1621694,1521411,100283,6.2
OR,1994,2,1625178,1525628,99550,6.1
OR,1994,3,1626796,1530249,96547,5.9
OR,1994,4,1628318,1535540,92778,5.7
OR,1994,5,1633073,1541154,91919,5.6
OR,1994,6,1637457,1546042,91415,5.6
OR,1994,7,1639534,1551269,88265,5.4
OR,1994,8,1643250,1556302,86948,5.3
OR,1994,9,1642130,1559463,82667,5
OR,1994,10,1641872,1560377,81495,5
OR,1994,11,1645591,1564790,80801,4.9
OR,1994,12,1647678,1566394,81284,4.9
OR,1995,1,1646148,1566833,79315,4.8
OR,1995,2,1649946,1569798,80148,4.9
OR,1995,3,1650617,1573302,77315,4.7
OR,1995,4,1652505,1574138,78367,4.7
OR,1995,5,1658401,1576102,82299,5
OR,1995,6,1662627,1580583,82044,4.9
OR,1995,7,1663554,1582686,80868,4.9
OR,1995,8,1670409,1588506,81903,4.9
OR,1995,9,1674176,1593647,80529,4.8
OR,1995,10,1677908,1594987,82921,4.9
OR,1995,11,1683770,1596678,87092,5.2
OR,1995,12,1689232,1600580,88652,5.2
OR,1996,1,1693503,1605231,88272,5.2
OR,1996,2,1698848,1605993,92855,5.5
OR,1996,3,1703309,1609800,93509,5.5
OR,1996,4,1705922,1611161,94761,5.6
OR,1996,5,1711064,1614929,96135,5.6
OR,1996,6,1712071,1615521,96550,5.6
OR,1996,7,1717740,1618766,98974,5.8
OR,1996,8,1720502,1622392,98110,5.7
OR,1996,9,1723447,1626279,97168,5.6
OR,1996,10,1726984,1627423,99561,5.8
OR,1996,11,1734379,1632556,101823,5.9
OR,1996,12,1735058,1632798,102260,5.9
OR,1997,1,1736161,1636458,99703,5.7
OR,1997,2,1738579,1638356,100223,5.8
OR,1997,3,1741947,1641039,100908,5.8
OR,1997,4,1744269,1646151,98118,5.6
OR,1997,5,1744862,1650664,94198,5.4
OR,1997,6,1748956,1652264,96692,5.5
OR,1997,7,1752281,1653862,98419,5.6
OR,1997,8,1755110,1656890,98220,5.6
OR,1997,9,1757286,1659993,97293,5.5
OR,1997,10,1761285,1664246,97039,5.5
OR,1997,11,1762708,1665404,97304,5.5
OR,1997,12,1766369,1670638,95731,5.4
OR,1998,1,1768247,1671835,96412,5.5
OR,1998,2,1769028,1673450,95578,5.4
OR,1998,3,1771708,1674673,97035,5.5
OR,1998,4,1774668,1676442,98226,5.5
OR,1998,5,1778491,1678629,99862,5.6
OR,1998,6,1780820,1678371,102449,5.8
OR,1998,7,1779118,1676694,102424,5.8
OR,1998,8,1781889,1678167,103722,5.8
OR,1998,9,1785122,1681272,103850,5.8
OR,1998,10,1786217,1681948,104269,5.8
OR,1998,11,1788036,1684058,103978,5.8
OR,1998,12,1789738,1685351,104387,5.8
OR,1999,1,1788769,1686848,101921,5.7
OR,1999,2,1789998,1687935,102063,5.7
OR,1999,3,1791941,1691427,100514,5.6
OR,1999,4,1790049,1692932,97117,5.4
OR,1999,5,1788168,1690626,97542,5.5
OR,1999,6,1791573,1691208,100365,5.6
OR,1999,7,1798728,1699284,99444,5.5
OR,1999,8,1797426,1697135,100291,5.6
OR,1999,9,1797567,1699010,98557,5.5
OR,1999,10,1801645,1705395,96250,5.3
OR,1999,11,1804743,1710912,93831,5.2
OR,1999,12,1808079,1714741,93338,5.2
OR,2000,1,1799600,1708949,90651,5
OR,2000,2,1802646,1711326,91320,5.1
OR,2000,3,1803440,1713052,90388,5
OR,2000,4,1805035,1715173,89862,5
OR,2000,5,1811297,1718046,93251,5.1
OR,2000,6,1811759,1718839,92920,5.1
OR,2000,7,1811142,1717297,93845,5.2
OR,2000,8,1815225,1717835,97390,5.4
OR,2000,9,1813489,1719341,94148,5.2
OR,2000,10,1815396,1718332,97064,5.3
OR,2000,11,1817504,1722775,94729,5.2
OR,2000,12,1815263,1722482,92781,5.1
OR,2001,1,1820187,1726085,94102,5.2
OR,2001,2,1824328,1723999,100329,5.5
OR,2001,3,1823405,1721415,101990,5.6
OR,2001,4,1824471,1717381,107090,5.9
OR,2001,5,1826781,1715845,110936,6.1
OR,2001,6,1828617,1715132,113485,6.2
OR,2001,7,1827766,1709083,118683,6.5
OR,2001,8,1830266,1707140,123126,6.7
OR,2001,9,1832144,1704413,127731,7
OR,2001,10,1833020,1701149,131871,7.2
OR,2001,11,1835044,1695992,139052,7.6
OR,2001,12,1835931,1694853,141078,7.7
OR,2002,1,1844584,1699070,145514,7.9
OR,2002,2,1843937,1699583,144354,7.8
OR,2002,3,1841987,1699800,142187,7.7
OR,2002,4,1842075,1701765,140310,7.6
OR,2002,5,1840593,1703196,137397,7.5
OR,2002,6,1840943,1703671,137272,7.5
OR,2002,7,1843964,1705905,138059,7.5
OR,2002,8,1844531,1708397,136134,7.4
OR,2002,9,1844638,1708465,136173,7.4
OR,2002,10,1845498,1707256,138242,7.5
OR,2002,11,1847319,1707060,140259,7.6
OR,2002,12,1844810,1705407,139403,7.6
OR,2003,1,1847650,1704544,143106,7.7
OR,2003,2,1847422,1702025,145397,7.9
OR,2003,3,1849431,1700102,149329,8.1
OR,2003,4,1851696,1696203,155493,8.4
OR,2003,5,1851541,1695682,155859,8.4
OR,2003,6,1852846,1695291,157555,8.5
OR,2003,7,1853030,1696263,156767,8.5
OR,2003,8,1851746,1698833,152913,8.3
OR,2003,9,1849945,1699108,150837,8.2
OR,2003,10,1850234,1702345,147889,8
OR,2003,11,1847187,1701591,145596,7.9
OR,2003,12,1847556,1704154,143402,7.8
OR,2004,1,1844117,1699533,144584,7.8
OR,2004,2,1843678,1702637,141041,7.6
OR,2004,3,1846506,1706260,140246,7.6
OR,2004,4,1847595,1711889,135706,7.3
OR,2004,5,1847780,1712045,135735,7.3
OR,2004,6,1850714,1713777,136937,7.4
OR,2004,7,1853254,1717535,135719,7.3
OR,2004,8,1853848,1717426,136422,7.4
OR,2004,9,1852398,1718950,133448,7.2
OR,2004,10,1853330,1721791,131539,7.1
OR,2004,11,1852754,1724274,128480,6.9
OR,2004,12,1850656,1727242,123414,6.7
OR,2005,1,1850253,1730234,120019,6.5
OR,2005,2,1852269,1733469,118800,6.4
OR,2005,3,1853456,1737415,116041,6.3
OR,2005,4,1858095,1740006,118089,6.4
OR,2005,5,1858742,1740777,117965,6.3
OR,2005,6,1862929,1744105,118824,6.4
OR,2005,7,1865011,1747288,117723,6.3
OR,2005,8,1867008,1750079,116929,6.3
OR,2005,9,1867423,1754383,113040,6.1
OR,2005,10,1869374,1757992,111382,6
OR,2005,11,1871566,1763598,107968,5.8
OR,2005,12,1875577,1769691,105886,5.6
OR,2006,1,1878098,1774777,103321,5.5
OR,2006,2,1881710,1780313,101397,5.4
OR,2006,3,1884520,1784000,100520,5.3
OR,2006,4,1889686,1789065,100621,5.3
OR,2006,5,1895094,1794669,100425,5.3
OR,2006,6,1899937,1798488,101449,5.3
OR,2006,7,1900975,1799414,101561,5.3
OR,2006,8,1903575,1801386,102189,5.4
OR,2006,9,1907105,1805176,101929,5.3
OR,2006,10,1910032,1808862,101170,5.3
OR,2006,11,1912907,1811803,101104,5.3
OR,2006,12,1913441,1814029,99412,5.2
OR,2007,1,1913717,1817444,96273,5
OR,2007,2,1916605,1820618,95987,5
OR,2007,3,1918152,1822761,95391,5
OR,2007,4,1917205,1821355,95850,5
OR,2007,5,1921232,1823691,97541,5.1
OR,2007,6,1924187,1825622,98565,5.1
OR,2007,7,1923019,1823325,99694,5.2
OR,2007,8,1926334,1826342,99992,5.2
OR,2007,9,1928537,1827505,101032,5.2
OR,2007,10,1933959,1831021,102938,5.3
OR,2007,11,1934537,1833299,101238,5.2
OR,2007,12,1937435,1834954,102481,5.3
OR,2008,1,1939496,1836577,102919,5.3
OR,2008,2,1942131,1837331,104800,5.4
OR,2008,3,1944465,1837812,106653,5.5
OR,2008,4,1947049,1838437,108612,5.6
OR,2008,5,1948331,1837452,110879,5.7
OR,2008,6,1951329,1835256,116073,5.9
OR,2008,7,1961165,1838410,122755,6.3
OR,2008,8,1964219,1836267,127952,6.5
OR,2008,9,1967027,1833513,133514,6.8
OR,2008,10,1970671,1827869,142802,7.2
OR,2008,11,1977264,1823509,153755,7.8
OR,2008,12,1982279,1818048,164231,8.3
OR,2009,1,1991703,1793542,198161,9.9
PA,1976,1,5132425,4718096,414329,8.1
PA,1976,2,5132566,4721890,410676,8
PA,1976,3,5120780,4704302,416478,8.1
PA,1976,4,5123022,4709101,413921,8.1
PA,1976,5,5113454,4699488,413966,8.1
PA,1976,6,5113931,4703827,410104,8
PA,1976,7,5128319,4722101,406218,7.9
PA,1976,8,5139136,4735960,403176,7.8
PA,1976,9,5136786,4731824,404962,7.9
PA,1976,10,5139633,4730697,408936,8
PA,1976,11,5149552,4736740,412812,8
PA,1976,12,5158608,4743291,415317,8.1
PA,1977,1,5165013,4745218,419795,8.1
PA,1977,2,5176693,4740258,436435,8.4
PA,1977,3,5191688,4779107,412581,7.9
PA,1977,4,5201407,4798175,403232,7.8
PA,1977,5,5202746,4804890,397856,7.6
PA,1977,6,5201666,4808557,393109,7.6
PA,1977,7,5211346,4818488,392858,7.5
PA,1977,8,5218645,4819870,398775,7.6
PA,1977,9,5224375,4832837,391538,7.5
PA,1977,10,5233776,4845285,388491,7.4
PA,1977,11,5237179,4851096,386083,7.4
PA,1977,12,5233212,4841084,392128,7.5
PA,1978,1,5241276,4852871,388405,7.4
PA,1978,2,5257473,4870732,386741,7.4
PA,1978,3,5271631,4887963,383668,7.3
PA,1978,4,5262903,4896233,366670,7
PA,1978,5,5273022,4911558,361464,6.9
PA,1978,6,5303143,4947234,355909,6.7
PA,1978,7,5309301,4946720,362581,6.8
PA,1978,8,5321069,4959779,361290,6.8
PA,1978,9,5321955,4964868,357087,6.7
PA,1978,10,5328373,4971494,356879,6.7
PA,1978,11,5337652,4980745,356907,6.7
PA,1978,12,5366241,5005146,361095,6.7
PA,1979,1,5370674,5005774,364900,6.8
PA,1979,2,5363403,4997742,365661,6.8
PA,1979,3,5364874,5004284,360590,6.7
PA,1979,4,5373481,5011671,361810,6.7
PA,1979,5,5385329,5027863,357466,6.6
PA,1979,6,5391231,5030677,360554,6.7
PA,1979,7,5394153,5026851,367302,6.8
PA,1979,8,5376741,5011752,364989,6.8
PA,1979,9,5391234,5022795,368439,6.8
PA,1979,10,5384072,5012596,371476,6.9
PA,1979,11,5403944,5026081,377863,7
PA,1979,12,5413623,5029065,384558,7.1
PA,1980,1,5429332,5033181,396151,7.3
PA,1980,2,5430518,5037492,393026,7.2
PA,1980,3,5424909,5020394,404515,7.5
PA,1980,4,5424178,5005953,418225,7.7
PA,1980,5,5427433,4999359,428074,7.9
PA,1980,6,5424009,4980537,443472,8.2
PA,1980,7,5412361,4949013,463348,8.6
PA,1980,8,5407702,4960691,447011,8.3
PA,1980,9,5409774,4968866,440908,8.2
PA,1980,10,5436089,5000908,435181,8
PA,1980,11,5436076,5003247,432829,8
PA,1980,12,5439388,5008990,430398,7.9
PA,1981,1,5460769,5028879,431890,7.9
PA,1981,2,5466410,5034861,431549,7.9
PA,1981,3,5488832,5053556,435276,7.9
PA,1981,4,5478757,5040246,438511,8
PA,1981,5,5477651,5031461,446190,8.1
PA,1981,6,5482656,5030801,451855,8.2
PA,1981,7,5499891,5048084,451807,8.2
PA,1981,8,5507215,5043000,464215,8.4
PA,1981,9,5481093,5003287,477806,8.7
PA,1981,10,5488473,4994506,493967,9
PA,1981,11,5493115,4988240,504875,9.2
PA,1981,12,5480336,4962164,518172,9.5
PA,1982,1,5482726,4943613,539113,9.8
PA,1982,2,5490837,4944063,546774,10
PA,1982,3,5486125,4922464,563661,10.3
PA,1982,4,5498439,4914634,583805,10.6
PA,1982,5,5490489,4897451,593038,10.8
PA,1982,6,5482967,4873703,609264,11.1
PA,1982,7,5493314,4868409,624905,11.4
PA,1982,8,5508093,4864004,644089,11.7
PA,1982,9,5505774,4848546,657228,11.9
PA,1982,10,5500065,4826054,674011,12.3
PA,1982,11,5507243,4820367,686876,12.5
PA,1982,12,5513680,4813701,699979,12.7
PA,1983,1,5501563,4797244,704319,12.8
PA,1983,2,5501675,4792827,708848,12.9
PA,1983,3,5506166,4795761,710405,12.9
PA,1983,4,5517175,4808521,708654,12.8
PA,1983,5,5536421,4832362,704059,12.7
PA,1983,6,5550954,4855021,695933,12.5
PA,1983,7,5478033,4885851,592182,10.8
PA,1983,8,5472025,4884389,587636,10.7
PA,1983,9,5494139,4912041,582098,10.6
PA,1983,10,5509197,4934899,574298,10.4
PA,1983,11,5506547,4941704,564843,10.3
PA,1983,12,5490159,4935471,554688,10.1
PA,1984,1,5493527,4953652,539875,9.8
PA,1984,2,5487993,4958482,529511,9.6
PA,1984,3,5482871,4957796,525075,9.6
PA,1984,4,5481717,4961890,519827,9.5
PA,1984,5,5496303,4983492,512811,9.3
PA,1984,6,5504149,5000581,503568,9.1
PA,1984,7,5501400,5005691,495709,9
PA,1984,8,5493082,5004250,488832,8.9
PA,1984,9,5508027,5020696,487331,8.8
PA,1984,10,5527462,5045184,482278,8.7
PA,1984,11,5540371,5060930,479441,8.7
PA,1984,12,5533324,5059255,474069,8.6
PA,1985,1,5509349,5051403,457946,8.3
PA,1985,2,5517446,5052606,464840,8.4
PA,1985,3,5524016,5066503,457513,8.3
PA,1985,4,5532758,5076734,456024,8.2
PA,1985,5,5536902,5083706,453196,8.2
PA,1985,6,5545200,5096282,448918,8.1
PA,1985,7,5557972,5112921,445051,8
PA,1985,8,5569778,5127488,442290,7.9
PA,1985,9,5581786,5141769,440017,7.9
PA,1985,10,5589032,5151557,437475,7.8
PA,1985,11,5584276,5148673,435603,7.8
PA,1985,12,5598949,5170220,428729,7.7
PA,1986,1,5598578,5177107,421471,7.5
PA,1986,2,5605123,5186515,418608,7.5
PA,1986,3,5621769,5207589,414180,7.4
PA,1986,4,5625323,5220604,404719,7.2
PA,1986,5,5629140,5229429,399711,7.1
PA,1986,6,5619450,5227646,391804,7
PA,1986,7,5621663,5238685,382978,6.8
PA,1986,8,5639883,5261793,378090,6.7
PA,1986,9,5634530,5259458,375072,6.7
PA,1986,10,5616371,5248407,367964,6.6
PA,1986,11,5603125,5242530,360595,6.4
PA,1986,12,5598416,5247904,350512,6.3
PA,1987,1,5606230,5268142,338088,6
PA,1987,2,5601678,5266766,334912,6
PA,1987,3,5600655,5270209,330446,5.9
PA,1987,4,5622655,5296663,325992,5.8
PA,1987,5,5643439,5319892,323547,5.7
PA,1987,6,5648522,5327572,320950,5.7
PA,1987,7,5659584,5345150,314434,5.6
PA,1987,8,5678337,5362556,315781,5.6
PA,1987,9,5690100,5373773,316327,5.6
PA,1987,10,5707102,5396545,310557,5.4
PA,1987,11,5704111,5395736,308375,5.4
PA,1987,12,5718540,5413939,304601,5.3
PA,1988,1,5720092,5413426,306666,5.4
PA,1988,2,5717480,5415256,302224,5.3
PA,1988,3,5710411,5411849,298562,5.2
PA,1988,4,5717505,5423187,294318,5.1
PA,1988,5,5709134,5415180,293954,5.1
PA,1988,6,5714528,5424677,289851,5.1
PA,1988,7,5739459,5453732,285727,5
PA,1988,8,5767591,5482510,285081,4.9
PA,1988,9,5760171,5477728,282443,4.9
PA,1988,10,5745162,5465912,279250,4.9
PA,1988,11,5752236,5477969,274267,4.8
PA,1988,12,5768101,5499890,268211,4.6
PA,1989,1,5796868,5530092,266776,4.6
PA,1989,2,5794872,5531158,263714,4.6
PA,1989,3,5805347,5540715,264632,4.6
PA,1989,4,5802066,5536076,265990,4.6
PA,1989,5,5799897,5529898,269999,4.7
PA,1989,6,5813895,5543525,270370,4.7
PA,1989,7,5809287,5538574,270713,4.7
PA,1989,8,5806301,5532407,273894,4.7
PA,1989,9,5816317,5539804,276513,4.8
PA,1989,10,5806017,5525351,280666,4.8
PA,1989,11,5816494,5533207,283287,4.9
PA,1989,12,5817710,5526697,291013,5
PA,1990,1,5821732,5531703,290029,5
PA,1990,2,5825301,5536323,288978,5
PA,1990,3,5836409,5544200,292209,5
PA,1990,4,5822618,5519480,303138,5.2
PA,1990,5,5828251,5522579,305672,5.2
PA,1990,6,5829639,5518425,311214,5.3
PA,1990,7,5823030,5505975,317055,5.4
PA,1990,8,5822063,5501949,320114,5.5
PA,1990,9,5829136,5500464,328672,5.6
PA,1990,10,5823956,5486810,337146,5.8
PA,1990,11,5824893,5476887,348006,6
PA,1990,12,5832961,5475313,357648,6.1
PA,1991,1,5827172,5459853,367319,6.3
PA,1991,2,5834898,5452711,382187,6.6
PA,1991,3,5823230,5430848,392382,6.7
PA,1991,4,5835251,5435942,399309,6.8
PA,1991,5,5830088,5429579,400509,6.9
PA,1991,6,5843019,5438399,404620,6.9
PA,1991,7,5829000,5420961,408039,7
PA,1991,8,5830133,5422835,407298,7
PA,1991,9,5847207,5434935,412272,7.1
PA,1991,10,5865924,5446352,419572,7.2
PA,1991,11,5868507,5442633,425874,7.3
PA,1991,12,5869234,5434225,435009,7.4
PA,1992,1,5888324,5445447,442877,7.5
PA,1992,2,5895318,5445507,449811,7.6
PA,1992,3,5891203,5437028,454175,7.7
PA,1992,4,5892427,5435003,457424,7.8
PA,1992,5,5907480,5447124,460356,7.8
PA,1992,6,5917462,5456255,461207,7.8
PA,1992,7,5911304,5453323,457981,7.7
PA,1992,8,5913471,5454423,459048,7.8
PA,1992,9,5921081,5462015,459066,7.8
PA,1992,10,5935890,5481684,454206,7.7
PA,1992,11,5929253,5478275,450978,7.6
PA,1992,12,5914669,5469322,445347,7.5
PA,1993,1,5927671,5492385,435286,7.3
PA,1993,2,5930316,5500999,429317,7.2
PA,1993,3,5911406,5477994,433412,7.3
PA,1993,4,5919068,5485971,433097,7.3
PA,1993,5,5923382,5494289,429093,7.2
PA,1993,6,5915249,5490975,424274,7.2
PA,1993,7,5917598,5500462,417136,7
PA,1993,8,5922707,5508015,414692,7
PA,1993,9,5929023,5518054,410969,6.9
PA,1993,10,5932442,5525289,407153,6.9
PA,1993,11,5927118,5526277,400841,6.8
PA,1993,12,5922953,5530514,392439,6.6
PA,1994,1,5909339,5516067,393272,6.7
PA,1994,2,5903713,5512491,391222,6.6
PA,1994,3,5911883,5518040,393843,6.7
PA,1994,4,5905811,5520005,385806,6.5
PA,1994,5,5918493,5536661,381832,6.5
PA,1994,6,5927827,5553130,374697,6.3
PA,1994,7,5903972,5533791,370181,6.3
PA,1994,8,5898467,5531657,366810,6.2
PA,1994,9,5891677,5529943,361734,6.1
PA,1994,10,5890651,5533040,357611,6.1
PA,1994,11,5882207,5530687,351520,6
PA,1994,12,5888208,5539102,349106,5.9
PA,1995,1,5885671,5538495,347176,5.9
PA,1995,2,5891392,5540636,350756,6
PA,1995,3,5903793,5557632,346161,5.9
PA,1995,4,5903507,5554369,349138,5.9
PA,1995,5,5887478,5538403,349075,5.9
PA,1995,6,5895125,5545795,349330,5.9
PA,1995,7,5889381,5543767,345614,5.9
PA,1995,8,5897974,5552898,345076,5.9
PA,1995,9,5902588,5559543,343045,5.8
PA,1995,10,5915467,5574112,341355,5.8
PA,1995,11,5919083,5574365,344718,5.8
PA,1995,12,5909046,5571622,337424,5.7
PA,1996,1,5899191,5547925,351266,6
PA,1996,2,5931583,5594910,336673,5.7
PA,1996,3,5949127,5615924,333203,5.6
PA,1996,4,5961798,5630731,331067,5.6
PA,1996,5,5972111,5645782,326329,5.5
PA,1996,6,5996091,5673545,322546,5.4
PA,1996,7,6004682,5683319,321363,5.4
PA,1996,8,6003904,5686221,317683,5.3
PA,1996,9,6012083,5693494,318589,5.3
PA,1996,10,6030560,5712243,318317,5.3
PA,1996,11,6041934,5725644,316290,5.2
PA,1996,12,6051404,5735777,315627,5.2
PA,1997,1,6072304,5757616,314688,5.2
PA,1997,2,6071601,5757459,314142,5.2
PA,1997,3,6072209,5757827,314382,5.2
PA,1997,4,6071881,5755636,316245,5.2
PA,1997,5,6082653,5766635,316018,5.2
PA,1997,6,6078353,5763051,315302,5.2
PA,1997,7,6089906,5776665,313241,5.1
PA,1997,8,6089035,5777673,311362,5.1
PA,1997,9,6091637,5782708,308929,5.1
PA,1997,10,6094806,5789976,304830,5
PA,1997,11,6101896,5801182,300714,4.9
PA,1997,12,6112954,5815707,297247,4.9
PA,1998,1,6089345,5800668,288677,4.7
PA,1998,2,6081648,5796275,285373,4.7
PA,1998,3,6078545,5792660,285885,4.7
PA,1998,4,6083533,5803902,279631,4.6
PA,1998,5,6076899,5795851,281048,4.6
PA,1998,6,6062960,5782227,280733,4.6
PA,1998,7,6061972,5782227,279745,4.6
PA,1998,8,6058424,5778059,280365,4.6
PA,1998,9,6049077,5767918,281159,4.6
PA,1998,10,6054019,5776373,277646,4.6
PA,1998,11,6059614,5784394,275220,4.5
PA,1998,12,6064078,5790559,273519,4.5
PA,1999,1,6069157,5794812,274345,4.5
PA,1999,2,6086890,5819727,267163,4.4
PA,1999,3,6091829,5821131,270698,4.4
PA,1999,4,6091251,5824874,266377,4.4
PA,1999,5,6095617,5825768,269849,4.4
PA,1999,6,6082677,5813041,269636,4.4
PA,1999,7,6083303,5813842,269461,4.4
PA,1999,8,6082100,5809319,272781,4.5
PA,1999,9,6062468,5792660,269808,4.5
PA,1999,10,6061393,5794920,266473,4.4
PA,1999,11,6054910,5793595,261315,4.3
PA,1999,12,6072318,5814201,258117,4.3
PA,2000,1,6071806,5820295,251511,4.1
PA,2000,2,6070613,5817199,253414,4.2
PA,2000,3,6065367,5820360,245007,4
PA,2000,4,6073660,5825160,248500,4.1
PA,2000,5,6074784,5822288,252496,4.2
PA,2000,6,6083610,5826824,256786,4.2
PA,2000,7,6086069,5831081,254988,4.2
PA,2000,8,6086531,5827465,259066,4.3
PA,2000,9,6099642,5840936,258706,4.2
PA,2000,10,6094698,5835827,258871,4.2
PA,2000,11,6108705,5848633,260072,4.3
PA,2000,12,6114507,5854749,259758,4.2
PA,2001,1,6139340,5876768,262572,4.3
PA,2001,2,6151017,5885491,265526,4.3
PA,2001,3,6162669,5892647,270022,4.4
PA,2001,4,6157826,5880293,277533,4.5
PA,2001,5,6165849,5881820,284029,4.6
PA,2001,6,6176835,5885474,291361,4.7
PA,2001,7,6164428,5866984,297444,4.8
PA,2001,8,6162195,5861065,301130,4.9
PA,2001,9,6180150,5873877,306273,5
PA,2001,10,6172986,5857327,315659,5.1
PA,2001,11,6183020,5859261,323759,5.2
PA,2001,12,6194528,5868832,325696,5.3
PA,2002,1,6208789,5873383,335406,5.4
PA,2002,2,6211705,5875007,336698,5.4
PA,2002,3,6219887,5881274,338613,5.4
PA,2002,4,6232229,5886969,345260,5.5
PA,2002,5,6231851,5884862,346989,5.6
PA,2002,6,6227019,5876831,350188,5.6
PA,2002,7,6226472,5873943,352529,5.7
PA,2002,8,6232969,5880519,352450,5.7
PA,2002,9,6225116,5871578,353538,5.7
PA,2002,10,6208837,5854241,354596,5.7
PA,2002,11,6197689,5841595,356094,5.7
PA,2002,12,6190750,5830483,360267,5.8
PA,2003,1,6151173,5797862,353311,5.7
PA,2003,2,6139153,5783195,355958,5.8
PA,2003,3,6142436,5786791,355645,5.8
PA,2003,4,6135252,5780492,354760,5.8
PA,2003,5,6125733,5775820,349913,5.7
PA,2003,6,6129315,5780685,348630,5.7
PA,2003,7,6137678,5785507,352171,5.7
PA,2003,8,6146451,5799056,347395,5.7
PA,2003,9,6141995,5795006,346989,5.6
PA,2003,10,6152384,5809247,343137,5.6
PA,2003,11,6166301,5824813,341488,5.5
PA,2003,12,6171737,5829942,341795,5.5
PA,2004,1,6157594,5818023,339571,5.5
PA,2004,2,6165272,5823919,341353,5.5
PA,2004,3,6178189,5838704,339485,5.5
PA,2004,4,6180783,5842636,338147,5.5
PA,2004,5,6188767,5849329,339438,5.5
PA,2004,6,6182384,5844098,338286,5.5
PA,2004,7,6200440,5861324,339116,5.5
PA,2004,8,6202337,5862412,339925,5.5
PA,2004,9,6217986,5881420,336566,5.4
PA,2004,10,6222001,5886697,335304,5.4
PA,2004,11,6230209,5898616,331593,5.3
PA,2004,12,6235587,5907548,328039,5.3
PA,2005,1,6240600,5916456,324144,5.2
PA,2005,2,6237184,5915557,321627,5.2
PA,2005,3,6234468,5911130,323338,5.2
PA,2005,4,6246918,5932997,313921,5
PA,2005,5,6254450,5940569,313881,5
PA,2005,6,6242092,5928875,313217,5
PA,2005,7,6251714,5942166,309548,5
PA,2005,8,6250209,5941420,308789,4.9
PA,2005,9,6256804,5953727,303077,4.8
PA,2005,10,6250247,5947461,302786,4.8
PA,2005,11,6254747,5956786,297961,4.8
PA,2005,12,6252924,5956943,295981,4.7
PA,2006,1,6262081,5965207,296874,4.7
PA,2006,2,6268165,5980388,287777,4.6
PA,2006,3,6278162,5991101,287061,4.6
PA,2006,4,6281932,5993073,288859,4.6
PA,2006,5,6275282,5988441,286841,4.6
PA,2006,6,6283060,5993293,289767,4.6
PA,2006,7,6281357,5993249,288108,4.6
PA,2006,8,6282435,5994965,287470,4.6
PA,2006,9,6289289,6005592,283697,4.5
PA,2006,10,6287609,6010942,276667,4.4
PA,2006,11,6290341,6014084,276257,4.4
PA,2006,12,6293741,6022097,271644,4.3
PA,2007,1,6293188,6024797,268391,4.3
PA,2007,2,6288077,6019562,268515,4.3
PA,2007,3,6281628,6014686,266942,4.2
PA,2007,4,6273976,6007383,266593,4.2
PA,2007,5,6284030,6016452,267578,4.3
PA,2007,6,6301995,6031655,270340,4.3
PA,2007,7,6293591,6022946,270645,4.3
PA,2007,8,6291684,6016240,275444,4.4
PA,2007,9,6301201,6021371,279830,4.4
PA,2007,10,6310764,6028764,282000,4.5
PA,2007,11,6317320,6033791,283529,4.5
PA,2007,12,6327806,6037440,290366,4.6
PA,2008,1,6346038,6051144,294894,4.6
PA,2008,2,6349244,6045176,304068,4.8
PA,2008,3,6348351,6037341,311010,4.9
PA,2008,4,6370021,6052194,317827,5
PA,2008,5,6392041,6066008,326033,5.1
PA,2008,6,6390988,6055012,335976,5.3
PA,2008,7,6396148,6049339,346809,5.4
PA,2008,8,6412907,6058361,354546,5.5
PA,2008,9,6423074,6063027,360047,5.6
PA,2008,10,6435447,6060448,374999,5.8
PA,2008,11,6432891,6039929,392962,6.1
PA,2008,12,6441455,6029493,411962,6.4
PA,2009,1,6445750,5995458,450292,7
PR,1976,1,834241,662846,171395,20.5
PR,1976,2,840036,670149,169887,20.2
PR,1976,3,852481,681781,170700,20
PR,1976,4,847006,689748,157258,18.6
PR,1976,5,859151,708126,151025,17.6
PR,1976,6,870778,699486,171292,19.7
PR,1976,7,872770,702431,170339,19.5
PR,1976,8,857914,688187,169727,19.8
PR,1976,9,857267,692799,164468,19.2
PR,1976,10,858576,691519,167057,19.5
PR,1976,11,873263,694583,178680,20.5
PR,1976,12,879207,705581,173626,19.7
PR,1977,1,865207,692341,172866,20
PR,1977,2,862910,704296,158614,18.4
PR,1977,3,859439,688003,171436,19.9
PR,1977,4,857863,675602,182261,21.2
PR,1977,5,864466,678979,185487,21.5
PR,1977,6,863970,679318,184652,21.4
PR,1977,7,871490,690419,181071,20.8
PR,1977,8,894562,719152,175410,19.6
PR,1977,9,896302,719108,177194,19.8
PR,1977,10,885190,716379,168811,19.1
PR,1977,11,889226,720321,168905,19
PR,1977,12,878023,714336,163687,18.6
PR,1978,1,898557,729849,168708,18.8
PR,1978,2,896477,728137,168340,18.8
PR,1978,3,884295,724923,159372,18
PR,1978,4,886391,733404,152987,17.3
PR,1978,5,884848,728971,155877,17.6
PR,1978,6,896136,729944,166192,18.5
PR,1978,7,873685,727220,146465,16.8
PR,1978,8,892734,730811,161923,18.1
PR,1978,9,897743,734893,162850,18.1
PR,1978,10,889657,726174,163483,18.4
PR,1978,11,893276,735281,157995,17.7
PR,1978,12,895292,728633,166659,18.6
PR,1979,1,895373,737803,157570,17.6
PR,1979,2,893647,739927,153720,17.2
PR,1979,3,901933,745814,156119,17.3
PR,1979,4,883420,734169,149251,16.9
PR,1979,5,890238,740503,149735,16.8
PR,1979,6,890485,742707,147778,16.6
PR,1979,7,901236,754318,146918,16.3
PR,1979,8,907332,758118,149214,16.4
PR,1979,9,908829,750531,158298,17.4
PR,1979,10,903882,749570,154312,17.1
PR,1979,11,906040,747056,158984,17.5
PR,1979,12,886235,733727,152508,17.2
PR,1980,1,901523,746902,154621,17.2
PR,1980,2,905720,749549,156171,17.2
PR,1980,3,908974,752060,156914,17.3
PR,1980,4,916575,759213,157362,17.2
PR,1980,5,917448,761755,155693,17
PR,1980,6,920553,770177,150376,16.3
PR,1980,7,923519,770653,152866,16.6
PR,1980,8,919820,763292,156528,17
PR,1980,9,913922,759253,154669,16.9
PR,1980,10,919752,759482,160270,17.4
PR,1980,11,915168,756488,158680,17.3
PR,1980,12,931287,766537,164750,17.7
PR,1981,1,923902,758553,165349,17.9
PR,1981,2,934451,765497,168954,18.1
PR,1981,3,923636,756345,167291,18.1
PR,1981,4,939311,759978,179333,19.1
PR,1981,5,931385,751464,179921,19.3
PR,1981,6,927603,740742,186861,20.1
PR,1981,7,927221,742081,185140,20
PR,1981,8,923242,734893,188349,20.4
PR,1981,9,918094,726975,191119,20.8
PR,1981,10,924976,733293,191683,20.7
PR,1981,11,923264,719132,204132,22.1
PR,1981,12,916341,715756,200585,21.9
PR,1982,1,914259,717938,196321,21.5
PR,1982,2,904488,705087,199401,22
PR,1982,3,917817,714947,202870,22.1
PR,1982,4,951068,731461,219607,23.1
PR,1982,5,918217,706105,212112,23.1
PR,1982,6,921957,708079,213878,23.2
PR,1982,7,913942,698013,215929,23.6
PR,1982,8,901589,691981,209608,23.2
PR,1982,9,920725,714938,205787,22.4
PR,1982,10,919419,705325,214094,23.3
PR,1982,11,917299,708335,208964,22.8
PR,1982,12,913623,695537,218086,23.9
PR,1983,1,924853,698455,226398,24.5
PR,1983,2,924774,700505,224269,24.3
PR,1983,3,930814,706680,224134,24.1
PR,1983,4,948315,732956,215359,22.7
PR,1983,5,952384,729725,222659,23.4
PR,1983,6,956452,733279,223173,23.3
PR,1983,7,954762,728702,226060,23.7
PR,1983,8,954756,732636,222120,23.3
PR,1983,9,978633,739208,239425,24.5
PR,1983,10,962780,744550,218230,22.7
PR,1983,11,972391,749786,222605,22.9
PR,1983,12,975418,765765,209653,21.5
PR,1984,1,989631,768075,221556,22.4
PR,1984,2,980210,776630,203580,20.8
PR,1984,3,971633,764706,206927,21.3
PR,1984,4,951583,758191,193392,20.3
PR,1984,5,964250,768225,196025,20.3
PR,1984,6,948523,759931,188592,19.9
PR,1984,7,969068,768079,200989,20.7
PR,1984,8,978117,772971,205146,21
PR,1984,9,980918,776377,204541,20.9
PR,1984,10,984384,784550,199834,20.3
PR,1984,11,989517,791189,198328,20
PR,1984,12,991799,788613,203186,20.5
PR,1985,1,975137,768265,206872,21.2
PR,1985,2,979798,767029,212769,21.7
PR,1985,3,987501,770545,216956,22
PR,1985,4,1001100,770499,230601,23
PR,1985,5,985664,768735,216929,22
PR,1985,6,999250,770102,229148,22.9
PR,1985,7,987194,772849,214345,21.7
PR,1985,8,997607,781051,216556,21.7
PR,1985,9,995323,783605,211718,21.3
PR,1985,10,993017,778153,214864,21.6
PR,1985,11,1001073,790720,210353,21
PR,1985,12,1001889,791974,209915,21
PR,1986,1,1001944,805059,196885,19.7
PR,1986,2,1019164,817253,201911,19.8
PR,1986,3,1020164,815789,204375,20
PR,1986,4,1002992,811500,191492,19.1
PR,1986,5,1016245,813333,202912,20
PR,1986,6,1015898,821141,194757,19.2
PR,1986,7,1040544,848419,192125,18.5
PR,1986,8,1040569,849891,190678,18.3
PR,1986,9,1039851,850750,189101,18.2
PR,1986,10,1057072,873233,183839,17.4
PR,1986,11,1040695,848102,192593,18.5
PR,1986,12,1046598,856388,190210,18.2
PR,1987,1,1048295,867714,180581,17.2
PR,1987,2,1048082,860748,187334,17.9
PR,1987,3,1044803,867934,176869,16.9
PR,1987,4,1061600,871825,189775,17.9
PR,1987,5,1047421,873104,174317,16.6
PR,1987,6,1056215,883523,172692,16.4
PR,1987,7,1058932,874562,184370,17.4
PR,1987,8,1053186,884580,168606,16
PR,1987,9,1055911,885928,169983,16.1
PR,1987,10,1064502,892557,171945,16.2
PR,1987,11,1070750,901992,168758,15.8
PR,1987,12,1080773,895729,185044,17.1
PR,1988,1,1082435,907464,174971,16.2
PR,1988,2,1089352,915090,174262,16
PR,1988,3,1080496,922810,157686,14.6
PR,1988,4,1108234,936961,171273,15.5
PR,1988,5,1106685,935758,170927,15.4
PR,1988,6,1120504,953295,167209,14.9
PR,1988,7,1107290,946262,161028,14.5
PR,1988,8,1099296,939506,159790,14.5
PR,1988,9,1107798,946631,161167,14.5
PR,1988,10,1111839,949065,162774,14.6
PR,1988,11,1114746,950287,164459,14.8
PR,1988,12,1110989,956087,154902,13.9
PR,1989,1,1098426,934077,164349,15
PR,1989,2,1121004,966716,154288,13.8
PR,1989,3,1110597,950746,159851,14.4
PR,1989,4,1103888,947563,156325,14.2
PR,1989,5,1103052,943876,159176,14.4
PR,1989,6,1102408,940964,161444,14.6
PR,1989,7,1126264,954920,171344,15.2
PR,1989,8,1127546,960171,167375,14.8
PR,1989,9,1127742,957442,170300,15.1
PR,1989,10,1108565,937803,170762,15.4
PR,1989,11,1126035,962814,163221,14.5
PR,1989,12,1124949,965419,159530,14.2
PR,1990,1,1120314,960693,159621,14.2
PR,1990,2,1110514,959696,150818,13.6
PR,1990,3,1122084,964065,158019,14.1
PR,1990,4,1127897,959860,168037,14.9
PR,1990,5,1120434,991252,129182,11.5
PR,1990,6,1143543,983159,160384,14
PR,1990,7,1123296,969583,153713,13.7
PR,1990,8,1138856,973247,165609,14.5
PR,1990,9,1145110,979447,165663,14.5
PR,1990,10,1134809,964197,170612,15
PR,1990,11,1140687,974294,166393,14.6
PR,1990,12,1161039,982415,178624,15.4
PR,1991,1,1161800,991061,170739,14.7
PR,1991,2,1173141,985790,187351,16
PR,1991,3,1162757,984390,178367,15.3
PR,1991,4,1179599,987256,192343,16.3
PR,1991,5,1164713,979877,184836,15.9
PR,1991,6,1164945,973182,191763,16.5
PR,1991,7,1168634,986535,182099,15.6
PR,1991,8,1155454,967939,187515,16.2
PR,1991,9,1167776,982411,185365,15.9
PR,1991,10,1176422,991682,184740,15.7
PR,1991,11,1173411,976933,196478,16.7
PR,1991,12,1177419,977629,199790,17
PR,1992,1,1174177,973909,200268,17.1
PR,1992,2,1157389,956254,201135,17.4
PR,1992,3,1171349,973733,197616,16.9
PR,1992,4,1181228,987142,194086,16.4
PR,1992,5,1193475,991522,201953,16.9
PR,1992,6,1208093,1011383,196710,16.3
PR,1992,7,1205087,995516,209571,17.4
PR,1992,8,1191623,1002490,189133,15.9
PR,1992,9,1204466,998799,205667,17.1
PR,1992,10,1208862,1014167,194695,16.1
PR,1992,11,1199434,1004545,194889,16.2
PR,1992,12,1189572,996820,192752,16.2
PR,1993,1,1190608,989745,200863,16.9
PR,1993,2,1194168,983905,210263,17.6
PR,1993,3,1224967,1013318,211649,17.3
PR,1993,4,1224529,1016148,208381,17
PR,1993,5,1245418,1028962,216456,17.4
PR,1993,6,1229088,1022308,206780,16.8
PR,1993,7,1208469,1000707,207762,17.2
PR,1993,8,1222146,1006426,215720,17.7
PR,1993,9,1217460,1013817,203643,16.7
PR,1993,10,1218695,1013373,205322,16.8
PR,1993,11,1221268,1018597,202671,16.6
PR,1993,12,1218922,1020706,198216,16.3
PR,1994,1,1211203,1012873,198330,16.4
PR,1994,2,1204600,1016270,188330,15.6
PR,1994,3,1197641,1016435,181206,15.1
PR,1994,4,1197071,1019728,177343,14.8
PR,1994,5,1202312,1036164,166148,13.8
PR,1994,6,1206474,1032363,174111,14.4
PR,1994,7,1219678,1048391,171287,14
PR,1994,8,1228912,1056073,172839,14.1
PR,1994,9,1215215,1046571,168644,13.9
PR,1994,10,1199203,1027113,172090,14.4
PR,1994,11,1209509,1036072,173437,14.3
PR,1994,12,1208428,1040599,167829,13.9
PR,1995,1,1232195,1066157,166038,13.5
PR,1995,2,1253808,1090233,163575,13
PR,1995,3,1239986,1069303,170683,13.8
PR,1995,4,1240700,1069291,171409,13.8
PR,1995,5,1220469,1055435,165034,13.5
PR,1995,6,1216991,1052741,164250,13.5
PR,1995,7,1243916,1068591,175325,14.1
PR,1995,8,1247278,1082698,164580,13.2
PR,1995,9,1247735,1075248,172487,13.8
PR,1995,10,1282872,1095146,187726,14.6
PR,1995,11,1265434,1095249,170185,13.4
PR,1995,12,1276316,1099986,176330,13.8
PR,1996,1,1273037,1099870,173167,13.6
PR,1996,2,1281411,1113204,168207,13.1
PR,1996,3,1266876,1102994,163882,12.9
PR,1996,4,1269131,1095010,174121,13.7
PR,1996,5,1279602,1092919,186683,14.6
PR,1996,6,1280456,1087517,192939,15.1
PR,1996,7,1294309,1116455,177854,13.7
PR,1996,8,1275097,1097797,177300,13.9
PR,1996,9,1283440,1110913,172527,13.4
PR,1996,10,1298999,1133401,165598,12.7
PR,1996,11,1306865,1146257,160608,12.3
PR,1996,12,1292046,1144688,147358,11.4
PR,1997,1,1301845,1141287,160558,12.3
PR,1997,2,1295924,1130025,165899,12.8
PR,1997,3,1292928,1123849,169079,13.1
PR,1997,4,1303669,1124391,179278,13.8
PR,1997,5,1300565,1122025,178540,13.7
PR,1997,6,1318748,1132841,185907,14.1
PR,1997,7,1313927,1130198,183729,14
PR,1997,8,1325378,1150052,175326,13.2
PR,1997,9,1337070,1162025,175045,13.1
PR,1997,10,1315422,1139249,176173,13.4
PR,1997,11,1320191,1136326,183865,13.9
PR,1997,12,1288022,1102699,185323,14.4
PR,1998,1,1303926,1118860,185066,14.2
PR,1998,2,1311784,1129207,182577,13.9
PR,1998,3,1324665,1145019,179646,13.6
PR,1998,4,1317244,1138859,178385,13.5
PR,1998,5,1325308,1151507,173801,13.1
PR,1998,6,1329970,1153787,176183,13.2
PR,1998,7,1309897,1138671,171226,13.1
PR,1998,8,1300715,1135580,165135,12.7
PR,1998,9,1318348,1141427,176921,13.4
PR,1998,10,1267855,1093208,174647,13.8
PR,1998,11,1305444,1135259,170185,13
PR,1998,12,1317234,1154715,162519,12.3
PR,1999,1,1327080,1160652,166428,12.5
PR,1999,2,1312737,1149697,163040,12.4
PR,1999,3,1312420,1143561,168859,12.9
PR,1999,4,1303836,1158543,145293,11.1
PR,1999,5,1297426,1152597,144829,11.2
PR,1999,6,1293101,1147999,145102,11.2
PR,1999,7,1273494,1140085,133409,10.5
PR,1999,8,1279962,1133448,146514,11.4
PR,1999,9,1279446,1130017,149429,11.7
PR,1999,10,1289245,1133929,155316,12
PR,1999,11,1278537,1121364,157173,12.3
PR,1999,12,1289117,1141631,147486,11.4
PR,2000,1,1302106,1151928,150178,11.5
PR,2000,2,1293875,1162467,131408,10.2
PR,2000,3,1310077,1172791,137286,10.5
PR,2000,4,1291822,1159575,132247,10.2
PR,2000,5,1322745,1188638,134107,10.1
PR,2000,6,1290757,1164180,126577,9.8
PR,2000,7,1302999,1175875,127124,9.8
PR,2000,8,1286292,1150552,135740,10.6
PR,2000,9,1284484,1164035,120449,9.4
PR,2000,10,1277396,1153558,123838,9.7
PR,2000,11,1277861,1154974,122887,9.6
PR,2000,12,1280996,1149383,131613,10.3
PR,2001,1,1270305,1137967,132338,10.4
PR,2001,2,1275152,1133820,141332,11.1
PR,2001,3,1261584,1125906,135678,10.8
PR,2001,4,1271657,1127041,144616,11.4
PR,2001,5,1272396,1126303,146093,11.5
PR,2001,6,1271076,1129922,141154,11.1
PR,2001,7,1257971,1124178,133793,10.6
PR,2001,8,1284349,1128779,155570,12.1
PR,2001,9,1293369,1134591,158778,12.3
PR,2001,10,1294810,1135077,159733,12.3
PR,2001,11,1307489,1153549,153940,11.8
PR,2001,12,1292770,1150492,142278,11
PR,2002,1,1310984,1160088,150896,11.5
PR,2002,2,1349304,1169589,179715,13.3
PR,2002,3,1331041,1168801,162240,12.2
PR,2002,4,1329044,1168820,160224,12.1
PR,2002,5,1323486,1161214,162272,12.3
PR,2002,6,1335373,1166455,168918,12.6
PR,2002,7,1331247,1162904,168343,12.6
PR,2002,8,1342481,1174387,168094,12.5
PR,2002,9,1342355,1176571,165784,12.4
PR,2002,10,1335696,1178198,157498,11.8
PR,2002,11,1341322,1185498,155824,11.6
PR,2002,12,1324964,1163824,161140,12.2
PR,2003,1,1355442,1200497,154945,11.4
PR,2003,2,1359455,1188159,171296,12.6
PR,2003,3,1363027,1196832,166195,12.2
PR,2003,4,1377926,1206543,171383,12.4
PR,2003,5,1385198,1217842,167356,12.1
PR,2003,6,1373285,1203384,169901,12.4
PR,2003,7,1371779,1207563,164216,12
PR,2003,8,1356188,1197324,158864,11.7
PR,2003,9,1334341,1175057,159284,11.9
PR,2003,10,1359234,1205401,153833,11.3
PR,2003,11,1364074,1194357,169717,12.4
PR,2003,12,1362728,1211679,151049,11.1
PR,2004,1,1360042,1205593,154449,11.4
PR,2004,2,1355510,1205120,150390,11.1
PR,2004,3,1374687,1212057,162630,11.8
PR,2004,4,1364922,1212950,151972,11.1
PR,2004,5,1356258,1210115,146143,10.8
PR,2004,6,1361222,1228175,133047,9.8
PR,2004,7,1363909,1233965,129944,9.5
PR,2004,8,1389208,1236081,153127,11
PR,2004,9,1386189,1252156,134033,9.7
PR,2004,10,1381665,1246839,134826,9.8
PR,2004,11,1378502,1238280,140222,10.2
PR,2004,12,1385355,1237710,147645,10.7
PR,2005,1,1378597,1229454,149143,10.8
PR,2005,2,1369514,1225442,144072,10.5
PR,2005,3,1382458,1222588,159870,11.6
PR,2005,4,1371493,1210895,160598,11.7
PR,2005,5,1403378,1251311,152067,10.8
PR,2005,6,1427143,1266653,160490,11.2
PR,2005,7,1423401,1262080,161321,11.3
PR,2005,8,1435422,1279477,155945,10.9
PR,2005,9,1448022,1293574,154448,10.7
PR,2005,10,1428284,1255010,173274,12.1
PR,2005,11,1439073,1255320,183753,12.8
PR,2005,12,1418327,1256755,161572,11.4
PR,2006,1,1390204,1230064,160140,11.5
PR,2006,2,1404800,1259491,145309,10.3
PR,2006,3,1410216,1278037,132179,9.4
PR,2006,4,1427058,1282816,144242,10.1
PR,2006,5,1413896,1257545,156351,11.1
PR,2006,6,1403019,1251558,151461,10.8
PR,2006,7,1389330,1236759,152571,11
PR,2006,8,1398945,1254701,144244,10.3
PR,2006,9,1413465,1258661,154804,11
PR,2006,10,1405900,1277192,128708,9.2
PR,2006,11,1414213,1275073,139140,9.8
PR,2006,12,1411065,1270046,141019,10
PR,2007,1,1420803,1280791,140012,9.9
PR,2007,2,1448103,1284631,163472,11.3
PR,2007,3,1422571,1273554,149017,10.5
PR,2007,4,1410536,1263873,146663,10.4
PR,2007,5,1394412,1248460,145952,10.5
PR,2007,6,1384221,1229422,154799,11.2
PR,2007,7,1384457,1227935,156522,11.3
PR,2007,8,1382775,1223557,159218,11.5
PR,2007,9,1369980,1217613,152367,11.1
PR,2007,10,1373993,1216409,157584,11.5
PR,2007,11,1369609,1216759,152850,11.2
PR,2007,12,1364781,1215555,149226,10.9
PR,2008,1,1365516,1219141,146375,10.7
PR,2008,2,1370573,1218508,152065,11.1
PR,2008,3,1352424,1220262,132162,9.8
PR,2008,4,1355107,1212409,142698,10.5
PR,2008,5,1366127,1211610,154517,11.3
PR,2008,6,1361773,1209453,152320,11.2
PR,2008,7,1366832,1209358,157474,11.5
PR,2008,8,1370679,1206518,164161,12
PR,2008,9,1370723,1206712,164011,12
PR,2008,10,1365672,1198264,167408,12.3
PR,2008,11,1374045,1200881,173164,12.6
PR,2008,12,1377129,1191237,185892,13.5
PR,2009,1,1353215,1177387,175828,13
RI,1976,1,442802,409083,33719,7.6
RI,1976,2,441826,407817,34009,7.7
RI,1976,3,441957,407667,34290,7.8
RI,1976,4,442435,407871,34564,7.8
RI,1976,5,442248,407418,34830,7.9
RI,1976,6,440993,405902,35091,8
RI,1976,7,439635,404294,35341,8
RI,1976,8,441063,405491,35572,8.1
RI,1976,9,440373,404595,35778,8.1
RI,1976,10,439357,403408,35949,8.2
RI,1976,11,438570,402497,36073,8.2
RI,1976,12,440266,404121,36145,8.2
RI,1977,1,440690,404530,36160,8.2
RI,1977,2,442394,406297,36097,8.2
RI,1977,3,442766,406812,35954,8.1
RI,1977,4,444585,408850,35735,8
RI,1977,5,446659,411212,35447,7.9
RI,1977,6,447443,412347,35096,7.8
RI,1977,7,449623,414933,34690,7.7
RI,1977,8,451048,416812,34236,7.6
RI,1977,9,451612,417872,33740,7.5
RI,1977,10,450909,417704,33205,7.4
RI,1977,11,451513,418875,32638,7.2
RI,1977,12,451316,419269,32047,7.1
RI,1978,1,450475,419035,31440,7
RI,1978,2,448876,418005,30871,6.9
RI,1978,3,449864,419522,30342,6.7
RI,1978,4,452660,422797,29863,6.6
RI,1978,5,452481,423038,29443,6.5
RI,1978,6,452420,423332,29088,6.4
RI,1978,7,453924,425127,28797,6.3
RI,1978,8,453999,425425,28574,6.3
RI,1978,9,454519,426099,28420,6.3
RI,1978,10,454729,426395,28334,6.2
RI,1978,11,456136,427825,28311,6.2
RI,1978,12,458248,429900,28348,6.2
RI,1979,1,457989,429548,28441,6.2
RI,1979,2,462107,433549,28558,6.2
RI,1979,3,463709,435004,28705,6.2
RI,1979,4,463816,434936,28880,6.2
RI,1979,5,464885,435807,29078,6.3
RI,1979,6,465907,436608,29299,6.3
RI,1979,7,466564,437016,29548,6.3
RI,1979,8,468238,438412,29826,6.4
RI,1979,9,469462,439331,30131,6.4
RI,1979,10,469415,438959,30456,6.5
RI,1979,11,469773,438977,30796,6.6
RI,1979,12,470849,439705,31144,6.6
RI,1980,1,472176,440682,31494,6.7
RI,1980,2,470251,438397,31854,6.8
RI,1980,3,469503,437284,32219,6.9
RI,1980,4,469492,436913,32579,6.9
RI,1980,5,469318,436383,32935,7
RI,1980,6,468723,435440,33283,7.1
RI,1980,7,468645,435026,33619,7.2
RI,1980,8,467546,433605,33941,7.3
RI,1980,9,468967,434720,34247,7.3
RI,1980,10,471660,437124,34536,7.3
RI,1980,11,473664,438852,34812,7.3
RI,1980,12,474102,439024,35078,7.4
RI,1981,1,476668,441329,35339,7.4
RI,1981,2,477311,441672,35639,7.5
RI,1981,3,478920,442943,35977,7.5
RI,1981,4,479368,443009,36359,7.6
RI,1981,5,479400,442610,36790,7.7
RI,1981,6,478474,441203,37271,7.8
RI,1981,7,478202,440393,37809,7.9
RI,1981,8,479246,440845,38401,8
RI,1981,9,482214,443172,39042,8.1
RI,1981,10,480789,441056,39733,8.3
RI,1981,11,479117,438650,40467,8.4
RI,1981,12,477610,436374,41236,8.6
RI,1982,1,477639,435610,42029,8.8
RI,1982,2,478273,435492,42781,8.9
RI,1982,3,477219,433740,43479,9.1
RI,1982,4,476455,432346,44109,9.3
RI,1982,5,476458,431803,44655,9.4
RI,1982,6,477604,432499,45105,9.4
RI,1982,7,478141,432692,45449,9.5
RI,1982,8,479101,433429,45672,9.5
RI,1982,9,476296,430527,45769,9.6
RI,1982,10,473452,427723,45729,9.7
RI,1982,11,471712,426168,45544,9.7
RI,1982,12,471514,426299,45215,9.6
RI,1983,1,473364,428617,44747,9.5
RI,1983,2,474783,430632,44151,9.3
RI,1983,3,474786,431344,43442,9.1
RI,1983,4,474509,431880,42629,9
RI,1983,5,474518,432795,41723,8.8
RI,1983,6,476743,436010,40733,8.5
RI,1983,7,478354,438683,39671,8.3
RI,1983,8,477240,438688,38552,8.1
RI,1983,9,478185,440795,37390,7.8
RI,1983,10,479654,443458,36196,7.5
RI,1983,11,481187,446200,34987,7.3
RI,1983,12,480705,446932,33773,7
RI,1984,1,484008,451448,32560,6.7
RI,1984,2,486172,454757,31415,6.5
RI,1984,3,487901,457562,30339,6.2
RI,1984,4,487877,458545,29332,6
RI,1984,5,488723,460328,28395,5.8
RI,1984,6,491602,464075,27527,5.6
RI,1984,7,492992,466258,26734,5.4
RI,1984,8,494033,468010,26023,5.3
RI,1984,9,494648,469244,25404,5.1
RI,1984,10,497191,472318,24873,5
RI,1984,11,498270,473842,24428,4.9
RI,1984,12,498134,474069,24065,4.8
RI,1985,1,496448,472674,23774,4.8
RI,1985,2,495955,472450,23505,4.7
RI,1985,3,495666,472419,23247,4.7
RI,1985,4,497017,474020,22997,4.6
RI,1985,5,497392,474639,22753,4.6
RI,1985,6,497464,474949,22515,4.5
RI,1985,7,497557,475280,22277,4.5
RI,1985,8,498421,476381,22040,4.4
RI,1985,9,497645,475845,21800,4.4
RI,1985,10,501359,479808,21551,4.3
RI,1985,11,501840,480538,21302,4.2
RI,1985,12,503170,482111,21059,4.2
RI,1986,1,503715,482886,20829,4.1
RI,1986,2,505244,484607,20637,4.1
RI,1986,3,504816,484332,20484,4.1
RI,1986,4,505310,484940,20370,4
RI,1986,5,505748,485459,20289,4
RI,1986,6,504826,484591,20235,4
RI,1986,7,504545,484351,20194,4
RI,1986,8,506421,486261,20160,4
RI,1986,9,507227,487099,20128,4
RI,1986,10,508448,488359,20089,4
RI,1986,11,508337,488299,20038,3.9
RI,1986,12,510713,490741,19972,3.9
RI,1987,1,511643,491750,19893,3.9
RI,1987,2,510516,490744,19772,3.9
RI,1987,3,511529,491923,19606,3.8
RI,1987,4,514125,494729,19396,3.8
RI,1987,5,513869,494730,19139,3.7
RI,1987,6,515172,496329,18843,3.7
RI,1987,7,515733,497215,18518,3.6
RI,1987,8,516310,498143,18167,3.5
RI,1987,9,515956,498165,17791,3.4
RI,1987,10,514808,497411,17397,3.4
RI,1987,11,515072,498081,16991,3.3
RI,1987,12,516370,499782,16588,3.2
RI,1988,1,516058,499855,16203,3.1
RI,1988,2,515544,499666,15878,3.1
RI,1988,3,515678,500070,15608,3
RI,1988,4,517072,501671,15401,3
RI,1988,5,517250,501985,15265,3
RI,1988,6,516593,501386,15207,2.9
RI,1988,7,518272,503048,15224,2.9
RI,1988,8,519065,503746,15319,3
RI,1988,9,516909,501425,15484,3
RI,1988,10,518878,503163,15715,3
RI,1988,11,521389,505375,16014,3.1
RI,1988,12,522056,505667,16389,3.1
RI,1989,1,521512,504668,16844,3.2
RI,1989,2,521737,504372,17365,3.3
RI,1989,3,522179,504225,17954,3.4
RI,1989,4,520060,501453,18607,3.6
RI,1989,5,520320,501000,19320,3.7
RI,1989,6,520378,500283,20095,3.9
RI,1989,7,520978,500037,20941,4
RI,1989,8,520429,498581,21848,4.2
RI,1989,9,522284,499477,22807,4.4
RI,1989,10,521942,498138,23804,4.6
RI,1989,11,523911,499088,24823,4.7
RI,1989,12,523869,498015,25854,4.9
RI,1990,1,523537,496659,26878,5.1
RI,1990,2,522206,494311,27895,5.3
RI,1990,3,522608,493711,28897,5.5
RI,1990,4,524448,494570,29878,5.7
RI,1990,5,525936,495095,30841,5.9
RI,1990,6,527262,495476,31786,6
RI,1990,7,525628,492913,32715,6.2
RI,1990,8,527202,493572,33630,6.4
RI,1990,9,529329,494789,34540,6.5
RI,1990,10,529307,493859,35448,6.7
RI,1990,11,526106,489751,36355,6.9
RI,1990,12,526633,489378,37255,7.1
RI,1991,1,527349,489201,38148,7.2
RI,1991,2,525931,486907,39024,7.4
RI,1991,3,524912,485032,39880,7.6
RI,1991,4,521964,481248,40716,7.8
RI,1991,5,522996,481468,41528,7.9
RI,1991,6,521545,479233,42312,8.1
RI,1991,7,520521,477454,43067,8.3
RI,1991,8,520699,476914,43785,8.4
RI,1991,9,521090,476634,44456,8.5
RI,1991,10,521865,476792,45073,8.6
RI,1991,11,522800,477169,45631,8.7
RI,1991,12,525174,479044,46130,8.8
RI,1992,1,525744,479174,46570,8.9
RI,1992,2,527071,480147,46924,8.9
RI,1992,3,527446,480260,47186,8.9
RI,1992,4,529638,482286,47352,8.9
RI,1992,5,529893,482477,47416,8.9
RI,1992,6,530740,483355,47385,8.9
RI,1992,7,531785,484526,47259,8.9
RI,1992,8,531411,484366,47045,8.9
RI,1992,9,530925,484176,46749,8.8
RI,1992,10,532164,485779,46385,8.7
RI,1992,11,532774,486813,45961,8.6
RI,1992,12,532071,486586,45485,8.5
RI,1993,1,531503,486536,44967,8.5
RI,1993,2,529775,485354,44421,8.4
RI,1993,3,528097,484246,43851,8.3
RI,1993,4,527191,483928,43263,8.2
RI,1993,5,528246,485589,42657,8.1
RI,1993,6,527450,485411,42039,8
RI,1993,7,528180,486763,41417,7.8
RI,1993,8,526792,485993,40799,7.7
RI,1993,9,525236,485051,40185,7.7
RI,1993,10,523726,484152,39574,7.6
RI,1993,11,522596,483629,38967,7.5
RI,1993,12,521285,482925,38360,7.4
RI,1994,1,520805,483055,37750,7.2
RI,1994,2,520898,483733,37165,7.1
RI,1994,3,518568,481955,36613,7.1
RI,1994,4,517033,480935,36098,7
RI,1994,5,517136,481509,35627,6.9
RI,1994,6,517440,482242,35198,6.8
RI,1994,7,515438,480630,34808,6.8
RI,1994,8,514319,479867,34452,6.7
RI,1994,9,513206,479081,34125,6.6
RI,1994,10,513066,479239,33827,6.6
RI,1994,11,511533,477972,33561,6.6
RI,1994,12,511135,477809,33326,6.5
RI,1995,1,511465,478340,33125,6.5
RI,1995,2,511077,478168,32909,6.4
RI,1995,3,509835,477160,32675,6.4
RI,1995,4,507789,475368,32421,6.4
RI,1995,5,507000,474853,32147,6.3
RI,1995,6,506617,474777,31840,6.3
RI,1995,7,506093,474599,31494,6.2
RI,1995,8,508507,477402,31105,6.1
RI,1995,9,508766,478088,30678,6
RI,1995,10,508985,478769,30216,5.9
RI,1995,11,510164,480438,29726,5.8
RI,1995,12,510174,480950,29224,5.7
RI,1996,1,510317,481604,28713,5.6
RI,1996,2,512192,483933,28259,5.5
RI,1996,3,513976,486105,27871,5.4
RI,1996,4,514349,486793,27556,5.4
RI,1996,5,516629,489313,27316,5.3
RI,1996,6,517964,490811,27153,5.2
RI,1996,7,517158,490095,27063,5.2
RI,1996,8,518671,491633,27038,5.2
RI,1996,9,519855,492782,27073,5.2
RI,1996,10,522032,494870,27162,5.2
RI,1996,11,522654,495349,27305,5.2
RI,1996,12,523343,495855,27488,5.3
RI,1997,1,524666,496961,27705,5.3
RI,1997,2,525588,497699,27889,5.3
RI,1997,3,527629,499597,28032,5.3
RI,1997,4,529848,501720,28128,5.3
RI,1997,5,530998,502832,28166,5.3
RI,1997,6,532293,504155,28138,5.3
RI,1997,7,533544,505501,28043,5.3
RI,1997,8,535756,507871,27885,5.2
RI,1997,9,537216,509545,27671,5.2
RI,1997,10,535701,508302,27399,5.1
RI,1997,11,534906,507834,27072,5.1
RI,1997,12,534451,507754,26697,5
RI,1998,1,534610,508335,26275,4.9
RI,1998,2,533680,507808,25872,4.8
RI,1998,3,533268,507784,25484,4.8
RI,1998,4,532221,507107,25114,4.7
RI,1998,5,532456,507689,24767,4.7
RI,1998,6,532798,508350,24448,4.6
RI,1998,7,533204,509042,24162,4.5
RI,1998,8,533440,509539,23901,4.5
RI,1998,9,534065,510400,23665,4.4
RI,1998,10,534558,511106,23452,4.4
RI,1998,11,536459,513195,23264,4.3
RI,1998,12,537368,514255,23113,4.3
RI,1999,1,535467,512456,23011,4.3
RI,1999,2,537716,514809,22907,4.3
RI,1999,3,541217,518404,22813,4.2
RI,1999,4,542508,519769,22739,4.2
RI,1999,5,541931,519254,22677,4.2
RI,1999,6,540767,518150,22617,4.2
RI,1999,7,542773,520219,22554,4.2
RI,1999,8,542521,520041,22480,4.1
RI,1999,9,541714,519323,22391,4.1
RI,1999,10,542205,519915,22290,4.1
RI,1999,11,543811,521634,22177,4.1
RI,1999,12,544245,522195,22050,4.1
RI,2000,1,542136,519775,22361,4.1
RI,2000,2,541860,519517,22343,4.1
RI,2000,3,543779,521435,22344,4.1
RI,2000,4,545624,523258,22366,4.1
RI,2000,5,542754,520344,22410,4.1
RI,2000,6,543194,520719,22475,4.1
RI,2000,7,543552,520987,22565,4.2
RI,2000,8,542077,519402,22675,4.2
RI,2000,9,542192,519390,22802,4.2
RI,2000,10,543784,520830,22954,4.2
RI,2000,11,544599,521468,23131,4.2
RI,2000,12,545304,521975,23329,4.3
RI,2001,1,545410,521868,23542,4.3
RI,2001,2,546043,522274,23769,4.4
RI,2001,3,545020,521019,24001,4.4
RI,2001,4,545079,520849,24230,4.4
RI,2001,5,544669,520213,24456,4.5
RI,2001,6,545365,520688,24677,4.5
RI,2001,7,543976,519088,24888,4.6
RI,2001,8,544386,519292,25094,4.6
RI,2001,9,546313,521002,25311,4.6
RI,2001,10,546211,520663,25548,4.7
RI,2001,11,545894,520090,25804,4.7
RI,2001,12,547162,521081,26081,4.8
RI,2002,1,544918,518665,26253,4.8
RI,2002,2,548923,522376,26547,4.8
RI,2002,3,550447,523591,26856,4.9
RI,2002,4,549438,522255,27183,4.9
RI,2002,5,550968,523443,27525,5
RI,2002,6,552771,524894,27877,5
RI,2002,7,555158,526914,28244,5.1
RI,2002,8,555698,527084,28614,5.1
RI,2002,9,556461,527490,28971,5.2
RI,2002,10,557844,528542,29302,5.3
RI,2002,11,561333,531732,29601,5.3
RI,2002,12,561528,531665,29863,5.3
RI,2003,1,565765,535797,29968,5.3
RI,2003,2,565006,534857,30149,5.3
RI,2003,3,564674,534386,30288,5.4
RI,2003,4,564677,534290,30387,5.4
RI,2003,5,565599,535150,30449,5.4
RI,2003,6,565506,535033,30473,5.4
RI,2003,7,564450,533987,30463,5.4
RI,2003,8,563221,532793,30428,5.4
RI,2003,9,563115,532736,30379,5.4
RI,2003,10,561811,531484,30327,5.4
RI,2003,11,560180,529911,30269,5.4
RI,2003,12,558954,528760,30194,5.4
RI,2004,1,555658,525572,30086,5.4
RI,2004,2,554377,524412,29965,5.4
RI,2004,3,554925,525109,29816,5.4
RI,2004,4,555045,525409,29636,5.3
RI,2004,5,555239,525812,29427,5.3
RI,2004,6,554908,525714,29194,5.3
RI,2004,7,556160,527216,28944,5.2
RI,2004,8,554525,525832,28693,5.2
RI,2004,9,555054,526596,28458,5.1
RI,2004,10,555682,527423,28259,5.1
RI,2004,11,555049,526941,28108,5.1
RI,2004,12,554529,526520,28009,5.1
RI,2005,1,555473,527517,27956,5
RI,2005,2,557135,529177,27958,5
RI,2005,3,558320,530314,28006,5
RI,2005,4,559737,531647,28090,5
RI,2005,5,561819,533617,28202,5
RI,2005,6,562027,533688,28339,5
RI,2005,7,563392,534906,28486,5.1
RI,2005,8,564792,536161,28631,5.1
RI,2005,9,565658,536888,28770,5.1
RI,2005,10,565223,536326,28897,5.1
RI,2005,11,567405,538386,29019,5.1
RI,2005,12,567602,538464,29138,5.1
RI,2006,1,568085,538833,29252,5.1
RI,2006,2,568459,539134,29325,5.2
RI,2006,3,569805,540457,29348,5.2
RI,2006,4,572359,543042,29317,5.1
RI,2006,5,572293,543061,29232,5.1
RI,2006,6,572509,543414,29095,5.1
RI,2006,7,572420,543505,28915,5.1
RI,2006,8,571424,542719,28705,5
RI,2006,9,572825,544346,28479,5
RI,2006,10,572543,544285,28258,4.9
RI,2006,11,571949,543893,28056,4.9
RI,2006,12,572772,544891,27881,4.9
RI,2007,1,574602,546851,27751,4.8
RI,2007,2,574616,546883,27733,4.8
RI,2007,3,573082,545245,27837,4.9
RI,2007,4,572027,543962,28065,4.9
RI,2007,5,573831,545419,28412,5
RI,2007,6,573769,544888,28881,5
RI,2007,7,571831,542355,29476,5.2
RI,2007,8,570856,540662,30194,5.3
RI,2007,9,572147,541106,31041,5.4
RI,2007,10,571658,539635,32023,5.6
RI,2007,11,570781,537641,33140,5.8
RI,2007,12,570594,536204,34390,6
RI,2008,1,568743,532973,35770,6.3
RI,2008,2,568420,531204,37216,6.5
RI,2008,3,568978,530258,38720,6.8
RI,2008,4,568757,528482,40275,7.1
RI,2008,5,567555,525684,41871,7.4
RI,2008,6,567542,524049,43493,7.7
RI,2008,7,568056,522926,45130,7.9
RI,2008,8,566569,519799,46770,8.3
RI,2008,9,567641,519241,48400,8.5
RI,2008,10,566548,516533,50015,8.8
RI,2008,11,567033,515423,51610,9.1
RI,2008,12,565319,512135,53184,9.4
RI,2009,1,562680,504878,57802,10.3
SC,1976,1,1280522,1183055,97467,7.6
SC,1976,2,1281178,1184777,96401,7.5
SC,1976,3,1279444,1186553,92891,7.3
SC,1976,4,1280244,1188384,91860,7.2
SC,1976,5,1281408,1190269,91139,7.1
SC,1976,6,1281134,1192210,88924,6.9
SC,1976,7,1283975,1194206,89769,7
SC,1976,8,1287436,1196258,91178,7.1
SC,1976,9,1285529,1198366,87163,6.8
SC,1976,10,1287859,1200532,87327,6.8
SC,1976,11,1291419,1202754,88665,6.9
SC,1976,12,1293254,1205035,88219,6.8
SC,1977,1,1298905,1207373,91532,7
SC,1977,2,1310398,1209782,100616,7.7
SC,1977,3,1309471,1212263,97208,7.4
SC,1977,4,1309528,1214815,94713,7.2
SC,1977,5,1307754,1217440,90314,6.9
SC,1977,6,1310361,1220138,90223,6.9
SC,1977,7,1308748,1222909,85839,6.6
SC,1977,8,1309123,1225754,83369,6.4
SC,1977,9,1314284,1228674,85610,6.5
SC,1977,10,1315763,1231669,84094,6.4
SC,1977,11,1320585,1234739,85846,6.5
SC,1977,12,1319359,1237885,81474,6.2
SC,1978,1,1318363,1241108,77255,5.9
SC,1978,2,1317242,1244273,72969,5.5
SC,1978,3,1323831,1247380,76451,5.8
SC,1978,4,1325692,1250427,75265,5.7
SC,1978,5,1330009,1253416,76593,5.8
SC,1978,6,1335625,1256344,79281,5.9
SC,1978,7,1336744,1259213,77531,5.8
SC,1978,8,1336158,1262020,74138,5.5
SC,1978,9,1337722,1264767,72955,5.5
SC,1978,10,1337976,1267452,70524,5.3
SC,1978,11,1338788,1270075,68713,5.1
SC,1978,12,1341758,1272636,69122,5.2
SC,1979,1,1343225,1275134,68091,5.1
SC,1979,2,1342822,1277492,65330,4.9
SC,1979,3,1347093,1279710,67383,5
SC,1979,4,1352042,1281786,70256,5.2
SC,1979,5,1350065,1283720,66345,4.9
SC,1979,6,1348183,1285509,62674,4.6
SC,1979,7,1345146,1287155,57991,4.3
SC,1979,8,1352890,1288655,64235,4.7
SC,1979,9,1357752,1290008,67744,5
SC,1979,10,1362837,1291214,71623,5.3
SC,1979,11,1364419,1292271,72148,5.3
SC,1979,12,1364711,1293179,71532,5.2
SC,1980,1,1370624,1293936,76688,5.6
SC,1980,2,1378348,1294836,83512,6.1
SC,1980,3,1378101,1295880,82221,6
SC,1980,4,1381703,1297071,84632,6.1
SC,1980,5,1388941,1298407,90534,6.5
SC,1980,6,1394832,1299891,94941,6.8
SC,1980,7,1401303,1301523,99780,7.1
SC,1980,8,1400269,1303305,96964,6.9
SC,1980,9,1404989,1305237,99752,7.1
SC,1980,10,1409731,1307321,102410,7.3
SC,1980,11,1408885,1309557,99328,7.1
SC,1980,12,1413166,1311947,101219,7.2
SC,1981,1,1417078,1314492,102586,7.2
SC,1981,2,1421466,1316931,104535,7.4
SC,1981,3,1425851,1319263,106588,7.5
SC,1981,4,1422823,1321489,101334,7.1
SC,1981,5,1429276,1323607,105669,7.4
SC,1981,6,1435742,1325617,110125,7.7
SC,1981,7,1437270,1327518,109752,7.6
SC,1981,8,1444647,1329309,115338,8
SC,1981,9,1451914,1330989,120925,8.3
SC,1981,10,1457282,1332558,124724,8.6
SC,1981,11,1467420,1334014,133406,9.1
SC,1981,12,1475973,1335359,140614,9.5
SC,1982,1,1481739,1336589,145150,9.8
SC,1982,2,1485135,1337787,147348,9.9
SC,1982,3,1490424,1338951,151473,10.2
SC,1982,4,1495586,1340081,155505,10.4
SC,1982,5,1504936,1341178,163758,10.9
SC,1982,6,1507627,1342241,165386,11
SC,1982,7,1509804,1343270,166534,11
SC,1982,8,1513451,1344265,169186,11.2
SC,1982,9,1509713,1345226,164487,10.9
SC,1982,10,1511229,1346151,165078,10.9
SC,1982,11,1513505,1347042,166463,11
SC,1982,12,1520458,1347897,172561,11.3
SC,1983,1,1521619,1348717,172902,11.4
SC,1983,2,1520571,1349880,170691,11.2
SC,1983,3,1520654,1351388,169266,11.1
SC,1983,4,1515095,1353244,161851,10.7
SC,1983,5,1509829,1355449,154380,10.2
SC,1983,6,1502849,1358005,144844,9.6
SC,1983,7,1497855,1360916,136939,9.1
SC,1983,8,1494576,1364183,130393,8.7
SC,1983,9,1493419,1367809,125610,8.4
SC,1983,10,1490957,1371795,119162,8
SC,1983,11,1496434,1376145,120289,8
SC,1983,12,1501828,1380861,120967,8.1
SC,1984,1,1501721,1385944,115777,7.7
SC,1984,2,1497793,1390669,107124,7.2
SC,1984,3,1499305,1395034,104271,7
SC,1984,4,1500888,1399036,101852,6.8
SC,1984,5,1500523,1402674,97849,6.5
SC,1984,6,1499824,1405944,93880,6.3
SC,1984,7,1505648,1408845,96803,6.4
SC,1984,8,1510304,1411374,98930,6.6
SC,1984,9,1512405,1413529,98876,6.5
SC,1984,10,1515019,1415307,99712,6.6
SC,1984,11,1518369,1416706,101663,6.7
SC,1984,12,1516455,1417723,98732,6.5
SC,1985,1,1514509,1418357,96152,6.3
SC,1985,2,1571914,1476300,95614,6.1
SC,1985,3,1570627,1477305,93322,5.9
SC,1985,4,1574345,1478534,95811,6.1
SC,1985,5,1582405,1479990,102415,6.5
SC,1985,6,1589486,1481672,107814,6.8
SC,1985,7,1596411,1483582,112829,7.1
SC,1985,8,1597526,1485722,111804,7
SC,1985,9,1596298,1488094,108204,6.8
SC,1985,10,1599302,1490697,108605,6.8
SC,1985,11,1601086,1493535,107551,6.7
SC,1985,12,1606366,1496608,109758,6.8
SC,1986,1,1607199,1499917,107282,6.7
SC,1986,2,1610220,1503179,107041,6.6
SC,1986,3,1613698,1506393,107305,6.6
SC,1986,4,1614592,1509559,105033,6.5
SC,1986,5,1614430,1512677,101753,6.3
SC,1986,6,1614125,1515746,98379,6.1
SC,1986,7,1615364,1518766,96598,6
SC,1986,8,1615018,1521737,93281,5.8
SC,1986,9,1618941,1524658,94283,5.8
SC,1986,10,1621248,1527529,93719,5.8
SC,1986,11,1625887,1530350,95537,5.9
SC,1986,12,1628397,1533121,95276,5.9
SC,1987,1,1631231,1535841,95390,5.8
SC,1987,2,1635157,1538552,96605,5.9
SC,1987,3,1639303,1541255,98048,6
SC,1987,4,1638219,1543949,94270,5.8
SC,1987,5,1632218,1546634,85584,5.2
SC,1987,6,1624219,1549311,74908,4.6
SC,1987,7,1625173,1551979,73194,4.5
SC,1987,8,1631801,1554638,77163,4.7
SC,1987,9,1640035,1557288,82747,5
SC,1987,10,1643369,1559929,83440,5.1
SC,1987,11,1645746,1562561,83185,5.1
SC,1987,12,1648701,1565184,83517,5.1
SC,1988,1,1651439,1567798,83641,5.1
SC,1988,2,1649588,1570396,79192,4.8
SC,1988,3,1650277,1572977,77300,4.7
SC,1988,4,1652477,1575543,76934,4.7
SC,1988,5,1656700,1578092,78608,4.7
SC,1988,6,1654722,1580624,74098,4.5
SC,1988,7,1656378,1583140,73238,4.4
SC,1988,8,1663414,1585640,77774,4.7
SC,1988,9,1663027,1588123,74904,4.5
SC,1988,10,1665887,1590589,75298,4.5
SC,1988,11,1664187,1593038,71149,4.3
SC,1988,12,1666969,1595469,71500,4.3
SC,1989,1,1670935,1597884,73051,4.4
SC,1989,2,1672038,1600312,71726,4.3
SC,1989,3,1674181,1602754,71427,4.3
SC,1989,4,1676290,1605208,71082,4.2
SC,1989,5,1680330,1607676,72654,4.3
SC,1989,6,1688221,1610158,78063,4.6
SC,1989,7,1691956,1612654,79302,4.7
SC,1989,8,1697335,1615163,82172,4.8
SC,1989,9,1700160,1617685,82475,4.9
SC,1989,10,1710666,1620222,90444,5.3
SC,1989,11,1708092,1622773,85319,5
SC,1989,12,1708196,1625337,82859,4.9
SC,1990,1,1708909,1627916,80993,4.7
SC,1990,2,1710284,1630349,79935,4.7
SC,1990,3,1711234,1632635,78599,4.6
SC,1990,4,1716437,1634775,81662,4.8
SC,1990,5,1719041,1636766,82275,4.8
SC,1990,6,1721449,1638609,82840,4.8
SC,1990,7,1725083,1640302,84781,4.9
SC,1990,8,1725427,1641844,83583,4.8
SC,1990,9,1729693,1643235,86458,5
SC,1990,10,1729470,1644475,84995,4.9
SC,1990,11,1732562,1645561,87001,5
SC,1990,12,1736207,1646494,89713,5.2
SC,1991,1,1741859,1647272,94587,5.4
SC,1991,2,1753834,1648142,105692,6
SC,1991,3,1756125,1649104,107021,6.1
SC,1991,4,1754754,1650159,104595,6
SC,1991,5,1753038,1651307,101731,5.8
SC,1991,6,1758421,1652550,105871,6
SC,1991,7,1759567,1653886,105681,6
SC,1991,8,1764159,1655318,108841,6.2
SC,1991,9,1766711,1656844,109867,6.2
SC,1991,10,1768647,1658467,110180,6.2
SC,1991,11,1773617,1660186,113431,6.4
SC,1991,12,1778871,1662003,116868,6.6
SC,1992,1,1780817,1663916,116901,6.6
SC,1992,2,1783211,1665796,117415,6.6
SC,1992,3,1788444,1667642,120802,6.8
SC,1992,4,1789242,1669453,119789,6.7
SC,1992,5,1789447,1671229,118218,6.6
SC,1992,6,1791564,1672971,118593,6.6
SC,1992,7,1794388,1674678,119710,6.7
SC,1992,8,1796108,1676350,119758,6.7
SC,1992,9,1797223,1677986,119237,6.6
SC,1992,10,1798435,1679588,118847,6.6
SC,1992,11,1798464,1681153,117311,6.5
SC,1992,12,1803189,1682683,120506,6.7
SC,1993,1,1809671,1684176,125495,6.9
SC,1993,2,1816384,1685822,130562,7.2
SC,1993,3,1824277,1687621,136656,7.5
SC,1993,4,1829549,1689574,139975,7.7
SC,1993,5,1830460,1691681,138779,7.6
SC,1993,6,1832163,1693944,138219,7.5
SC,1993,7,1833185,1696364,136821,7.5
SC,1993,8,1832355,1698940,133415,7.3
SC,1993,9,1830637,1701674,128963,7
SC,1993,10,1829011,1704567,124444,6.8
SC,1993,11,1831261,1707619,123642,6.8
SC,1993,12,1834109,1710832,123277,6.7
SC,1994,1,1834827,1714206,120621,6.6
SC,1994,2,1840148,1717439,122709,6.7
SC,1994,3,1843703,1720531,123172,6.7
SC,1994,4,1844261,1723480,120781,6.5
SC,1994,5,1841388,1726287,115101,6.3
SC,1994,6,1840099,1728949,111150,6
SC,1994,7,1840785,1731468,109317,5.9
SC,1994,8,1841408,1733840,107568,5.8
SC,1994,9,1841056,1736067,104989,5.7
SC,1994,10,1841613,1738148,103465,5.6
SC,1994,11,1838870,1740080,98790,5.4
SC,1994,12,1836839,1741865,94974,5.2
SC,1995,1,1839212,1743500,95712,5.2
SC,1995,2,1839627,1745224,94403,5.1
SC,1995,3,1839505,1747037,92468,5
SC,1995,4,1840385,1748940,91445,5
SC,1995,5,1843306,1750932,92374,5
SC,1995,6,1845062,1753015,92047,5
SC,1995,7,1852031,1755189,96842,5.2
SC,1995,8,1852750,1757454,95296,5.1
SC,1995,9,1856792,1759811,96981,5.2
SC,1995,10,1860203,1762260,97943,5.3
SC,1995,11,1863323,1764801,98522,5.3
SC,1995,12,1866195,1767436,98759,5.3
SC,1996,1,1871935,1770165,101770,5.4
SC,1996,2,1870869,1772913,97956,5.2
SC,1996,3,1876888,1775681,101207,5.4
SC,1996,4,1886637,1778469,108168,5.7
SC,1996,5,1887982,1781277,106705,5.7
SC,1996,6,1895064,1784105,110959,5.9
SC,1996,7,1897042,1786952,110090,5.8
SC,1996,8,1899766,1789820,109946,5.8
SC,1996,9,1903348,1792709,110639,5.8
SC,1996,10,1905575,1795617,109958,5.8
SC,1996,11,1907021,1798546,108475,5.7
SC,1996,12,1906392,1801496,104896,5.5
SC,1997,1,1905103,1804466,100637,5.3
SC,1997,2,1904712,1807383,97329,5.1
SC,1997,3,1904193,1810246,93947,4.9
SC,1997,4,1903578,1813054,90524,4.8
SC,1997,5,1904960,1815808,89152,4.7
SC,1997,6,1907765,1818508,89257,4.7
SC,1997,7,1907236,1821152,86084,4.5
SC,1997,8,1905801,1823741,82060,4.3
SC,1997,9,1905177,1826275,78902,4.1
SC,1997,10,1899989,1828753,71236,3.7
SC,1997,11,1898578,1831174,67404,3.6
SC,1997,12,1899195,1833540,65655,3.5
SC,1998,1,1901629,1835848,65781,3.5
SC,1998,2,1899896,1838179,61717,3.2
SC,1998,3,1899088,1840532,58556,3.1
SC,1998,4,1906394,1842906,63488,3.3
SC,1998,5,1911770,1845303,66467,3.5
SC,1998,6,1916694,1847723,68971,3.6
SC,1998,7,1922921,1850165,72756,3.8
SC,1998,8,1926645,1852629,74016,3.8
SC,1998,9,1928163,1855116,73047,3.8
SC,1998,10,1932561,1857626,74935,3.9
SC,1998,11,1935812,1860159,75653,3.9
SC,1998,12,1938091,1862715,75376,3.9
SC,1999,1,1940870,1865294,75576,3.9
SC,1999,2,1943788,1867765,76023,3.9
SC,1999,3,1945096,1870130,74966,3.9
SC,1999,4,1952128,1872386,79742,4.1
SC,1999,5,1954945,1874533,80412,4.1
SC,1999,6,1956730,1876572,80158,4.1
SC,1999,7,1957517,1878501,79016,4
SC,1999,8,1962637,1880320,82317,4.2
SC,1999,9,1966654,1882028,84626,4.3
SC,1999,10,1967878,1883625,84253,4.3
SC,1999,11,1967539,1885110,82429,4.2
SC,1999,12,1964312,1886483,77829,4
SC,2000,1,1977925,1904958,72967,3.7
SC,2000,2,1977570,1907114,70456,3.6
SC,2000,3,1978430,1911401,67029,3.4
SC,2000,4,1979246,1911876,67370,3.4
SC,2000,5,1989347,1916761,72586,3.6
SC,2000,6,1992191,1921016,71175,3.6
SC,2000,7,1995052,1922635,72417,3.6
SC,2000,8,1997462,1923846,73616,3.7
SC,2000,9,1994928,1923949,70979,3.6
SC,2000,10,1994630,1928825,65805,3.3
SC,2000,11,1999654,1930490,69164,3.5
SC,2000,12,1981475,1905510,75965,3.8
SC,2001,1,1962092,1881976,80116,4.1
SC,2001,2,1952517,1865902,86615,4.4
SC,2001,3,1945316,1853431,91885,4.7
SC,2001,4,1937607,1842541,95066,4.9
SC,2001,5,1935965,1834506,101459,5.2
SC,2001,6,1929764,1827494,102270,5.3
SC,2001,7,1932028,1824930,107098,5.5
SC,2001,8,1929847,1823648,106199,5.5
SC,2001,9,1927314,1820786,106528,5.5
SC,2001,10,1925273,1814864,110409,5.7
SC,2001,11,1924275,1814741,109534,5.7
SC,2001,12,1925372,1813638,111734,5.8
SC,2002,1,1925786,1812367,113419,5.9
SC,2002,2,1926568,1813586,112982,5.9
SC,2002,3,1931600,1816497,115103,6
SC,2002,4,1934254,1820889,113365,5.9
SC,2002,5,1937189,1823366,113823,5.9
SC,2002,6,1939857,1826605,113252,5.8
SC,2002,7,1939690,1826845,112845,5.8
SC,2002,8,1944933,1831597,113336,5.8
SC,2002,9,1948673,1833082,115591,5.9
SC,2002,10,1954275,1835124,119151,6.1
SC,2002,11,1961273,1836493,124780,6.4
SC,2002,12,1961667,1838432,123235,6.3
SC,2003,1,1968575,1842703,125872,6.4
SC,2003,2,1971561,1845918,125643,6.4
SC,2003,3,1972523,1847639,124884,6.3
SC,2003,4,1977193,1848418,128775,6.5
SC,2003,5,1982070,1850448,131622,6.6
SC,2003,6,1989046,1852136,136910,6.9
SC,2003,7,1995365,1854508,140857,7.1
SC,2003,8,1991580,1858498,133082,6.7
SC,2003,9,1998089,1861091,136998,6.9
SC,2003,10,2001587,1861968,139619,7
SC,2003,11,2001956,1863098,138858,6.9
SC,2003,12,2002576,1866608,135968,6.8
SC,2004,1,2006283,1869716,136567,6.8
SC,2004,2,2006979,1871289,135690,6.8
SC,2004,3,2012930,1876028,136902,6.8
SC,2004,4,2016231,1880454,135777,6.7
SC,2004,5,2020189,1883544,136645,6.8
SC,2004,6,2027235,1887718,139517,6.9
SC,2004,7,2028744,1890254,138490,6.8
SC,2004,8,2032623,1893311,139312,6.9
SC,2004,9,2037395,1896354,141041,6.9
SC,2004,10,2039659,1899472,140187,6.9
SC,2004,11,2044942,1902781,142161,7
SC,2004,12,2044558,1905684,138874,6.8
SC,2005,1,2046572,1908557,138015,6.7
SC,2005,2,2048835,1911549,137286,6.7
SC,2005,3,2047651,1912357,135294,6.6
SC,2005,4,2052849,1918253,134596,6.6
SC,2005,5,2055934,1920558,135376,6.6
SC,2005,6,2058098,1920709,137389,6.7
SC,2005,7,2066811,1930081,136730,6.6
SC,2005,8,2076778,1935398,141380,6.8
SC,2005,9,2081309,1937479,143830,6.9
SC,2005,10,2088343,1941902,146441,7
SC,2005,11,2091683,1947269,144414,6.9
SC,2005,12,2091063,1947942,143121,6.8
SC,2006,1,2092857,1955823,137034,6.5
SC,2006,2,2096745,1961787,134958,6.4
SC,2006,3,2101208,1966076,135132,6.4
SC,2006,4,2105913,1971117,134796,6.4
SC,2006,5,2106654,1973019,133635,6.3
SC,2006,6,2104394,1969931,134463,6.4
SC,2006,7,2103613,1974159,129454,6.2
SC,2006,8,2112838,1978627,134211,6.4
SC,2006,9,2115839,1982858,132981,6.3
SC,2006,10,2125314,1991431,133883,6.3
SC,2006,11,2126023,1994579,131444,6.2
SC,2006,12,2127604,2000374,127230,6
SC,2007,1,2125551,2001647,123904,5.8
SC,2007,2,2123484,2003164,120320,5.7
SC,2007,3,2123831,2005900,117931,5.6
SC,2007,4,2121858,2005326,116532,5.5
SC,2007,5,2120554,2005901,114653,5.4
SC,2007,6,2126452,2010091,116361,5.5
SC,2007,7,2124860,2006681,118179,5.6
SC,2007,8,2121819,2005446,116373,5.5
SC,2007,9,2127564,2009007,118557,5.6
SC,2007,10,2126593,2006509,120084,5.6
SC,2007,11,2128476,2007114,121362,5.7
SC,2007,12,2129826,2007344,122482,5.8
SC,2008,1,2127989,2006488,121501,5.7
SC,2008,2,2126910,2006331,120579,5.7
SC,2008,3,2131288,2005563,125725,5.9
SC,2008,4,2135310,2003865,131445,6.2
SC,2008,5,2141142,2005469,135673,6.3
SC,2008,6,2145832,2006065,139767,6.5
SC,2008,7,2154794,2005642,149152,6.9
SC,2008,8,2161896,2004594,157302,7.3
SC,2008,9,2164160,2002798,161362,7.5
SC,2008,10,2172654,2002497,170157,7.8
SC,2008,11,2180411,2001476,178935,8.2
SC,2008,12,2193197,2000103,193094,8.8
SC,2009,1,2188441,1960455,227986,10.4
SD,1976,1,307875,297078,10797,3.5
SD,1976,2,307573,296988,10585,3.4
SD,1976,3,307383,297003,10380,3.4
SD,1976,4,306818,297090,9728,3.2
SD,1976,5,307656,297406,10250,3.3
SD,1976,6,307375,297473,9902,3.2
SD,1976,7,308107,297979,10128,3.3
SD,1976,8,308441,298205,10236,3.3
SD,1976,9,309578,298551,11027,3.6
SD,1976,10,310198,299187,11011,3.5
SD,1976,11,311043,299979,11064,3.6
SD,1976,12,312002,300617,11385,3.6
SD,1977,1,313026,301513,11513,3.7
SD,1977,2,315130,302515,12615,4
SD,1977,3,315893,303442,12451,3.9
SD,1977,4,315809,304261,11548,3.7
SD,1977,5,316294,305147,11147,3.5
SD,1977,6,317207,306117,11090,3.5
SD,1977,7,317504,307028,10476,3.3
SD,1977,8,318095,307806,10289,3.2
SD,1977,9,318864,308655,10209,3.2
SD,1977,10,319477,309397,10080,3.2
SD,1977,11,319909,310059,9850,3.1
SD,1977,12,321138,310843,10295,3.2
SD,1978,1,322035,311680,10355,3.2
SD,1978,2,322503,312168,10335,3.2
SD,1978,3,322963,312624,10339,3.2
SD,1978,4,323323,313187,10136,3.1
SD,1978,5,324150,313874,10276,3.2
SD,1978,6,325751,314445,11306,3.5
SD,1978,7,326698,315072,11626,3.6
SD,1978,8,327275,315659,11616,3.5
SD,1978,9,326298,316042,10256,3.1
SD,1978,10,326804,316463,10341,3.2
SD,1978,11,327248,316823,10425,3.2
SD,1978,12,328595,317362,11233,3.4
SD,1979,1,329725,317848,11877,3.6
SD,1979,2,329710,318148,11562,3.5
SD,1979,3,330087,318605,11482,3.5
SD,1979,4,330912,319031,11881,3.6
SD,1979,5,330934,319662,11272,3.4
SD,1979,6,330805,319925,10880,3.3
SD,1979,7,330824,320081,10743,3.2
SD,1979,8,330913,320207,10706,3.2
SD,1979,9,331716,320628,11088,3.3
SD,1979,10,331970,320802,11168,3.4
SD,1979,11,332334,320744,11590,3.5
SD,1979,12,332526,320398,12128,3.6
SD,1980,1,332605,319913,12692,3.8
SD,1980,2,332990,319575,13415,4
SD,1980,3,333745,319326,14419,4.3
SD,1980,4,334724,319110,15614,4.7
SD,1980,5,334747,318369,16378,4.9
SD,1980,6,334811,318314,16497,4.9
SD,1980,7,334730,317678,17052,5.1
SD,1980,8,333992,317280,16712,5
SD,1980,9,333556,317103,16453,4.9
SD,1980,10,333158,316766,16392,4.9
SD,1980,11,333116,316510,16606,5
SD,1980,12,333425,316611,16814,5
SD,1981,1,334054,316796,17258,5.2
SD,1981,2,333748,316765,16983,5.1
SD,1981,3,333333,316919,16414,4.9
SD,1981,4,332992,317392,15600,4.7
SD,1981,5,333539,317673,15866,4.8
SD,1981,6,333282,317406,15876,4.8
SD,1981,7,333279,317708,15571,4.7
SD,1981,8,333483,317772,15711,4.7
SD,1981,9,333190,317536,15654,4.7
SD,1981,10,332861,317258,15603,4.7
SD,1981,11,333379,317005,16374,4.9
SD,1981,12,332637,316698,15939,4.8
SD,1982,1,332504,316157,16347,4.9
SD,1982,2,332063,315558,16505,5
SD,1982,3,332749,315466,17283,5.2
SD,1982,4,333589,315430,18159,5.4
SD,1982,5,332513,315013,17500,5.3
SD,1982,6,333531,315112,18419,5.5
SD,1982,7,333254,315013,18241,5.5
SD,1982,8,333267,314769,18498,5.6
SD,1982,9,333612,314380,19232,5.8
SD,1982,10,334353,314643,19710,5.9
SD,1982,11,334223,314906,19317,5.8
SD,1982,12,334085,314828,19257,5.8
SD,1983,1,334455,314891,19564,5.8
SD,1983,2,334840,315316,19524,5.8
SD,1983,3,334882,315580,19302,5.8
SD,1983,4,334998,315608,19390,5.8
SD,1983,5,334493,315937,18556,5.5
SD,1983,6,333826,316439,17387,5.2
SD,1983,7,333903,316817,17086,5.1
SD,1983,8,334378,317422,16956,5.1
SD,1983,9,334996,318353,16643,5
SD,1983,10,335705,319169,16536,4.9
SD,1983,11,335924,319870,16054,4.8
SD,1983,12,336564,320599,15965,4.7
SD,1984,1,336884,321746,15138,4.5
SD,1984,2,337297,322551,14746,4.4
SD,1984,3,338243,323382,14861,4.4
SD,1984,4,339658,324193,15465,4.6
SD,1984,5,340503,325156,15347,4.5
SD,1984,6,340946,325832,15114,4.4
SD,1984,7,341516,326551,14965,4.4
SD,1984,8,342058,326885,15173,4.4
SD,1984,9,342804,327202,15602,4.6
SD,1984,10,343094,327347,15747,4.6
SD,1984,11,343052,327285,15767,4.6
SD,1984,12,342376,327013,15363,4.5
SD,1985,1,342778,326908,15870,4.6
SD,1985,2,343378,326828,16550,4.8
SD,1985,3,343800,327051,16749,4.9
SD,1985,4,344068,327384,16684,4.8
SD,1985,5,343731,327226,16505,4.8
SD,1985,6,343899,327095,16804,4.9
SD,1985,7,344609,327634,16975,4.9
SD,1985,8,344574,328235,16339,4.7
SD,1985,9,344820,328379,16441,4.8
SD,1985,10,344950,328470,16480,4.8
SD,1985,11,345868,329041,16827,4.9
SD,1985,12,347235,329984,17251,5
SD,1986,1,346851,330255,16596,4.8
SD,1986,2,347506,330747,16759,4.8
SD,1986,3,347864,331315,16549,4.8
SD,1986,4,348343,331944,16399,4.7
SD,1986,5,348942,332707,16235,4.7
SD,1986,6,349081,333080,16001,4.6
SD,1986,7,349603,333555,16048,4.6
SD,1986,8,350247,334092,16155,4.6
SD,1986,9,350787,334738,16049,4.6
SD,1986,10,351228,335110,16118,4.6
SD,1986,11,351705,335487,16218,4.6
SD,1986,12,351686,335754,15932,4.5
SD,1987,1,352167,336349,15818,4.5
SD,1987,2,352344,336858,15486,4.4
SD,1987,3,352816,337200,15616,4.4
SD,1987,4,353085,337551,15534,4.4
SD,1987,5,353624,337913,15711,4.4
SD,1987,6,354024,338457,15567,4.4
SD,1987,7,354249,338784,15465,4.4
SD,1987,8,354470,338960,15510,4.4
SD,1987,9,354833,339367,15466,4.4
SD,1987,10,354881,339638,15243,4.3
SD,1987,11,355744,340108,15636,4.4
SD,1987,12,356202,340444,15758,4.4
SD,1988,1,356793,340777,16016,4.5
SD,1988,2,356708,340755,15953,4.5
SD,1988,3,356784,341286,15498,4.3
SD,1988,4,356196,341446,14750,4.1
SD,1988,5,356340,341454,14886,4.2
SD,1988,6,356139,341800,14339,4
SD,1988,7,356086,341859,14227,4
SD,1988,8,356547,342006,14541,4.1
SD,1988,9,357223,342524,14699,4.1
SD,1988,10,357522,342822,14700,4.1
SD,1988,11,358115,343430,14685,4.1
SD,1988,12,358337,344129,14208,4
SD,1989,1,358516,344626,13890,3.9
SD,1989,2,359241,345108,14133,3.9
SD,1989,3,359502,345480,14022,3.9
SD,1989,4,359979,345626,14353,4
SD,1989,5,359989,345621,14368,4
SD,1989,6,359725,345331,14394,4
SD,1989,7,359349,344844,14505,4
SD,1989,8,359059,344411,14648,4.1
SD,1989,9,358725,344148,14577,4.1
SD,1989,10,357784,343338,14446,4
SD,1989,11,356351,342415,13936,3.9
SD,1989,12,355616,341490,14126,4
SD,1990,1,353586,340198,13388,3.8
SD,1990,2,352220,339264,12956,3.7
SD,1990,3,351290,338298,12992,3.7
SD,1990,4,351012,337858,13154,3.7
SD,1990,5,350672,337213,13459,3.8
SD,1990,6,350049,336614,13435,3.8
SD,1990,7,349780,336450,13330,3.8
SD,1990,8,349898,336736,13162,3.8
SD,1990,9,349823,336704,13119,3.8
SD,1990,10,349694,336445,13249,3.8
SD,1990,11,349564,336695,12869,3.7
SD,1990,12,350110,337560,12550,3.6
SD,1991,1,350784,338150,12634,3.6
SD,1991,2,351332,338839,12493,3.6
SD,1991,3,351619,339088,12531,3.6
SD,1991,4,352454,339772,12682,3.6
SD,1991,5,353078,340336,12742,3.6
SD,1991,6,353648,340789,12859,3.6
SD,1991,7,353884,341052,12832,3.6
SD,1991,8,354428,341494,12934,3.6
SD,1991,9,355241,342337,12904,3.6
SD,1991,10,355884,343058,12826,3.6
SD,1991,11,356473,343454,13019,3.7
SD,1991,12,356536,343927,12609,3.5
SD,1992,1,356619,344321,12298,3.4
SD,1992,2,356642,344387,12255,3.4
SD,1992,3,356728,344448,12280,3.4
SD,1992,4,356983,344783,12200,3.4
SD,1992,5,357997,345062,12935,3.6
SD,1992,6,358222,345358,12864,3.6
SD,1992,7,358700,345859,12841,3.6
SD,1992,8,359689,346516,13173,3.7
SD,1992,9,360027,347044,12983,3.6
SD,1992,10,360460,347505,12955,3.6
SD,1992,11,361076,348086,12990,3.6
SD,1992,12,361265,348581,12684,3.5
SD,1993,1,361891,348786,13105,3.6
SD,1993,2,362336,349375,12961,3.6
SD,1993,3,363301,350084,13217,3.6
SD,1993,4,363966,350797,13169,3.6
SD,1993,5,364205,351382,12823,3.5
SD,1993,6,365350,352195,13155,3.6
SD,1993,7,366321,353007,13314,3.6
SD,1993,8,367120,353831,13289,3.6
SD,1993,9,367607,354299,13308,3.6
SD,1993,10,368343,355231,13112,3.6
SD,1993,11,368819,356038,12781,3.5
SD,1993,12,369675,356963,12712,3.4
SD,1994,1,370647,358303,12344,3.3
SD,1994,2,372319,359648,12671,3.4
SD,1994,3,373476,360881,12595,3.4
SD,1994,4,374483,362151,12332,3.3
SD,1994,5,376129,363295,12834,3.4
SD,1994,6,377005,364176,12829,3.4
SD,1994,7,378203,365324,12879,3.4
SD,1994,8,379243,366373,12870,3.4
SD,1994,9,380066,367071,12995,3.4
SD,1994,10,380797,367884,12913,3.4
SD,1994,11,380989,368707,12282,3.2
SD,1994,12,381757,369610,12147,3.2
SD,1995,1,382208,370286,11922,3.1
SD,1995,2,382556,370950,11606,3
SD,1995,3,383004,371584,11420,3
SD,1995,4,384235,371869,12366,3.2
SD,1995,5,385113,372584,12529,3.3
SD,1995,6,385835,373374,12461,3.2
SD,1995,7,386795,373867,12928,3.3
SD,1995,8,387515,374448,13067,3.4
SD,1995,9,388083,375077,13006,3.4
SD,1995,10,388545,375537,13008,3.3
SD,1995,11,389238,376005,13233,3.4
SD,1995,12,389926,376599,13327,3.4
SD,1996,1,390265,377225,13040,3.3
SD,1996,2,391162,377707,13455,3.4
SD,1996,3,391678,378232,13446,3.4
SD,1996,4,391892,378478,13414,3.4
SD,1996,5,392428,378924,13504,3.4
SD,1996,6,392834,379171,13663,3.5
SD,1996,7,393098,379484,13614,3.5
SD,1996,8,393164,379785,13379,3.4
SD,1996,9,393288,379964,13324,3.4
SD,1996,10,393480,380338,13142,3.3
SD,1996,11,393638,380643,12995,3.3
SD,1996,12,393715,380707,13008,3.3
SD,1997,1,393729,380901,12828,3.3
SD,1997,2,393185,381193,11992,3
SD,1997,3,393377,381606,11771,3
SD,1997,4,394311,382081,12230,3.1
SD,1997,5,394469,382567,11902,3
SD,1997,6,394816,382837,11979,3
SD,1997,7,395201,383286,11915,3
SD,1997,8,396010,383855,12155,3.1
SD,1997,9,396423,384284,12139,3.1
SD,1997,10,396742,384742,12000,3
SD,1997,11,397222,385328,11894,3
SD,1997,12,397825,385907,11918,3
SD,1998,1,398645,386554,12091,3
SD,1998,2,398865,387214,11651,2.9
SD,1998,3,399670,387647,12023,3
SD,1998,4,399777,388006,11771,2.9
SD,1998,5,400730,388907,11823,3
SD,1998,6,401741,389647,12094,3
SD,1998,7,402168,390106,12062,3
SD,1998,8,402417,390556,11861,2.9
SD,1998,9,403055,391177,11878,2.9
SD,1998,10,403933,392011,11922,3
SD,1998,11,404690,392456,12234,3
SD,1998,12,404439,392700,11739,2.9
SD,1999,1,404993,393049,11944,2.9
SD,1999,2,405130,393457,11673,2.9
SD,1999,3,405480,393775,11705,2.9
SD,1999,4,405110,393751,11359,2.8
SD,1999,5,405599,394112,11487,2.8
SD,1999,6,406030,394655,11375,2.8
SD,1999,7,406675,395225,11450,2.8
SD,1999,8,406993,395297,11696,2.9
SD,1999,9,407244,395762,11482,2.8
SD,1999,10,407512,396165,11347,2.8
SD,1999,11,407631,396683,10948,2.7
SD,1999,12,407535,396846,10689,2.6
SD,2000,1,407089,396565,10524,2.6
SD,2000,2,407605,397046,10559,2.6
SD,2000,3,408974,399029,9945,2.4
SD,2000,4,408781,398513,10268,2.5
SD,2000,5,408795,397938,10857,2.7
SD,2000,6,409333,398207,11126,2.7
SD,2000,7,408243,397171,11072,2.7
SD,2000,8,408229,397010,11219,2.7
SD,2000,9,408800,397598,11202,2.7
SD,2000,10,409147,397772,11375,2.8
SD,2000,11,409776,397508,12268,3
SD,2000,12,409442,397773,11669,2.8
SD,2001,1,410661,399204,11457,2.8
SD,2001,2,411660,399674,11986,2.9
SD,2001,3,412123,399927,12196,3
SD,2001,4,412409,399744,12665,3.1
SD,2001,5,413088,400524,12564,3
SD,2001,6,413841,400978,12863,3.1
SD,2001,7,413987,400937,13050,3.2
SD,2001,8,413981,400987,12994,3.1
SD,2001,9,413687,400469,13218,3.2
SD,2001,10,414059,400167,13892,3.4
SD,2001,11,414464,400856,13608,3.3
SD,2001,12,415202,400751,14451,3.5
SD,2002,1,413679,399545,14134,3.4
SD,2002,2,414161,399895,14266,3.4
SD,2002,3,414736,399992,14744,3.6
SD,2002,4,415231,400757,14474,3.5
SD,2002,5,415602,402230,13372,3.2
SD,2002,6,416148,402884,13264,3.2
SD,2002,7,416728,403378,13350,3.2
SD,2002,8,417032,403625,13407,3.2
SD,2002,9,417019,403718,13301,3.2
SD,2002,10,417760,404207,13553,3.2
SD,2002,11,417815,403967,13848,3.3
SD,2002,12,418298,404558,13740,3.3
SD,2003,1,420873,406359,14514,3.4
SD,2003,2,420888,406144,14744,3.5
SD,2003,3,420984,406178,14806,3.5
SD,2003,4,421577,406706,14871,3.5
SD,2003,5,422074,407353,14721,3.5
SD,2003,6,422723,407900,14823,3.5
SD,2003,7,423830,408688,15142,3.6
SD,2003,8,424545,409506,15039,3.5
SD,2003,9,424005,408896,15109,3.6
SD,2003,10,424299,409425,14874,3.5
SD,2003,11,425296,409937,15359,3.6
SD,2003,12,425438,409971,15467,3.6
SD,2004,1,425067,409746,15321,3.6
SD,2004,2,425085,409587,15498,3.6
SD,2004,3,425467,409722,15745,3.7
SD,2004,4,426830,411974,14856,3.5
SD,2004,5,427444,411946,15498,3.6
SD,2004,6,428005,412276,15729,3.7
SD,2004,7,427709,411953,15756,3.7
SD,2004,8,428180,412414,15766,3.7
SD,2004,9,428845,412970,15875,3.7
SD,2004,10,428946,412912,16034,3.7
SD,2004,11,428497,412643,15854,3.7
SD,2004,12,428231,412350,15881,3.7
SD,2005,1,428713,412001,16712,3.9
SD,2005,2,428850,412291,16559,3.9
SD,2005,3,429339,413042,16297,3.8
SD,2005,4,429926,414028,15898,3.7
SD,2005,5,429573,413346,16227,3.8
SD,2005,6,430259,414474,15785,3.7
SD,2005,7,430900,415352,15548,3.6
SD,2005,8,430946,415681,15265,3.5
SD,2005,9,431669,416454,15215,3.5
SD,2005,10,430947,415982,14965,3.5
SD,2005,11,431411,416947,14464,3.4
SD,2005,12,432789,417806,14983,3.5
SD,2006,1,431927,417995,13932,3.2
SD,2006,2,432292,418898,13394,3.1
SD,2006,3,433021,419767,13254,3.1
SD,2006,4,433244,420148,13096,3
SD,2006,5,434418,421112,13306,3.1
SD,2006,6,435926,422551,13375,3.1
SD,2006,7,436606,423245,13361,3.1
SD,2006,8,437733,424274,13459,3.1
SD,2006,9,437815,424310,13505,3.1
SD,2006,10,438033,424493,13540,3.1
SD,2006,11,438529,425248,13281,3
SD,2006,12,439243,426215,13028,3
SD,2007,1,439209,426142,13067,3
SD,2007,2,440249,426847,13402,3
SD,2007,3,440789,427845,12944,2.9
SD,2007,4,441277,428152,13125,3
SD,2007,5,442239,429465,12774,2.9
SD,2007,6,442622,430075,12547,2.8
SD,2007,7,443659,431200,12459,2.8
SD,2007,8,443578,431253,12325,2.8
SD,2007,9,443150,430569,12581,2.8
SD,2007,10,443105,430705,12400,2.8
SD,2007,11,442846,430686,12160,2.7
SD,2007,12,442297,430404,11893,2.7
SD,2008,1,443080,431072,12008,2.7
SD,2008,2,443880,431714,12166,2.7
SD,2008,3,443986,431716,12270,2.8
SD,2008,4,443706,430764,12942,2.9
SD,2008,5,443915,431174,12741,2.9
SD,2008,6,444049,431267,12782,2.9
SD,2008,7,444601,431395,13206,3
SD,2008,8,445861,432103,13758,3.1
SD,2008,9,446024,431921,14103,3.2
SD,2008,10,446385,431903,14482,3.2
SD,2008,11,446447,431206,15241,3.4
SD,2008,12,446746,430317,16429,3.7
SD,2009,1,445331,425669,19662,4.4
TN,1976,1,1833061,1729407,103654,5.7
TN,1976,2,1839702,1733452,106250,5.8
TN,1976,3,1840744,1732003,108741,5.9
TN,1976,4,1844674,1733553,111121,6
TN,1976,5,1843984,1730626,113358,6.1
TN,1976,6,1851595,1736163,115432,6.2
TN,1976,7,1870455,1753149,117306,6.3
TN,1976,8,1878513,1759563,118950,6.3
TN,1976,9,1875060,1754699,120361,6.4
TN,1976,10,1877812,1756282,121530,6.5
TN,1976,11,1882873,1760446,122427,6.5
TN,1976,12,1890624,1767573,123051,6.5
TN,1977,1,1902127,1778726,123401,6.5
TN,1977,2,1914362,1790739,123623,6.5
TN,1977,3,1920003,1796324,123679,6.4
TN,1977,4,1929906,1806339,123567,6.4
TN,1977,5,1935998,1812681,123317,6.4
TN,1977,6,1938774,1815810,122964,6.3
TN,1977,7,1947233,1824710,122523,6.3
TN,1977,8,1950402,1828369,122033,6.3
TN,1977,9,1958878,1837372,121506,6.2
TN,1977,10,1957773,1836804,120969,6.2
TN,1977,11,1956363,1835939,120424,6.2
TN,1977,12,1956378,1836498,119880,6.1
TN,1978,1,1946152,1826811,119341,6.1
TN,1978,2,1942871,1824034,118837,6.1
TN,1978,3,1958135,1839726,118409,6
TN,1978,4,1972949,1854923,118026,6
TN,1978,5,1986047,1868344,117703,5.9
TN,1978,6,1997337,1879895,117442,5.9
TN,1978,7,1998785,1881569,117216,5.9
TN,1978,8,1995535,1878532,117003,5.9
TN,1978,9,1986110,1869314,116796,5.9
TN,1978,10,1997260,1880641,116619,5.8
TN,1978,11,2009976,1893470,116506,5.8
TN,1978,12,2014090,1897591,116499,5.8
TN,1979,1,2013514,1896892,116622,5.8
TN,1979,2,2015943,1899005,116938,5.8
TN,1979,3,2025172,1907717,117455,5.8
TN,1979,4,2027799,1909596,118203,5.8
TN,1979,5,2033994,1914836,119158,5.9
TN,1979,6,2043342,1923059,120283,5.9
TN,1979,7,2040492,1918932,121560,6
TN,1979,8,2050742,1927721,123021,6
TN,1979,9,2056089,1931392,124697,6.1
TN,1979,10,2054326,1927714,126612,6.2
TN,1979,11,2059800,1931010,128790,6.3
TN,1979,12,2065875,1934652,131223,6.4
TN,1980,1,2069127,1935192,133935,6.5
TN,1980,2,2070221,1933400,136821,6.6
TN,1980,3,2069316,1929464,139852,6.8
TN,1980,4,2066602,1923597,143005,6.9
TN,1980,5,2058705,1912449,146256,7.1
TN,1980,6,2061848,1912291,149557,7.3
TN,1980,7,2063596,1910694,152902,7.4
TN,1980,8,2060240,1903956,156284,7.6
TN,1980,9,2074447,1914771,159676,7.7
TN,1980,10,2082360,1919272,163088,7.8
TN,1980,11,2088252,1921755,166497,8
TN,1980,12,2094543,1924622,169921,8.1
TN,1981,1,2108526,1935165,173361,8.2
TN,1981,2,2113905,1936983,176922,8.4
TN,1981,3,2118105,1937514,180591,8.5
TN,1981,4,2121485,1937105,184380,8.7
TN,1981,5,2122523,1934220,188303,8.9
TN,1981,6,2118248,1925889,192359,9.1
TN,1981,7,2122312,1925741,196571,9.3
TN,1981,8,2134334,1933360,200974,9.4
TN,1981,9,2132499,1926903,205596,9.6
TN,1981,10,2133223,1922795,210428,9.9
TN,1981,11,2126547,1911107,215440,10.1
TN,1981,12,2125274,1904653,220621,10.4
TN,1982,1,2118196,1892257,225939,10.7
TN,1982,2,2119918,1888764,231154,10.9
TN,1982,3,2123340,1887136,236204,11.1
TN,1982,4,2134295,1893248,241047,11.3
TN,1982,5,2143087,1897456,245631,11.5
TN,1982,6,2145826,1895905,249921,11.6
TN,1982,7,2151794,1897939,253855,11.8
TN,1982,8,2149042,1891661,257381,12
TN,1982,9,2152496,1892043,260453,12.1
TN,1982,10,2149555,1886533,263022,12.2
TN,1982,11,2151026,1885989,265037,12.3
TN,1982,12,2155641,1889177,266464,12.4
TN,1983,1,2171914,1904650,267264,12.3
TN,1983,2,2176788,1909482,267306,12.3
TN,1983,3,2180746,1914122,266624,12.2
TN,1983,4,2182913,1917657,265256,12.2
TN,1983,5,2187974,1924746,263228,12
TN,1983,6,2187416,1926841,260575,11.9
TN,1983,7,2181558,1924215,257343,11.8
TN,1983,8,2191901,1938311,253590,11.6
TN,1983,9,2194496,1945119,249377,11.4
TN,1983,10,2197161,1952383,244778,11.1
TN,1983,11,2199969,1960110,239859,10.9
TN,1983,12,2206200,1971503,234697,10.6
TN,1984,1,2219595,1990235,229360,10.3
TN,1984,2,2230488,2006229,224259,10.1
TN,1984,3,2226901,2007447,219454,9.9
TN,1984,4,2226332,2011382,214950,9.7
TN,1984,5,2226392,2015643,210749,9.5
TN,1984,6,2231901,2025039,206862,9.3
TN,1984,7,2235983,2032681,203302,9.1
TN,1984,8,2237440,2037342,200098,8.9
TN,1984,9,2242711,2045465,197246,8.8
TN,1984,10,2242677,2047905,194772,8.7
TN,1984,11,2241605,2048932,192673,8.6
TN,1984,12,2239441,2048509,190932,8.5
TN,1985,1,2238569,2049041,189528,8.5
TN,1985,2,2233534,2045208,188326,8.4
TN,1985,3,2242490,2055173,187317,8.4
TN,1985,4,2251195,2064717,186478,8.3
TN,1985,5,2255465,2069684,185781,8.2
TN,1985,6,2257544,2072330,185214,8.2
TN,1985,7,2256323,2071540,184783,8.2
TN,1985,8,2254831,2070365,184466,8.2
TN,1985,9,2262213,2077948,184265,8.1
TN,1985,10,2265237,2081046,184191,8.1
TN,1985,11,2271358,2087128,184230,8.1
TN,1985,12,2280701,2096379,184322,8.1
TN,1986,1,2285837,2101408,184429,8.1
TN,1986,2,2281208,2096819,184389,8.1
TN,1986,3,2283578,2099407,184171,8.1
TN,1986,4,2283135,2099382,183753,8
TN,1986,5,2287347,2104208,183139,8
TN,1986,6,2281503,2099179,182324,8
TN,1986,7,2291491,2110203,181288,7.9
TN,1986,8,2299057,2119029,180028,7.8
TN,1986,9,2295362,2116791,178571,7.8
TN,1986,10,2297939,2121054,176885,7.7
TN,1986,11,2300828,2125873,174955,7.6
TN,1986,12,2307308,2134503,172805,7.5
TN,1987,1,2316666,2146192,170474,7.4
TN,1987,2,2318422,2150295,168127,7.3
TN,1987,3,2313596,2147846,165750,7.2
TN,1987,4,2312246,2148897,163349,7.1
TN,1987,5,2317342,2156418,160924,6.9
TN,1987,6,2322884,2164387,158497,6.8
TN,1987,7,2327583,2171478,156105,6.7
TN,1987,8,2323946,2170164,153782,6.6
TN,1987,9,2327163,2175603,151560,6.5
TN,1987,10,2335128,2185673,149455,6.4
TN,1987,11,2334880,2187368,147512,6.3
TN,1987,12,2339764,2194051,145713,6.2
TN,1988,1,2328533,2184467,144066,6.2
TN,1988,2,2331236,2188717,142519,6.1
TN,1988,3,2331878,2190832,141046,6
TN,1988,4,2332309,2192667,139642,6
TN,1988,5,2331859,2193571,138288,5.9
TN,1988,6,2336052,2199099,136953,5.9
TN,1988,7,2343937,2208309,135628,5.8
TN,1988,8,2335874,2201566,134308,5.7
TN,1988,9,2330347,2197350,132997,5.7
TN,1988,10,2329169,2197500,131669,5.7
TN,1988,11,2339391,2209049,130342,5.6
TN,1988,12,2332090,2203059,129031,5.5
TN,1989,1,2343308,2215570,127738,5.5
TN,1989,2,2347433,2220938,126495,5.4
TN,1989,3,2349649,2224291,125358,5.3
TN,1989,4,2354853,2230504,124349,5.3
TN,1989,5,2357438,2233940,123498,5.2
TN,1989,6,2367037,2244205,122832,5.2
TN,1989,7,2369594,2247242,122352,5.2
TN,1989,8,2378941,2256881,122060,5.1
TN,1989,9,2385922,2263989,121933,5.1
TN,1989,10,2378192,2256225,121967,5.1
TN,1989,11,2373014,2250860,122154,5.1
TN,1989,12,2373132,2250623,122509,5.2
TN,1990,1,2377274,2254220,123054,5.2
TN,1990,2,2383117,2259238,123879,5.2
TN,1990,3,2386458,2261477,124981,5.2
TN,1990,4,2392344,2265989,126355,5.3
TN,1990,5,2400681,2272721,127960,5.3
TN,1990,6,2406709,2276930,129779,5.4
TN,1990,7,2406334,2274491,131843,5.5
TN,1990,8,2414978,2280843,134135,5.6
TN,1990,9,2413003,2276385,136618,5.7
TN,1990,10,2410341,2271068,139273,5.8
TN,1990,11,2411214,2269141,142073,5.9
TN,1990,12,2410660,2265677,144983,6
TN,1991,1,2405182,2257209,147973,6.2
TN,1991,2,2405787,2254962,150825,6.3
TN,1991,3,2403620,2250125,153495,6.4
TN,1991,4,2406902,2250951,155951,6.5
TN,1991,5,2413599,2255409,158190,6.6
TN,1991,6,2419576,2259385,160191,6.6
TN,1991,7,2426281,2264366,161915,6.7
TN,1991,8,2439139,2275809,163330,6.7
TN,1991,9,2444972,2280548,164424,6.7
TN,1991,10,2447460,2282283,165177,6.7
TN,1991,11,2448042,2282449,165593,6.8
TN,1991,12,2444008,2278318,165690,6.8
TN,1992,1,2453524,2288034,165490,6.7
TN,1992,2,2457626,2292465,165161,6.7
TN,1992,3,2474631,2309902,164729,6.7
TN,1992,4,2466771,2302544,164227,6.7
TN,1992,5,2466000,2302314,163686,6.6
TN,1992,6,2471483,2308365,163118,6.6
TN,1992,7,2478809,2316267,162542,6.6
TN,1992,8,2476966,2314982,161984,6.5
TN,1992,9,2482513,2321074,161439,6.5
TN,1992,10,2504644,2343733,160911,6.4
TN,1992,11,2508463,2348057,160406,6.4
TN,1992,12,2512074,2352195,159879,6.4
TN,1993,1,2516078,2356769,159309,6.3
TN,1993,2,2520961,2362422,158539,6.3
TN,1993,3,2512152,2354570,157582,6.3
TN,1993,4,2524526,2368111,156415,6.2
TN,1993,5,2527928,2372887,155041,6.1
TN,1993,6,2535486,2382017,153469,6.1
TN,1993,7,2549028,2397305,151723,6
TN,1993,8,2549794,2399970,149824,5.9
TN,1993,9,2555684,2407876,147808,5.8
TN,1993,10,2568320,2422603,145717,5.7
TN,1993,11,2574999,2431411,143588,5.6
TN,1993,12,2584324,2442871,141453,5.5
TN,1994,1,2589608,2450249,139359,5.4
TN,1994,2,2600116,2462600,137516,5.3
TN,1994,3,2615994,2480069,135925,5.2
TN,1994,4,2630095,2495475,134620,5.1
TN,1994,5,2642475,2508844,133631,5.1
TN,1994,6,2644797,2511832,132965,5
TN,1994,7,2648589,2515978,132611,5
TN,1994,8,2653626,2521042,132584,5
TN,1994,9,2667853,2534978,132875,5
TN,1994,10,2671520,2538036,133484,5
TN,1994,11,2685881,2551445,134436,5
TN,1994,12,2698233,2562466,135767,5
TN,1995,1,2701612,2564199,137413,5.1
TN,1995,2,2705205,2566151,139054,5.1
TN,1995,3,2710409,2569745,140664,5.2
TN,1995,4,2702832,2560638,142194,5.3
TN,1995,5,2705221,2561639,143582,5.3
TN,1995,6,2706535,2561749,144786,5.3
TN,1995,7,2705075,2559304,145771,5.4
TN,1995,8,2720904,2574388,146516,5.4
TN,1995,9,2736851,2589837,147014,5.4
TN,1995,10,2735286,2588026,147260,5.4
TN,1995,11,2740515,2593248,147267,5.4
TN,1995,12,2746122,2599077,147045,5.4
TN,1996,1,2748485,2601885,146600,5.3
TN,1996,2,2750884,2604616,146268,5.3
TN,1996,3,2752532,2606474,146058,5.3
TN,1996,4,2748810,2602816,145994,5.3
TN,1996,5,2752372,2606282,146090,5.3
TN,1996,6,2749646,2603300,146346,5.3
TN,1996,7,2752423,2605667,146756,5.3
TN,1996,8,2760635,2613328,147307,5.3
TN,1996,9,2766012,2618011,148001,5.4
TN,1996,10,2768912,2620111,148801,5.4
TN,1996,11,2775518,2625854,149664,5.4
TN,1996,12,2773924,2623355,150569,5.4
TN,1997,1,2774197,2622689,151508,5.5
TN,1997,2,2780130,2628025,152105,5.5
TN,1997,3,2785543,2633198,152345,5.5
TN,1997,4,2794399,2642180,152219,5.4
TN,1997,5,2789895,2638160,151735,5.4
TN,1997,6,2788621,2637723,150898,5.4
TN,1997,7,2782840,2633143,149697,5.4
TN,1997,8,2782445,2634296,148149,5.3
TN,1997,9,2786119,2639829,146290,5.3
TN,1997,10,2795747,2651598,144149,5.2
TN,1997,11,2798684,2656900,141784,5.1
TN,1997,12,2801555,2662316,139239,5
TN,1998,1,2799011,2662457,136554,4.9
TN,1998,2,2793473,2659411,134062,4.8
TN,1998,3,2792205,2660435,131770,4.7
TN,1998,4,2798794,2669127,129667,4.6
TN,1998,5,2808870,2681114,127756,4.5
TN,1998,6,2813087,2687021,126066,4.5
TN,1998,7,2815084,2690478,124606,4.4
TN,1998,8,2813885,2690526,123359,4.4
TN,1998,9,2817187,2694874,122313,4.3
TN,1998,10,2825454,2704004,121450,4.3
TN,1998,11,2830621,2709865,120756,4.3
TN,1998,12,2832722,2712500,120222,4.2
TN,1999,1,2821034,2701218,119816,4.2
TN,1999,2,2824219,2704905,119314,4.2
TN,1999,3,2826339,2707610,118729,4.2
TN,1999,4,2833371,2715280,118091,4.2
TN,1999,5,2832385,2714956,117429,4.1
TN,1999,6,2837796,2721007,116789,4.1
TN,1999,7,2849560,2733342,116218,4.1
TN,1999,8,2847609,2731938,115671,4.1
TN,1999,9,2845965,2730838,115127,4
TN,1999,10,2848995,2734399,114596,4
TN,1999,11,2848007,2733945,114062,4
TN,1999,12,2849576,2736050,113526,4
TN,2000,1,2856658,2746245,110413,3.9
TN,2000,2,2861217,2751080,110137,3.8
TN,2000,3,2873511,2764570,108941,3.8
TN,2000,4,2866326,2755364,110962,3.9
TN,2000,5,2869970,2756779,113191,3.9
TN,2000,6,2875996,2760129,115867,4
TN,2000,7,2873769,2759196,114573,4
TN,2000,8,2878122,2758947,119175,4.1
TN,2000,9,2877440,2757148,120292,4.2
TN,2000,10,2874104,2756458,117646,4.1
TN,2000,11,2876130,2756120,120010,4.2
TN,2000,12,2875226,2755941,119285,4.1
TN,2001,1,2874965,2754535,120430,4.2
TN,2001,2,2873227,2751180,122047,4.2
TN,2001,3,2867626,2746412,121214,4.2
TN,2001,4,2866168,2741224,124944,4.4
TN,2001,5,2865914,2736442,129472,4.5
TN,2001,6,2866295,2731969,134326,4.7
TN,2001,7,2861336,2723304,138032,4.8
TN,2001,8,2860349,2722744,137605,4.8
TN,2001,9,2858752,2718314,140438,4.9
TN,2001,10,2855222,2708166,147056,5.2
TN,2001,11,2855062,2704586,150476,5.3
TN,2001,12,2857277,2703405,153872,5.4
TN,2002,1,2863211,2704249,158962,5.6
TN,2002,2,2860371,2703855,156516,5.5
TN,2002,3,2858817,2702617,156200,5.5
TN,2002,4,2862111,2706590,155521,5.4
TN,2002,5,2861838,2709237,152601,5.3
TN,2002,6,2865712,2713900,151812,5.3
TN,2002,7,2871289,2720927,150362,5.2
TN,2002,8,2866823,2720975,145848,5.1
TN,2002,9,2867948,2720318,147630,5.1
TN,2002,10,2872634,2723919,148715,5.2
TN,2002,11,2875206,2725518,149688,5.2
TN,2002,12,2879342,2727800,151542,5.3
TN,2003,1,2890510,2736002,154508,5.3
TN,2003,2,2890160,2731856,158304,5.5
TN,2003,3,2892113,2730414,161699,5.6
TN,2003,4,2899586,2733423,166163,5.7
TN,2003,5,2900861,2735486,165375,5.7
TN,2003,6,2899593,2731182,168411,5.8
TN,2003,7,2893852,2722405,171447,5.9
TN,2003,8,2891022,2723596,167426,5.8
TN,2003,9,2895968,2727231,168737,5.8
TN,2003,10,2902374,2734125,168249,5.8
TN,2003,11,2899791,2734401,165390,5.7
TN,2003,12,2897782,2736327,161455,5.6
TN,2004,1,2899110,2744503,154607,5.3
TN,2004,2,2908112,2754269,153843,5.3
TN,2004,3,2900269,2745178,155091,5.3
TN,2004,4,2896807,2744497,152310,5.3
TN,2004,5,2894500,2742103,152397,5.3
TN,2004,6,2900432,2744453,155979,5.4
TN,2004,7,2902239,2745486,156753,5.4
TN,2004,8,2903843,2743390,160453,5.5
TN,2004,9,2903610,2740467,163143,5.6
TN,2004,10,2911886,2747288,164598,5.7
TN,2004,11,2914302,2750438,163864,5.6
TN,2004,12,2917148,2752814,164334,5.6
TN,2005,1,2906576,2745657,160919,5.5
TN,2005,2,2913547,2752181,161366,5.5
TN,2005,3,2918002,2754687,163315,5.6
TN,2005,4,2923748,2760611,163137,5.6
TN,2005,5,2927967,2761332,166635,5.7
TN,2005,6,2928151,2762905,165246,5.6
TN,2005,7,2933475,2771526,161949,5.5
TN,2005,8,2940303,2776487,163816,5.6
TN,2005,9,2949221,2786092,163129,5.5
TN,2005,10,2953426,2787192,166234,5.6
TN,2005,11,2958079,2793935,164144,5.5
TN,2005,12,2962533,2801866,160667,5.4
TN,2006,1,2972910,2815920,156990,5.3
TN,2006,2,2972538,2817992,154546,5.2
TN,2006,3,2984786,2827430,157356,5.3
TN,2006,4,2994147,2835320,158827,5.3
TN,2006,5,3002530,2840714,161816,5.4
TN,2006,6,3009930,2847911,162019,5.4
TN,2006,7,3007677,2849701,157976,5.3
TN,2006,8,3013931,2856642,157289,5.2
TN,2006,9,3009816,2858033,151783,5
TN,2006,10,3003510,2852332,151178,5
TN,2006,11,3006076,2857474,148602,4.9
TN,2006,12,3007806,2865120,142686,4.7
TN,2007,1,3004193,2865778,138415,4.6
TN,2007,2,3001555,2864458,137097,4.6
TN,2007,3,3003515,2868383,135132,4.5
TN,2007,4,2997207,2861632,135575,4.5
TN,2007,5,3003990,2861868,142122,4.7
TN,2007,6,3006310,2865881,140429,4.7
TN,2007,7,3008598,2868316,140282,4.7
TN,2007,8,3019470,2872838,146632,4.9
TN,2007,9,3022885,2869173,153712,5.1
TN,2007,10,3027366,2868113,159253,5.3
TN,2007,11,3031696,2871394,160302,5.3
TN,2007,12,3033772,2873119,160653,5.3
TN,2008,1,3030388,2869901,160487,5.3
TN,2008,2,3035123,2866732,168391,5.5
TN,2008,3,3034931,2861200,173731,5.7
TN,2008,4,3041381,2859955,181426,6
TN,2008,5,3045228,2855195,190033,6.2
TN,2008,6,3039191,2843824,195367,6.4
TN,2008,7,3041094,2841284,199810,6.6
TN,2008,8,3038676,2837382,201294,6.6
TN,2008,9,3046978,2837005,209973,6.9
TN,2008,10,3049195,2838579,210616,6.9
TN,2008,11,3047058,2827358,219700,7.2
TN,2008,12,3046065,2814731,231334,7.6
TN,2009,1,3035217,2773436,261781,8.6
TX,1976,1,5589294,5266044,323250,5.8
TX,1976,2,5609392,5283748,325644,5.8
TX,1976,3,5630539,5303041,327498,5.8
TX,1976,4,5651471,5322609,328862,5.8
TX,1976,5,5673495,5342691,330804,5.8
TX,1976,6,5695691,5364059,331632,5.8
TX,1976,7,5717261,5384588,332673,5.8
TX,1976,8,5738664,5405418,333246,5.8
TX,1976,9,5760413,5426521,333892,5.8
TX,1976,10,5781050,5447563,333487,5.8
TX,1976,11,5801716,5469237,332479,5.7
TX,1976,12,5822669,5491424,331245,5.7
TX,1977,1,5843553,5514111,329442,5.6
TX,1977,2,5864486,5537886,326600,5.6
TX,1977,3,5884515,5560692,323823,5.5
TX,1977,4,5905717,5583397,322320,5.5
TX,1977,5,5927964,5606879,321085,5.4
TX,1977,6,5950316,5629410,320906,5.4
TX,1977,7,5972974,5651769,321205,5.4
TX,1977,8,5995484,5674844,320640,5.3
TX,1977,9,6017063,5698263,318800,5.3
TX,1977,10,6040146,5722544,317602,5.3
TX,1977,11,6062489,5746427,316062,5.2
TX,1977,12,6084937,5770769,314168,5.2
TX,1978,1,6106640,5795284,311356,5.1
TX,1978,2,6127479,5818355,309124,5
TX,1978,3,6151094,5843873,307221,5
TX,1978,4,6173574,5868058,305516,4.9
TX,1978,5,6195765,5892372,303393,4.9
TX,1978,6,6219216,5917236,301980,4.9
TX,1978,7,6241560,5939849,301711,4.8
TX,1978,8,6264484,5962697,301787,4.8
TX,1978,9,6285660,5985116,300544,4.8
TX,1978,10,6307426,6010716,296710,4.7
TX,1978,11,6326154,6034235,291919,4.6
TX,1978,12,6343449,6056947,286502,4.5
TX,1979,1,6363397,6082050,281347,4.4
TX,1979,2,6385124,6106992,278132,4.4
TX,1979,3,6406170,6128596,277574,4.3
TX,1979,4,6426922,6148185,278737,4.3
TX,1979,5,6448233,6167824,280409,4.3
TX,1979,6,6472537,6189822,282715,4.4
TX,1979,7,6495651,6209665,285986,4.4
TX,1979,8,6515763,6227429,288334,4.4
TX,1979,9,6537058,6247243,289815,4.4
TX,1979,10,6556406,6264825,291581,4.4
TX,1979,11,6576177,6281261,294916,4.5
TX,1979,12,6596606,6297250,299356,4.5
TX,1980,1,6617234,6311759,305475,4.6
TX,1980,2,6640079,6326352,313727,4.7
TX,1980,3,6663836,6341721,322115,4.8
TX,1980,4,6690812,6359461,331351,5
TX,1980,5,6720843,6378359,342484,5.1
TX,1980,6,6751222,6398642,352580,5.2
TX,1980,7,6778518,6420774,357744,5.3
TX,1980,8,6809742,6444765,364977,5.4
TX,1980,9,6839971,6468966,371005,5.4
TX,1980,10,6870733,6493246,377487,5.5
TX,1980,11,6899448,6518130,381318,5.5
TX,1980,12,6927253,6544811,382442,5.5
TX,1981,1,6956819,6574091,382728,5.5
TX,1981,2,6982426,6601221,381205,5.5
TX,1981,3,7004920,6626950,377970,5.4
TX,1981,4,7026801,6652583,374218,5.3
TX,1981,5,7048421,6676731,371690,5.3
TX,1981,6,7067455,6697634,369821,5.2
TX,1981,7,7089486,6719452,370034,5.2
TX,1981,8,7111005,6739090,371915,5.2
TX,1981,9,7134664,6759397,375267,5.3
TX,1981,10,7156689,6777085,379604,5.3
TX,1981,11,7177914,6792638,385276,5.4
TX,1981,12,7199493,6806401,393092,5.5
TX,1982,1,7220625,6819075,401550,5.6
TX,1982,2,7242447,6832073,410374,5.7
TX,1982,3,7269118,6844038,425080,5.8
TX,1982,4,7296371,6852726,443645,6.1
TX,1982,5,7327986,6861822,466164,6.4
TX,1982,6,7362412,6870495,491917,6.7
TX,1982,7,7398820,6879488,519332,7
TX,1982,8,7434704,6888758,545946,7.3
TX,1982,9,7469113,6895627,573486,7.7
TX,1982,10,7502177,6904324,597853,8
TX,1982,11,7533638,6915324,618314,8.2
TX,1982,12,7560248,6926545,633703,8.4
TX,1983,1,7581528,6938189,643339,8.5
TX,1983,2,7597435,6948709,648726,8.5
TX,1983,3,7610074,6961210,648864,8.5
TX,1983,4,7620808,6976750,644058,8.5
TX,1983,5,7626791,6992909,633882,8.3
TX,1983,6,7635654,7012932,622722,8.2
TX,1983,7,7644527,7033647,610880,8
TX,1983,8,7652567,7056210,596357,7.8
TX,1983,9,7660753,7080777,579976,7.6
TX,1983,10,7670743,7107164,563579,7.3
TX,1983,11,7681782,7134609,547173,7.1
TX,1983,12,7695275,7163474,531801,6.9
TX,1984,1,7712687,7193706,518981,6.7
TX,1984,2,7731848,7225059,506789,6.6
TX,1984,3,7749623,7254573,495050,6.4
TX,1984,4,7768049,7283029,485020,6.2
TX,1984,5,7789305,7312012,477293,6.1
TX,1984,6,7810678,7338670,472008,6
TX,1984,7,7832060,7361801,470259,6
TX,1984,8,7855151,7383456,471695,6
TX,1984,9,7881006,7403968,477038,6.1
TX,1984,10,7907991,7423193,484798,6.1
TX,1984,11,7934321,7440135,494186,6.2
TX,1984,12,7959480,7456237,503243,6.3
TX,1985,1,7981762,7469432,512330,6.4
TX,1985,2,8005936,7482944,522992,6.5
TX,1985,3,8029094,7495279,533815,6.6
TX,1985,4,8044988,7502520,542468,6.7
TX,1985,5,8054465,7506769,547696,6.8
TX,1985,6,8061340,7510048,551292,6.8
TX,1985,7,8067236,7512281,554955,6.9
TX,1985,8,8070346,7511171,559175,6.9
TX,1985,9,8070753,7506858,563895,7
TX,1985,10,8069192,7500891,568301,7
TX,1985,11,8067872,7495308,572564,7.1
TX,1985,12,8062858,7485662,577196,7.2
TX,1986,1,8058787,7474222,584565,7.3
TX,1986,2,8156740,7463190,693550,8.5
TX,1986,3,8165240,7456445,708795,8.7
TX,1986,4,8177184,7450630,726554,8.9
TX,1986,5,8188637,7445590,743047,9.1
TX,1986,6,8198073,7443541,754532,9.2
TX,1986,7,8206676,7446144,760532,9.3
TX,1986,8,8213414,7449240,764174,9.3
TX,1986,9,8221479,7456271,765208,9.3
TX,1986,10,8228799,7465329,763470,9.3
TX,1986,11,8236652,7477179,759473,9.2
TX,1986,12,8247545,7491996,755549,9.2
TX,1987,1,8260405,7508542,751863,9.1
TX,1987,2,8271474,7525387,746087,9
TX,1987,3,8280218,7540878,739340,8.9
TX,1987,4,8287369,7556518,730851,8.8
TX,1987,5,8295355,7572686,722669,8.7
TX,1987,6,8299888,7585945,713943,8.6
TX,1987,7,8304238,7601478,702760,8.5
TX,1987,8,8305969,7615593,690376,8.3
TX,1987,9,8305416,7626683,678733,8.2
TX,1987,10,8307769,7638897,668872,8.1
TX,1987,11,8312110,7651230,660880,8
TX,1987,12,8316834,7661623,655211,7.9
TX,1988,1,8320339,7669883,650456,7.8
TX,1988,2,8323777,7679515,644262,7.7
TX,1988,3,8328549,7689974,638575,7.7
TX,1988,4,8333641,7701951,631690,7.6
TX,1988,5,8336793,7713348,623445,7.5
TX,1988,6,8341605,7726230,615375,7.4
TX,1988,7,8346800,7737666,609134,7.3
TX,1988,8,8354227,7749469,604758,7.2
TX,1988,9,8362076,7760733,601343,7.2
TX,1988,10,8370546,7772556,597990,7.1
TX,1988,11,8380414,7785594,594820,7.1
TX,1988,12,8390013,7797675,592338,7.1
TX,1989,1,8398449,7809254,589195,7
TX,1989,2,8407751,7821823,585928,7
TX,1989,3,8417110,7835434,581676,6.9
TX,1989,4,8424820,7848481,576339,6.8
TX,1989,5,8432039,7862343,569696,6.8
TX,1989,6,8438462,7874695,563767,6.7
TX,1989,7,8448829,7888805,560024,6.6
TX,1989,8,8461793,7903365,558428,6.6
TX,1989,9,8474495,7917280,557215,6.6
TX,1989,10,8488765,7931604,557161,6.6
TX,1989,11,8503121,7945841,557280,6.6
TX,1989,12,8518286,7960749,557537,6.5
TX,1990,1,8536580,7978068,558512,6.5
TX,1990,2,8550760,7991921,558839,6.5
TX,1990,3,8561498,8005586,555912,6.5
TX,1990,4,8569881,8018433,551448,6.4
TX,1990,5,8578187,8030846,547341,6.4
TX,1990,6,8585842,8042667,543175,6.3
TX,1990,7,8593469,8052189,541280,6.3
TX,1990,8,8603727,8061502,542225,6.3
TX,1990,9,8615889,8070361,545528,6.3
TX,1990,10,8628821,8077629,551192,6.4
TX,1990,11,8643767,8083864,559903,6.5
TX,1990,12,8656267,8089245,567022,6.6
TX,1991,1,8667927,8093445,574482,6.6
TX,1991,2,8684210,8099870,584340,6.7
TX,1991,3,8697726,8106561,591165,6.8
TX,1991,4,8709648,8113719,595929,6.8
TX,1991,5,8721695,8121606,600089,6.9
TX,1991,6,8735017,8130989,604028,6.9
TX,1991,7,8750149,8140588,609561,7
TX,1991,8,8767409,8150094,617315,7
TX,1991,9,8787351,8161110,626241,7.1
TX,1991,10,8809074,8172589,636485,7.2
TX,1991,11,8835354,8186206,649148,7.3
TX,1991,12,8860840,8199890,660950,7.5
TX,1992,1,8887228,8214715,672513,7.6
TX,1992,2,8911979,8230286,681693,7.6
TX,1992,3,8932783,8246508,686275,7.7
TX,1992,4,8950420,8262777,687643,7.7
TX,1992,5,8966163,8279269,686894,7.7
TX,1992,6,8984629,8296534,688095,7.7
TX,1992,7,9002785,8314015,688770,7.7
TX,1992,8,9017664,8331622,686042,7.6
TX,1992,9,9033392,8348868,684524,7.6
TX,1992,10,9050675,8367646,683029,7.5
TX,1992,11,9068211,8386803,681408,7.5
TX,1992,12,9089847,8407073,682774,7.5
TX,1993,1,9109710,8427075,682635,7.5
TX,1993,2,9126542,8447966,678576,7.4
TX,1993,3,9144018,8469767,674251,7.4
TX,1993,4,9160221,8490770,669451,7.3
TX,1993,5,9176549,8512044,664505,7.2
TX,1993,6,9192699,8533234,659465,7.2
TX,1993,7,9210422,8554974,655448,7.1
TX,1993,8,9229067,8576474,652593,7.1
TX,1993,9,9246082,8597191,648891,7
TX,1993,10,9262649,8616856,645793,7
TX,1993,11,9279881,8636540,643341,6.9
TX,1993,12,9299142,8655596,643546,6.9
TX,1994,1,9317660,8674699,642961,6.9
TX,1994,2,9332645,8692692,639953,6.9
TX,1994,3,9346826,8711945,634881,6.8
TX,1994,4,9361375,8732046,629329,6.7
TX,1994,5,9375665,8750999,624666,6.7
TX,1994,6,9389954,8770526,619428,6.6
TX,1994,7,9403966,8790100,613866,6.5
TX,1994,8,9417278,8808156,609122,6.5
TX,1994,9,9429992,8825718,604274,6.4
TX,1994,10,9443130,8844371,598759,6.3
TX,1994,11,9457408,8862970,594438,6.3
TX,1994,12,9472253,8879700,592553,6.3
TX,1995,1,9486976,8896845,590131,6.2
TX,1995,2,9502123,8914239,587884,6.2
TX,1995,3,9518337,8930759,587578,6.2
TX,1995,4,9534825,8947030,587795,6.2
TX,1995,5,9551776,8963598,588178,6.2
TX,1995,6,9567796,8979792,588004,6.1
TX,1995,7,9582366,8995008,587358,6.1
TX,1995,8,9596223,9009564,586659,6.1
TX,1995,9,9611008,9025466,585542,6.1
TX,1995,10,9626075,9040330,585745,6.1
TX,1995,11,9640250,9055253,584997,6.1
TX,1995,12,9651484,9069737,581747,6
TX,1996,1,9662802,9084775,578027,6
TX,1996,2,9675443,9100815,574628,5.9
TX,1996,3,9686725,9115684,571041,5.9
TX,1996,4,9698707,9131151,567556,5.9
TX,1996,5,9711757,9147402,564355,5.8
TX,1996,6,9725606,9163981,561625,5.8
TX,1996,7,9740294,9181566,558728,5.7
TX,1996,8,9754506,9199377,555129,5.7
TX,1996,9,9770904,9218282,552622,5.7
TX,1996,10,9787703,9237697,550006,5.6
TX,1996,11,9804022,9255791,548231,5.6
TX,1996,12,9821288,9275277,546011,5.6
TX,1997,1,9840779,9294461,546318,5.6
TX,1997,2,9857072,9312279,544793,5.5
TX,1997,3,9872918,9330657,542261,5.5
TX,1997,4,9889189,9349304,539885,5.5
TX,1997,5,9905784,9368700,537084,5.4
TX,1997,6,9921403,9387029,534374,5.4
TX,1997,7,9936794,9404671,532123,5.4
TX,1997,8,9952136,9423140,528996,5.3
TX,1997,9,9966593,9441700,524893,5.3
TX,1997,10,9980283,9459563,520720,5.2
TX,1997,11,9991996,9477276,514720,5.2
TX,1997,12,10004178,9494565,509613,5.1
TX,1998,1,10015980,9511405,504575,5
TX,1998,2,10028883,9529149,499734,5
TX,1998,3,10043374,9546117,497257,5
TX,1998,4,10059399,9563284,496115,4.9
TX,1998,5,10074058,9579765,494293,4.9
TX,1998,6,10089729,9595143,494586,4.9
TX,1998,7,10107125,9611035,496090,4.9
TX,1998,8,10122644,9625874,496770,4.9
TX,1998,9,10138581,9641352,497229,4.9
TX,1998,10,10152169,9656034,496135,4.9
TX,1998,11,10164869,9669406,495463,4.9
TX,1998,12,10177764,9683218,494546,4.9
TX,1999,1,10190666,9696643,494023,4.8
TX,1999,2,10204282,9709549,494733,4.8
TX,1999,3,10217473,9722528,494945,4.8
TX,1999,4,10229221,9734658,494563,4.8
TX,1999,5,10240994,9747100,493894,4.8
TX,1999,6,10250628,9759327,491301,4.8
TX,1999,7,10257310,9771314,485996,4.7
TX,1999,8,10265198,9784635,480563,4.7
TX,1999,9,10273778,9797779,475999,4.6
TX,1999,10,10282023,9811124,470899,4.6
TX,1999,11,10289999,9824154,465845,4.5
TX,1999,12,10298734,9836781,461953,4.5
TX,2000,1,10297083,9838533,458550,4.5
TX,2000,2,10306181,9850022,456159,4.4
TX,2000,3,10315655,9861164,454491,4.4
TX,2000,4,10325203,9872032,453171,4.4
TX,2000,5,10334553,9882605,451948,4.4
TX,2000,6,10343822,9892820,451002,4.4
TX,2000,7,10353065,9902734,450331,4.3
TX,2000,8,10362934,9912369,450565,4.3
TX,2000,9,10371490,9921721,449769,4.3
TX,2000,10,10379869,9930718,449151,4.3
TX,2000,11,10388011,9939423,448588,4.3
TX,2000,12,10396300,9947885,448415,4.3
TX,2001,1,10407162,9955982,451180,4.3
TX,2001,2,10422306,9963701,458605,4.4
TX,2001,3,10440753,9971023,469730,4.5
TX,2001,4,10461785,9977989,483796,4.6
TX,2001,5,10484269,9984618,499651,4.8
TX,2001,6,10507077,9990910,516167,4.9
TX,2001,7,10528928,9996833,532095,5.1
TX,2001,8,10550043,10002462,547581,5.2
TX,2001,9,10571038,10007738,563300,5.3
TX,2001,10,10594926,10012699,582227,5.5
TX,2001,11,10620123,10017365,602758,5.7
TX,2001,12,10643613,10021719,621894,5.8
TX,2002,1,10712690,10070670,642020,6
TX,2002,2,10730923,10076894,654029,6.1
TX,2002,3,10748531,10083686,664845,6.2
TX,2002,4,10765343,10091030,674313,6.3
TX,2002,5,10782713,10098962,683751,6.3
TX,2002,6,10798124,10107422,690702,6.4
TX,2002,7,10813304,10116455,696849,6.4
TX,2002,8,10827686,10126106,701580,6.5
TX,2002,9,10841526,10136341,705185,6.5
TX,2002,10,10856156,10147121,709035,6.5
TX,2002,11,10872117,10158468,713649,6.6
TX,2002,12,10889124,10170428,718696,6.6
TX,2003,1,10881945,10157845,724100,6.7
TX,2003,2,10899559,10169736,729823,6.7
TX,2003,3,10917895,10181900,735995,6.7
TX,2003,4,10935856,10194403,741453,6.8
TX,2003,5,10952773,10207137,745636,6.8
TX,2003,6,10968541,10220172,748369,6.8
TX,2003,7,10981987,10233505,748482,6.8
TX,2003,8,10992177,10247207,744970,6.8
TX,2003,9,11000117,10261184,738933,6.7
TX,2003,10,11007540,10275474,732066,6.7
TX,2003,11,11015564,10290080,725484,6.6
TX,2003,12,11023126,10305042,718084,6.5
TX,2004,1,11013847,10305004,708843,6.4
TX,2004,2,11020338,10319737,700601,6.4
TX,2004,3,11026974,10334408,692566,6.3
TX,2004,4,11033818,10349101,684717,6.2
TX,2004,5,11041608,10363709,677899,6.1
TX,2004,6,11049810,10378283,671527,6.1
TX,2004,7,11057438,10392847,664591,6
TX,2004,8,11064331,10407366,656965,5.9
TX,2004,9,11069572,10421820,647752,5.9
TX,2004,10,11075247,10436208,639039,5.8
TX,2004,11,11081550,10450528,631022,5.7
TX,2004,12,11088414,10464810,623604,5.6
TX,2005,1,11094484,10478985,615499,5.5
TX,2005,2,11100518,10493612,606906,5.5
TX,2005,3,11108802,10508756,600046,5.4
TX,2005,4,11119116,10524409,594707,5.3
TX,2005,5,11132242,10540488,591754,5.3
TX,2005,6,11148333,10557050,591283,5.3
TX,2005,7,11167478,10574140,593338,5.3
TX,2005,8,11190642,10591669,598973,5.4
TX,2005,9,11218773,10609703,609070,5.4
TX,2005,10,11241676,10628201,613475,5.5
TX,2005,11,11256994,10647226,609768,5.4
TX,2005,12,11267835,10666732,601103,5.3
TX,2006,1,11280931,10686757,594174,5.3
TX,2006,2,11292779,10706404,586375,5.2
TX,2006,3,11304066,10725648,578418,5.1
TX,2006,4,11316552,10744459,572093,5.1
TX,2006,5,11330746,10762941,567805,5
TX,2006,6,11345532,10781020,564512,5
TX,2006,7,11359615,10798644,560971,4.9
TX,2006,8,11372241,10815893,556348,4.9
TX,2006,9,11382255,10832694,549561,4.8
TX,2006,10,11390481,10849017,541464,4.8
TX,2006,11,11397779,10864920,532859,4.7
TX,2006,12,11404785,10880363,524422,4.6
TX,2007,1,11410882,10895310,515572,4.5
TX,2007,2,11417887,10910045,507842,4.4
TX,2007,3,11426209,10924574,501635,4.4
TX,2007,4,11438738,10938834,499904,4.4
TX,2007,5,11451553,10952888,498665,4.4
TX,2007,6,11465286,10966700,498586,4.3
TX,2007,7,11479639,10980282,499357,4.3
TX,2007,8,11493845,10993609,500236,4.4
TX,2007,9,11507369,11006765,500604,4.4
TX,2007,10,11520917,11019672,501245,4.4
TX,2007,11,11535793,11032366,503427,4.4
TX,2007,12,11551729,11044779,506950,4.4
TX,2008,1,11568848,11056969,511879,4.4
TX,2008,2,11588581,11069232,519349,4.5
TX,2008,3,11610701,11081632,529069,4.6
TX,2008,4,11633510,11094134,539376,4.6
TX,2008,5,11657814,11106718,551096,4.7
TX,2008,6,11682541,11119377,563164,4.8
TX,2008,7,11708438,11132171,576267,4.9
TX,2008,8,11734737,11145083,589654,5
TX,2008,9,11761903,11158087,603816,5.1
TX,2008,10,11791846,11171270,620576,5.3
TX,2008,11,11823440,11184578,638862,5.4
TX,2008,12,11856650,11197975,658675,5.6
TX,2009,1,11816923,11060792,756131,6.4
UT,1976,1,518878,487419,31459,6.1
UT,1976,2,517638,488593,29045,5.6
UT,1976,3,520625,489801,30824,5.9
UT,1976,4,521165,491375,29790,5.7
UT,1976,5,521585,493054,28531,5.5
UT,1976,6,523571,494640,28931,5.5
UT,1976,7,525494,496413,29081,5.5
UT,1976,8,528000,498380,29620,5.6
UT,1976,9,529523,500407,29116,5.5
UT,1976,10,532505,502607,29898,5.6
UT,1976,11,534534,504811,29723,5.6
UT,1976,12,536941,507267,29674,5.5
UT,1977,1,540076,509730,30346,5.6
UT,1977,2,543683,512164,31519,5.8
UT,1977,3,545879,514333,31546,5.8
UT,1977,4,545599,516441,29158,5.3
UT,1977,5,547693,518444,29249,5.3
UT,1977,6,549302,520435,28867,5.3
UT,1977,7,550530,522394,28136,5.1
UT,1977,8,552831,524231,28600,5.2
UT,1977,9,554087,526303,27784,5
UT,1977,10,556676,528054,28622,5.1
UT,1977,11,557872,529837,28035,5
UT,1977,12,558057,531602,26455,4.7
UT,1978,1,559437,533414,26023,4.7
UT,1978,2,559995,535368,24627,4.4
UT,1978,3,562449,537589,24860,4.4
UT,1978,4,563098,539866,23232,4.1
UT,1978,5,563979,542184,21795,3.9
UT,1978,6,565284,544609,20675,3.7
UT,1978,7,566395,546984,19411,3.4
UT,1978,8,568713,549488,19225,3.4
UT,1978,9,572991,552007,20984,3.7
UT,1978,10,575969,554707,21262,3.7
UT,1978,11,579482,557352,22130,3.8
UT,1978,12,583949,560100,23849,4.1
UT,1979,1,585854,562840,23014,3.9
UT,1979,2,590354,565612,24742,4.2
UT,1979,3,590491,568188,22303,3.8
UT,1979,4,595939,570427,25512,4.3
UT,1979,5,598018,572528,25490,4.3
UT,1979,6,600789,574460,26329,4.4
UT,1979,7,603159,576331,26828,4.4
UT,1979,8,605836,578072,27764,4.6
UT,1979,9,608355,579527,28828,4.7
UT,1979,10,609541,580765,28776,4.7
UT,1979,11,611897,582075,29822,4.9
UT,1979,12,615903,583204,32699,5.3
UT,1980,1,617995,584218,33777,5.5
UT,1980,2,620840,584948,35892,5.8
UT,1980,3,622013,585843,36170,5.8
UT,1980,4,625369,586760,38609,6.2
UT,1980,5,627809,587719,40090,6.4
UT,1980,6,631018,588508,42510,6.7
UT,1980,7,633237,589500,43737,6.9
UT,1980,8,634140,590558,43582,6.9
UT,1980,9,635830,591884,43946,6.9
UT,1980,10,636792,592973,43819,6.9
UT,1980,11,637678,594225,43453,6.8
UT,1980,12,638737,595706,43031,6.7
UT,1981,1,639897,597375,42522,6.6
UT,1981,2,640865,599039,41826,6.5
UT,1981,3,643692,600708,42984,6.7
UT,1981,4,643390,602214,41176,6.4
UT,1981,5,644541,603578,40963,6.4
UT,1981,6,645630,604831,40799,6.3
UT,1981,7,647377,606186,41191,6.4
UT,1981,8,648551,607489,41062,6.3
UT,1981,9,650719,608742,41977,6.5
UT,1981,10,653534,609854,43680,6.7
UT,1981,11,654661,610923,43738,6.7
UT,1981,12,656564,611800,44764,6.8
UT,1982,1,661201,612560,48641,7.4
UT,1982,2,664748,613106,51642,7.8
UT,1982,3,663425,613987,49438,7.5
UT,1982,4,666020,614769,51251,7.7
UT,1982,5,667036,615451,51585,7.7
UT,1982,6,668897,616123,52774,7.9
UT,1982,7,673991,616897,57094,8.5
UT,1982,8,677083,617735,59348,8.8
UT,1982,9,678485,618441,60044,8.8
UT,1982,10,680382,619236,61146,9
UT,1982,11,684498,620285,64213,9.4
UT,1982,12,686376,621266,65110,9.5
UT,1983,1,688467,622190,66277,9.6
UT,1983,2,689704,623487,66217,9.6
UT,1983,3,692222,624834,67388,9.7
UT,1983,4,693078,626422,66656,9.6
UT,1983,5,693491,628249,65242,9.4
UT,1983,6,693219,630200,63019,9.1
UT,1983,7,692545,632213,60332,8.7
UT,1983,8,693236,634376,58860,8.5
UT,1983,9,693687,636815,56872,8.2
UT,1983,10,695135,639334,55801,8
UT,1983,11,696249,641918,54331,7.8
UT,1983,12,699241,644669,54572,7.8
UT,1984,1,699429,647478,51951,7.4
UT,1984,2,699611,650090,49521,7.1
UT,1984,3,701134,652561,48573,6.9
UT,1984,4,701909,654873,47036,6.7
UT,1984,5,703375,657159,46216,6.6
UT,1984,6,703264,659410,43854,6.2
UT,1984,7,704556,661558,42998,6.1
UT,1984,8,706875,663444,43431,6.1
UT,1984,9,708955,665090,43865,6.2
UT,1984,10,711521,666460,45061,6.3
UT,1984,11,713491,667876,45615,6.4
UT,1984,12,714101,669125,44976,6.3
UT,1985,1,715760,670104,45656,6.4
UT,1985,2,719759,671118,48641,6.8
UT,1985,3,719655,672370,47285,6.6
UT,1985,4,719836,673956,45880,6.4
UT,1985,5,720201,675504,44697,6.2
UT,1985,6,722094,677165,44929,6.2
UT,1985,7,723288,678689,44599,6.2
UT,1985,8,723331,680288,43043,6
UT,1985,9,725022,681983,43039,5.9
UT,1985,10,726508,683796,42712,5.9
UT,1985,11,730010,685701,44309,6.1
UT,1985,12,732123,687529,44594,6.1
UT,1986,1,733826,689379,44447,6.1
UT,1986,2,734532,691189,43343,5.9
UT,1986,3,736079,692897,43182,5.9
UT,1986,4,738463,694604,43859,5.9
UT,1986,5,740213,696021,44192,6
UT,1986,6,741505,697380,44125,6
UT,1986,7,743348,698705,44643,6
UT,1986,8,746669,699815,46854,6.3
UT,1986,9,749017,700858,48159,6.4
UT,1986,10,750124,701835,48289,6.4
UT,1986,11,751445,702683,48762,6.5
UT,1986,12,753451,703485,49966,6.6
UT,1987,1,756307,704306,52001,6.9
UT,1987,2,757344,705203,52141,6.9
UT,1987,3,757387,706126,51261,6.8
UT,1987,4,756452,706934,49518,6.5
UT,1987,5,756196,707880,48316,6.4
UT,1987,6,756831,708817,48014,6.3
UT,1987,7,756824,709879,46945,6.2
UT,1987,8,756753,711117,45636,6
UT,1987,9,756834,712401,44433,5.9
UT,1987,10,757452,713816,43636,5.8
UT,1987,11,757789,715210,42579,5.6
UT,1987,12,758826,716660,42166,5.6
UT,1988,1,760367,718175,42192,5.5
UT,1988,2,760758,719775,40983,5.4
UT,1988,3,760762,721356,39406,5.2
UT,1988,4,761111,722899,38212,5
UT,1988,5,762547,724560,37987,5
UT,1988,6,763177,726458,36719,4.8
UT,1988,7,764884,728228,36656,4.8
UT,1988,8,767286,730055,37231,4.9
UT,1988,9,768589,731956,36633,4.8
UT,1988,10,770315,733920,36395,4.7
UT,1988,11,772134,735844,36290,4.7
UT,1988,12,773921,737802,36119,4.7
UT,1989,1,775593,739775,35818,4.6
UT,1989,2,776912,741786,35126,4.5
UT,1989,3,779597,743880,35717,4.6
UT,1989,4,783142,746124,37018,4.7
UT,1989,5,785471,748476,36995,4.7
UT,1989,6,787278,750940,36338,4.6
UT,1989,7,789895,753448,36447,4.6
UT,1989,8,793303,755951,37352,4.7
UT,1989,9,796635,758634,38001,4.8
UT,1989,10,798791,761271,37520,4.7
UT,1989,11,801237,764010,37227,4.6
UT,1989,12,803410,766871,36539,4.5
UT,1990,1,804792,769848,34944,4.3
UT,1990,2,807761,772601,35160,4.4
UT,1990,3,812425,775334,37091,4.6
UT,1990,4,815808,778034,37774,4.6
UT,1990,5,818227,780739,37488,4.6
UT,1990,6,819865,783288,36577,4.5
UT,1990,7,822083,785830,36253,4.4
UT,1990,8,824156,788296,35860,4.4
UT,1990,9,826528,790552,35976,4.4
UT,1990,10,829268,792682,36586,4.4
UT,1990,11,831258,794706,36552,4.4
UT,1990,12,833065,796689,36376,4.4
UT,1991,1,835690,798504,37186,4.4
UT,1991,2,838123,800553,37570,4.5
UT,1991,3,841039,802623,38416,4.6
UT,1991,4,844365,804763,39602,4.7
UT,1991,5,846040,806835,39205,4.6
UT,1991,6,849939,809032,40907,4.8
UT,1991,7,852343,811481,40862,4.8
UT,1991,8,854927,813959,40968,4.8
UT,1991,9,858106,816445,41661,4.9
UT,1991,10,860146,819024,41122,4.8
UT,1991,11,864853,821768,43085,5
UT,1991,12,867618,824680,42938,4.9
UT,1992,1,871364,827608,43756,5
UT,1992,2,874276,830524,43752,5
UT,1992,3,877601,833574,44027,5
UT,1992,4,880769,836705,44064,5
UT,1992,5,884115,839938,44177,5
UT,1992,6,887914,843242,44672,5
UT,1992,7,890692,846591,44101,5
UT,1992,8,893731,849965,43766,4.9
UT,1992,9,897223,853583,43640,4.9
UT,1992,10,900852,857229,43623,4.8
UT,1992,11,904869,860998,43871,4.8
UT,1992,12,907865,864825,43040,4.7
UT,1993,1,910284,868783,41501,4.6
UT,1993,2,913190,872869,40321,4.4
UT,1993,3,917114,877036,40078,4.4
UT,1993,4,920853,881217,39636,4.3
UT,1993,5,925781,885694,40087,4.3
UT,1993,6,929875,890221,39654,4.3
UT,1993,7,933403,894863,38540,4.1
UT,1993,8,937085,899420,37665,4
UT,1993,9,941865,904143,37722,4
UT,1993,10,946491,908957,37534,4
UT,1993,11,950465,913764,36701,3.9
UT,1993,12,955047,918510,36537,3.8
UT,1994,1,959409,923465,35944,3.7
UT,1994,2,963717,928138,35579,3.7
UT,1994,3,969154,932633,36521,3.8
UT,1994,4,974133,936832,37301,3.8
UT,1994,5,978902,940894,38008,3.9
UT,1994,6,982494,944751,37743,3.8
UT,1994,7,987168,948351,38817,3.9
UT,1994,8,990505,951814,38691,3.9
UT,1994,9,993840,954952,38888,3.9
UT,1994,10,997292,958075,39217,3.9
UT,1994,11,999957,960992,38965,3.9
UT,1994,12,1002610,963768,38842,3.9
UT,1995,1,1003006,966311,36695,3.7
UT,1995,2,1005048,968967,36081,3.6
UT,1995,3,1005217,971504,33713,3.4
UT,1995,4,1009850,973863,35987,3.6
UT,1995,5,1013038,976258,36780,3.6
UT,1995,6,1015184,978689,36495,3.6
UT,1995,7,1016930,981054,35876,3.5
UT,1995,8,1018943,983225,35718,3.5
UT,1995,9,1020920,985227,35693,3.5
UT,1995,10,1022736,987169,35567,3.5
UT,1995,11,1023943,989128,34815,3.4
UT,1995,12,1024694,991012,33682,3.3
UT,1996,1,1025842,992838,33004,3.2
UT,1996,2,1029373,994644,34729,3.4
UT,1996,3,1032486,996484,36002,3.5
UT,1996,4,1034359,998522,35837,3.5
UT,1996,5,1037660,1000607,37053,3.6
UT,1996,6,1040324,1002755,37569,3.6
UT,1996,7,1041787,1004939,36848,3.5
UT,1996,8,1044140,1007293,36847,3.5
UT,1996,9,1046845,1009640,37205,3.6
UT,1996,10,1049305,1012175,37130,3.5
UT,1996,11,1051393,1014797,36596,3.5
UT,1996,12,1052405,1017472,34933,3.3
UT,1997,1,1054883,1020178,34705,3.3
UT,1997,2,1055819,1022889,32930,3.1
UT,1997,3,1057125,1025687,31438,3
UT,1997,4,1060624,1028301,32323,3
UT,1997,5,1063939,1030853,33086,3.1
UT,1997,6,1067119,1033394,33725,3.2
UT,1997,7,1069227,1035915,33312,3.1
UT,1997,8,1072713,1038406,34307,3.2
UT,1997,9,1075633,1040870,34763,3.2
UT,1997,10,1078568,1043237,35331,3.3
UT,1997,11,1080410,1045540,34870,3.2
UT,1997,12,1083288,1047878,35410,3.3
UT,1998,1,1086112,1050188,35924,3.3
UT,1998,2,1088827,1052381,36446,3.3
UT,1998,3,1093459,1054419,39040,3.6
UT,1998,4,1096649,1056537,40112,3.7
UT,1998,5,1098766,1058613,40153,3.7
UT,1998,6,1102084,1060653,41431,3.8
UT,1998,7,1106307,1062565,43742,4
UT,1998,8,1107773,1064492,43281,3.9
UT,1998,9,1108816,1066287,42529,3.8
UT,1998,10,1110412,1068124,42288,3.8
UT,1998,11,1111358,1069766,41592,3.7
UT,1998,12,1113106,1071357,41749,3.8
UT,1999,1,1113611,1072841,40770,3.7
UT,1999,2,1114140,1074355,39785,3.6
UT,1999,3,1116731,1075782,40949,3.7
UT,1999,4,1117718,1077155,40563,3.6
UT,1999,5,1120328,1078481,41847,3.7
UT,1999,6,1122322,1079825,42497,3.8
UT,1999,7,1123489,1081048,42441,3.8
UT,1999,8,1124203,1082353,41850,3.7
UT,1999,9,1124487,1083698,40789,3.6
UT,1999,10,1124071,1085176,38895,3.5
UT,1999,11,1122622,1086608,36014,3.2
UT,1999,12,1123375,1087973,35402,3.2
UT,2000,1,1126176,1090967,35209,3.1
UT,2000,2,1127582,1092323,35259,3.1
UT,2000,3,1128443,1093722,34721,3.1
UT,2000,4,1130374,1095042,35332,3.1
UT,2000,5,1133114,1096290,36824,3.2
UT,2000,6,1135710,1097568,38142,3.4
UT,2000,7,1137825,1098766,39059,3.4
UT,2000,8,1139926,1099904,40022,3.5
UT,2000,9,1140925,1101020,39905,3.5
UT,2000,10,1142583,1102115,40468,3.5
UT,2000,11,1144661,1103159,41502,3.6
UT,2000,12,1145109,1104104,41005,3.6
UT,2001,1,1146991,1105013,41978,3.7
UT,2001,2,1149638,1105910,43728,3.8
UT,2001,3,1153536,1106618,46918,4.1
UT,2001,4,1154581,1107237,47344,4.1
UT,2001,5,1156837,1107871,48966,4.2
UT,2001,6,1158602,1108538,50064,4.3
UT,2001,7,1160768,1109117,51651,4.4
UT,2001,8,1162011,1109526,52485,4.5
UT,2001,9,1163051,1110053,52998,4.6
UT,2001,10,1165309,1110559,54750,4.7
UT,2001,11,1168412,1110955,57457,4.9
UT,2001,12,1173462,1111165,62297,5.3
UT,2002,1,1173858,1110298,63560,5.4
UT,2002,2,1177713,1110691,67022,5.7
UT,2002,3,1177877,1111081,66796,5.7
UT,2002,4,1179083,1111465,67618,5.7
UT,2002,5,1179905,1111962,67943,5.8
UT,2002,6,1180504,1112571,67933,5.8
UT,2002,7,1182781,1113330,69451,5.9
UT,2002,8,1183649,1114215,69434,5.9
UT,2002,9,1184610,1115125,69485,5.9
UT,2002,10,1185544,1116330,69214,5.8
UT,2002,11,1187099,1117600,69499,5.9
UT,2002,12,1187674,1119075,68599,5.8
UT,2003,1,1197982,1127028,70954,5.9
UT,2003,2,1199718,1128861,70857,5.9
UT,2003,3,1201844,1130797,71047,5.9
UT,2003,4,1202855,1132850,70005,5.8
UT,2003,5,1204240,1135018,69222,5.7
UT,2003,6,1206438,1137295,69143,5.7
UT,2003,7,1208128,1139687,68441,5.7
UT,2003,8,1209876,1142192,67684,5.6
UT,2003,9,1211226,1144799,66427,5.5
UT,2003,10,1212859,1147507,65352,5.4
UT,2003,11,1215928,1150308,65620,5.4
UT,2003,12,1218142,1153211,64931,5.3
UT,2004,1,1226561,1160453,66108,5.4
UT,2004,2,1228897,1163593,65304,5.3
UT,2004,3,1231828,1166817,65011,5.3
UT,2004,4,1233499,1170122,63377,5.1
UT,2004,5,1236974,1173500,63474,5.1
UT,2004,6,1240836,1176948,63888,5.1
UT,2004,7,1243972,1180467,63505,5.1
UT,2004,8,1247203,1184059,63144,5.1
UT,2004,9,1249262,1187736,61526,4.9
UT,2004,10,1252517,1191493,61024,4.9
UT,2004,11,1255138,1195315,59823,4.8
UT,2004,12,1257352,1199197,58155,4.6
UT,2005,1,1259649,1203143,56506,4.5
UT,2005,2,1262404,1207189,55215,4.4
UT,2005,3,1265748,1211325,54423,4.3
UT,2005,4,1270378,1215550,54828,4.3
UT,2005,5,1274475,1219857,54618,4.3
UT,2005,6,1277706,1224247,53459,4.2
UT,2005,7,1280478,1228725,51753,4
UT,2005,8,1283825,1233272,50553,3.9
UT,2005,9,1292430,1237880,54550,4.2
UT,2005,10,1295502,1242546,52956,4.1
UT,2005,11,1297348,1247272,50076,3.9
UT,2005,12,1300519,1252059,48460,3.7
UT,2006,1,1302505,1256897,45608,3.5
UT,2006,2,1304799,1261655,43144,3.3
UT,2006,3,1308297,1266320,41977,3.2
UT,2006,4,1312238,1270881,41357,3.2
UT,2006,5,1316492,1275334,41158,3.1
UT,2006,6,1319060,1279672,39388,3
UT,2006,7,1323546,1283877,39669,3
UT,2006,8,1326884,1287949,38935,2.9
UT,2006,9,1328571,1291883,36688,2.8
UT,2006,10,1331758,1295679,36079,2.7
UT,2006,11,1334703,1299343,35360,2.6
UT,2006,12,1337199,1302857,34342,2.6
UT,2007,1,1340034,1306210,33824,2.5
UT,2007,2,1341873,1309364,32509,2.4
UT,2007,3,1345157,1312319,32838,2.4
UT,2007,4,1349329,1315065,34264,2.5
UT,2007,5,1352684,1317604,35080,2.6
UT,2007,6,1356543,1319933,36610,2.7
UT,2007,7,1359312,1322049,37263,2.7
UT,2007,8,1362308,1323960,38348,2.8
UT,2007,9,1365195,1325667,39528,2.9
UT,2007,10,1367133,1327174,39959,2.9
UT,2007,11,1368430,1328479,39951,2.9
UT,2007,12,1370597,1329578,41019,3
UT,2008,1,1373836,1330475,43361,3.2
UT,2008,2,1376386,1331382,45004,3.3
UT,2008,3,1378140,1332309,45831,3.3
UT,2008,4,1378929,1333267,45662,3.3
UT,2008,5,1379661,1334263,45398,3.3
UT,2008,6,1381334,1335301,46033,3.3
UT,2008,7,1383701,1336398,47303,3.4
UT,2008,8,1385130,1337553,47577,3.4
UT,2008,9,1385423,1338766,46657,3.4
UT,2008,10,1388331,1340035,48296,3.5
UT,2008,11,1393949,1341362,52587,3.8
UT,2008,12,1400090,1342758,57332,4.1
UT,2009,1,1390959,1326635,64324,4.6
VT,1976,1,215448,196305,19143,8.9
VT,1976,2,215410,196938,18472,8.6
VT,1976,3,215759,197120,18639,8.6
VT,1976,4,215818,197631,18187,8.4
VT,1976,5,217108,198524,18584,8.6
VT,1976,6,219177,199471,19706,9
VT,1976,7,219775,201197,18578,8.5
VT,1976,8,220095,201442,18653,8.5
VT,1976,9,219998,201314,18684,8.5
VT,1976,10,219846,201631,18215,8.3
VT,1976,11,220386,202372,18014,8.2
VT,1976,12,220462,203010,17452,7.9
VT,1977,1,222155,204939,17216,7.7
VT,1977,2,222827,205935,16892,7.6
VT,1977,3,223626,207101,16525,7.4
VT,1977,4,224520,208668,15852,7.1
VT,1977,5,226260,210141,16119,7.1
VT,1977,6,228018,211743,16275,7.1
VT,1977,7,228546,212809,15737,6.9
VT,1977,8,230335,214421,15914,6.9
VT,1977,9,232583,215926,16657,7.2
VT,1977,10,233459,217017,16442,7
VT,1977,11,233720,217821,15899,6.8
VT,1977,12,234455,218738,15717,6.7
VT,1978,1,233907,219414,14493,6.2
VT,1978,2,234459,220741,13718,5.9
VT,1978,3,235219,222289,12930,5.5
VT,1978,4,236328,223893,12435,5.3
VT,1978,5,237525,224830,12695,5.3
VT,1978,6,238784,225773,13011,5.4
VT,1978,7,240300,227033,13267,5.5
VT,1978,8,240948,227490,13458,5.6
VT,1978,9,241023,227832,13191,5.5
VT,1978,10,241185,227870,13315,5.5
VT,1978,11,242017,228834,13183,5.4
VT,1978,12,243221,230031,13190,5.4
VT,1979,1,242888,230261,12627,5.2
VT,1979,2,242994,230975,12019,4.9
VT,1979,3,243515,232268,11247,4.6
VT,1979,4,243241,231577,11664,4.8
VT,1979,5,243860,232506,11354,4.7
VT,1979,6,244503,233407,11096,4.5
VT,1979,7,244807,232678,12129,5
VT,1979,8,245649,232718,12931,5.3
VT,1979,9,245434,232865,12569,5.1
VT,1979,10,246054,233750,12304,5
VT,1979,11,246428,233859,12569,5.1
VT,1979,12,246559,234038,12521,5.1
VT,1980,1,246091,233901,12190,5
VT,1980,2,246404,233923,12481,5.1
VT,1980,3,246512,233692,12820,5.2
VT,1980,4,247807,233816,13991,5.6
VT,1980,5,248259,232925,15334,6.2
VT,1980,6,248362,231904,16458,6.6
VT,1980,7,251540,232774,18766,7.5
VT,1980,8,252142,233649,18493,7.3
VT,1980,9,251651,234033,17618,7
VT,1980,10,252191,234863,17328,6.9
VT,1980,11,252829,236193,16636,6.6
VT,1980,12,252257,237051,15206,6
VT,1981,1,253347,239252,14095,5.6
VT,1981,2,253720,239627,14093,5.6
VT,1981,3,253732,239983,13749,5.4
VT,1981,4,255013,241303,13710,5.4
VT,1981,5,255825,241537,14288,5.6
VT,1981,6,257542,242992,14550,5.6
VT,1981,7,259454,244246,15208,5.9
VT,1981,8,259442,244149,15293,5.9
VT,1981,9,258880,243559,15321,5.9
VT,1981,10,259811,244321,15490,6
VT,1981,11,260093,244203,15890,6.1
VT,1981,12,260689,244560,16129,6.2
VT,1982,1,260296,243477,16819,6.5
VT,1982,2,260786,243343,17443,6.7
VT,1982,3,261453,243572,17881,6.8
VT,1982,4,263462,243201,20261,7.7
VT,1982,5,263825,244552,19273,7.3
VT,1982,6,263157,244283,18874,7.2
VT,1982,7,264399,244212,20187,7.6
VT,1982,8,264477,244497,19980,7.6
VT,1982,9,264358,245328,19030,7.2
VT,1982,10,263544,244195,19349,7.3
VT,1982,11,263697,243879,19818,7.5
VT,1982,12,263039,243523,19516,7.4
VT,1983,1,263646,243327,20319,7.7
VT,1983,2,264401,243995,20406,7.7
VT,1983,3,264561,245013,19548,7.4
VT,1983,4,265233,245931,19302,7.3
VT,1983,5,265555,245875,19680,7.4
VT,1983,6,264304,246493,17811,6.7
VT,1983,7,264892,247608,17284,6.5
VT,1983,8,265348,248363,16985,6.4
VT,1983,9,265903,249864,16039,6
VT,1983,10,266563,250631,15932,6
VT,1983,11,266864,251430,15434,5.8
VT,1983,12,267814,252245,15569,5.8
VT,1984,1,268812,253504,15308,5.7
VT,1984,2,270088,254954,15134,5.6
VT,1984,3,271503,256358,15145,5.6
VT,1984,4,271198,256823,14375,5.3
VT,1984,5,271204,257071,14133,5.2
VT,1984,6,270705,257478,13227,4.9
VT,1984,7,269436,257225,12211,4.5
VT,1984,8,270191,258307,11884,4.4
VT,1984,9,272153,259913,12240,4.5
VT,1984,10,273904,261530,12374,4.5
VT,1984,11,274433,262172,12261,4.5
VT,1984,12,274968,262268,12700,4.6
VT,1985,1,275719,262899,12820,4.6
VT,1985,2,277284,263745,13539,4.9
VT,1985,3,277391,263803,13588,4.9
VT,1985,4,278332,264849,13483,4.8
VT,1985,5,279142,265903,13239,4.7
VT,1985,6,279732,265951,13781,4.9
VT,1985,7,280306,266885,13421,4.8
VT,1985,8,281397,267854,13543,4.8
VT,1985,9,282529,268840,13689,4.8
VT,1985,10,282927,269450,13477,4.8
VT,1985,11,283556,270312,13244,4.7
VT,1985,12,283838,270939,12899,4.5
VT,1986,1,284733,271773,12960,4.6
VT,1986,2,285046,272378,12668,4.4
VT,1986,3,286193,273203,12990,4.5
VT,1986,4,286580,273808,12772,4.5
VT,1986,5,286987,274351,12636,4.4
VT,1986,6,288413,275606,12807,4.4
VT,1986,7,288553,276370,12183,4.2
VT,1986,8,289708,277274,12434,4.3
VT,1986,9,290434,277168,13266,4.6
VT,1986,10,290928,277787,13141,4.5
VT,1986,11,291366,278453,12913,4.4
VT,1986,12,291630,279232,12398,4.3
VT,1987,1,291717,279868,11849,4.1
VT,1987,2,291397,280024,11373,3.9
VT,1987,3,292127,280614,11513,3.9
VT,1987,4,292347,281612,10735,3.7
VT,1987,5,293956,282594,11362,3.9
VT,1987,6,294474,283073,11401,3.9
VT,1987,7,295568,284695,10873,3.7
VT,1987,8,296171,285086,11085,3.7
VT,1987,9,296311,284641,11670,3.9
VT,1987,10,296604,285386,11218,3.8
VT,1987,11,296228,286130,10098,3.4
VT,1987,12,296280,286714,9566,3.2
VT,1988,1,296178,287052,9126,3.1
VT,1988,2,295786,286796,8990,3
VT,1988,3,295871,287187,8684,2.9
VT,1988,4,295971,288171,7800,2.6
VT,1988,5,297008,288870,8138,2.7
VT,1988,6,298316,289916,8400,2.8
VT,1988,7,298564,290160,8404,2.8
VT,1988,8,298544,289921,8623,2.9
VT,1988,9,299459,289891,9568,3.2
VT,1988,10,299218,289346,9872,3.3
VT,1988,11,299199,289809,9390,3.1
VT,1988,12,300335,291188,9147,3
VT,1989,1,301689,292360,9329,3.1
VT,1989,2,303027,293535,9492,3.1
VT,1989,3,303797,293709,10088,3.3
VT,1989,4,303513,292907,10606,3.5
VT,1989,5,304519,293979,10540,3.5
VT,1989,6,305712,294783,10929,3.6
VT,1989,7,304994,294193,10801,3.5
VT,1989,8,304627,293019,11608,3.8
VT,1989,9,304511,292800,11711,3.8
VT,1989,10,304516,292727,11789,3.9
VT,1989,11,305248,293684,11564,3.8
VT,1989,12,307663,295443,12220,4
VT,1990,1,308205,295474,12731,4.1
VT,1990,2,308447,294905,13542,4.4
VT,1990,3,309361,294875,14486,4.7
VT,1990,4,309916,295371,14545,4.7
VT,1990,5,311064,295879,15185,4.9
VT,1990,6,309961,295296,14665,4.7
VT,1990,7,308896,294248,14648,4.7
VT,1990,8,309207,294379,14828,4.8
VT,1990,9,308904,293836,15068,4.9
VT,1990,10,308449,292870,15579,5.1
VT,1990,11,309448,291443,18005,5.8
VT,1990,12,309502,290313,19189,6.2
VT,1991,1,309377,289416,19961,6.5
VT,1991,2,308659,287277,21382,6.9
VT,1991,3,308458,286858,21600,7
VT,1991,4,310446,286689,23757,7.7
VT,1991,5,308713,286635,22078,7.2
VT,1991,6,308761,286811,21950,7.1
VT,1991,7,308619,288052,20567,6.7
VT,1991,8,307159,289011,18148,5.9
VT,1991,9,307455,289508,17947,5.8
VT,1991,10,307765,289960,17805,5.8
VT,1991,11,308674,289913,18761,6.1
VT,1991,12,309541,289225,20316,6.6
VT,1992,1,309636,288580,21056,6.8
VT,1992,2,311184,290215,20969,6.7
VT,1992,3,311937,290407,21530,6.9
VT,1992,4,312593,290627,21966,7
VT,1992,5,312013,290471,21542,6.9
VT,1992,6,311079,290755,20324,6.5
VT,1992,7,311717,292126,19591,6.3
VT,1992,8,312363,293136,19227,6.2
VT,1992,9,313624,294688,18936,6
VT,1992,10,314559,295549,19010,6
VT,1992,11,314596,295651,18945,6
VT,1992,12,313748,295245,18503,5.9
VT,1993,1,314751,296238,18513,5.9
VT,1993,2,314730,296502,18228,5.8
VT,1993,3,314013,295921,18092,5.8
VT,1993,4,315086,297020,18066,5.7
VT,1993,5,314684,297361,17323,5.5
VT,1993,6,315153,298502,16651,5.3
VT,1993,7,314396,298385,16011,5.1
VT,1993,8,314617,299248,15369,4.9
VT,1993,9,315099,299853,15246,4.8
VT,1993,10,315642,300331,15311,4.9
VT,1993,11,315369,300249,15120,4.8
VT,1993,12,315027,299707,15320,4.9
VT,1994,1,315084,299687,15397,4.9
VT,1994,2,315540,300492,15048,4.8
VT,1994,3,316278,301422,14856,4.7
VT,1994,4,315936,301011,14925,4.7
VT,1994,5,316590,301480,15110,4.8
VT,1994,6,316168,301894,14274,4.5
VT,1994,7,315596,301573,14023,4.4
VT,1994,8,315963,301788,14175,4.5
VT,1994,9,316222,302275,13947,4.4
VT,1994,10,316635,302741,13894,4.4
VT,1994,11,316757,303333,13424,4.2
VT,1994,12,317937,304338,13599,4.3
VT,1995,1,318110,304581,13529,4.3
VT,1995,2,318411,304586,13825,4.3
VT,1995,3,318719,305197,13522,4.2
VT,1995,4,318273,304876,13397,4.2
VT,1995,5,317769,304142,13627,4.3
VT,1995,6,317410,303911,13499,4.3
VT,1995,7,318662,304822,13840,4.3
VT,1995,8,318987,305206,13781,4.3
VT,1995,9,319709,305993,13716,4.3
VT,1995,10,320233,306487,13746,4.3
VT,1995,11,320987,306694,14293,4.5
VT,1995,12,320556,306846,13710,4.3
VT,1996,1,322430,308325,14105,4.4
VT,1996,2,322152,308222,13930,4.3
VT,1996,3,322587,308587,14000,4.3
VT,1996,4,323249,308971,14278,4.4
VT,1996,5,323745,309588,14157,4.4
VT,1996,6,323483,309242,14241,4.4
VT,1996,7,322699,308354,14345,4.4
VT,1996,8,323996,309542,14454,4.5
VT,1996,9,324811,310453,14358,4.4
VT,1996,10,325229,310762,14467,4.4
VT,1996,11,326321,311642,14679,4.5
VT,1996,12,326390,312150,14240,4.4
VT,1997,1,325965,311959,14006,4.3
VT,1997,2,326766,312926,13840,4.2
VT,1997,3,326676,312994,13682,4.2
VT,1997,4,327340,313614,13726,4.2
VT,1997,5,327854,314570,13284,4.1
VT,1997,6,328269,315340,12929,3.9
VT,1997,7,329179,316456,12723,3.9
VT,1997,8,329600,316916,12684,3.8
VT,1997,9,329786,317387,12399,3.8
VT,1997,10,331394,318918,12476,3.8
VT,1997,11,331284,319070,12214,3.7
VT,1997,12,331719,319518,12201,3.7
VT,1998,1,330573,319073,11500,3.5
VT,1998,2,331076,320087,10989,3.3
VT,1998,3,331743,320916,10827,3.3
VT,1998,4,331770,321618,10152,3.1
VT,1998,5,331904,321489,10415,3.1
VT,1998,6,331822,321411,10411,3.1
VT,1998,7,331685,321773,9912,3
VT,1998,8,331833,322318,9515,2.9
VT,1998,9,332306,322647,9659,2.9
VT,1998,10,332209,322063,10146,3.1
VT,1998,11,332314,322567,9747,2.9
VT,1998,12,333068,323335,9733,2.9
VT,1999,1,334352,324300,10052,3
VT,1999,2,335456,325253,10203,3
VT,1999,3,335778,325446,10332,3.1
VT,1999,4,335015,326135,8880,2.7
VT,1999,5,335306,325725,9581,2.9
VT,1999,6,335340,325030,10310,3.1
VT,1999,7,336432,325799,10633,3.2
VT,1999,8,335677,325343,10334,3.1
VT,1999,9,334978,324959,10019,3
VT,1999,10,335840,325885,9955,3
VT,1999,11,335765,326836,8929,2.7
VT,1999,12,335035,326256,8779,2.6
VT,2000,1,334367,325962,8405,2.5
VT,2000,2,334773,326500,8273,2.5
VT,2000,3,335191,327738,7453,2.2
VT,2000,4,335105,327198,7907,2.4
VT,2000,5,335146,326524,8622,2.6
VT,2000,6,335483,326324,9159,2.7
VT,2000,7,335217,325607,9610,2.9
VT,2000,8,335652,325693,9959,3
VT,2000,9,336464,326374,10090,3
VT,2000,10,336781,326787,9994,3
VT,2000,11,337072,327162,9910,2.9
VT,2000,12,338322,329030,9292,2.7
VT,2001,1,339472,330048,9424,2.8
VT,2001,2,339410,329590,9820,2.9
VT,2001,3,338975,328763,10212,3
VT,2001,4,339421,328976,10445,3.1
VT,2001,5,339860,329349,10511,3.1
VT,2001,6,340925,329977,10948,3.2
VT,2001,7,341605,330280,11325,3.3
VT,2001,8,342210,330458,11752,3.4
VT,2001,9,342377,330695,11682,3.4
VT,2001,10,342905,330813,12092,3.5
VT,2001,11,343942,331230,12712,3.7
VT,2001,12,343709,331008,12701,3.7
VT,2002,1,342757,330035,12722,3.7
VT,2002,2,343349,330420,12929,3.8
VT,2002,3,344367,330972,13395,3.9
VT,2002,4,344825,331764,13061,3.8
VT,2002,5,345001,331941,13060,3.8
VT,2002,6,345757,332483,13274,3.8
VT,2002,7,345774,331965,13809,4
VT,2002,8,346420,332009,14411,4.2
VT,2002,9,346471,332161,14310,4.1
VT,2002,10,346939,332409,14530,4.2
VT,2002,11,347673,332326,15347,4.4
VT,2002,12,348231,332666,15565,4.5
VT,2003,1,346531,330592,15939,4.6
VT,2003,2,346645,330546,16099,4.6
VT,2003,3,346162,330021,16141,4.7
VT,2003,4,345797,329611,16186,4.7
VT,2003,5,345643,330409,15234,4.4
VT,2003,6,346319,331159,15160,4.4
VT,2003,7,346573,331223,15350,4.4
VT,2003,8,346611,331583,15028,4.3
VT,2003,9,347646,331664,15982,4.6
VT,2003,10,347241,332447,14794,4.3
VT,2003,11,347787,332867,14920,4.3
VT,2003,12,348286,333386,14900,4.3
VT,2004,1,347274,332617,14657,4.2
VT,2004,2,347135,333107,14028,4
VT,2004,3,347216,333602,13614,3.9
VT,2004,4,347126,333997,13129,3.8
VT,2004,5,347072,334359,12713,3.7
VT,2004,6,346931,334484,12447,3.6
VT,2004,7,347370,335006,12364,3.6
VT,2004,8,347342,334808,12534,3.6
VT,2004,9,347150,334886,12264,3.5
VT,2004,10,346792,334697,12095,3.5
VT,2004,11,346862,334609,12253,3.5
VT,2004,12,346541,334081,12460,3.6
VT,2005,1,347139,334835,12304,3.5
VT,2005,2,347282,334867,12415,3.6
VT,2005,3,347255,335101,12154,3.5
VT,2005,4,347524,335858,11666,3.4
VT,2005,5,347423,335954,11469,3.3
VT,2005,6,347873,335818,12055,3.5
VT,2005,7,348971,336721,12250,3.5
VT,2005,8,349747,337364,12383,3.5
VT,2005,9,350283,337900,12383,3.5
VT,2005,10,351064,338002,13062,3.7
VT,2005,11,351422,339154,12268,3.5
VT,2005,12,353141,340617,12524,3.5
VT,2006,1,354280,341345,12935,3.7
VT,2006,2,354797,341700,13097,3.7
VT,2006,3,354745,341782,12963,3.7
VT,2006,4,353933,341779,12154,3.4
VT,2006,5,354562,342119,12443,3.5
VT,2006,6,355786,342530,13256,3.7
VT,2006,7,355501,341968,13533,3.8
VT,2006,8,356099,342287,13812,3.9
VT,2006,9,356361,342564,13797,3.9
VT,2006,10,356798,343030,13768,3.9
VT,2006,11,356490,342785,13705,3.8
VT,2006,12,356201,342558,13643,3.8
VT,2007,1,355845,341718,14127,4
VT,2007,2,355670,341402,14268,4
VT,2007,3,355452,341212,14240,4
VT,2007,4,354433,340048,14385,4.1
VT,2007,5,354024,340333,13691,3.9
VT,2007,6,354362,340708,13654,3.9
VT,2007,7,353760,339993,13767,3.9
VT,2007,8,352801,338974,13827,3.9
VT,2007,9,352421,338332,14089,4
VT,2007,10,352450,338145,14305,4.1
VT,2007,11,352870,338878,13992,4
VT,2007,12,353812,339598,14214,4
VT,2008,1,354635,339391,15244,4.3
VT,2008,2,354704,339137,15567,4.4
VT,2008,3,354721,338555,16166,4.6
VT,2008,4,355332,338913,16419,4.6
VT,2008,5,354952,338951,16001,4.5
VT,2008,6,354384,338520,15864,4.5
VT,2008,7,354799,338584,16215,4.6
VT,2008,8,355325,338721,16604,4.7
VT,2008,9,356354,339128,17226,4.8
VT,2008,10,356800,339176,17624,4.9
VT,2008,11,356472,337460,19012,5.3
VT,2008,12,356705,335662,21043,5.9
VT,2009,1,357236,333023,24213,6.8
VA,1976,1,2326560,2182425,144135,6.2
VA,1976,2,2325253,2188532,136721,5.9
VA,1976,3,2331730,2190378,141352,6.1
VA,1976,4,2332268,2193475,138793,6
VA,1976,5,2333160,2197383,135777,5.8
VA,1976,6,2334810,2201291,133519,5.7
VA,1976,7,2339404,2207478,131926,5.6
VA,1976,8,2350221,2212181,138040,5.9
VA,1976,9,2355657,2215941,139716,5.9
VA,1976,10,2353822,2219777,134045,5.7
VA,1976,11,2358011,2223886,134125,5.7
VA,1976,12,2367412,2230577,136835,5.8
VA,1977,1,2373001,2235689,137312,5.8
VA,1977,2,2396103,2241308,154795,6.5
VA,1977,3,2393283,2248585,144698,6
VA,1977,4,2388572,2252195,136377,5.7
VA,1977,5,2388099,2257075,131024,5.5
VA,1977,6,2392985,2264818,128167,5.4
VA,1977,7,2404913,2274345,130568,5.4
VA,1977,8,2401345,2280862,120483,5
VA,1977,9,2411174,2287613,123561,5.1
VA,1977,10,2417085,2291778,125307,5.2
VA,1977,11,2424484,2296172,128312,5.3
VA,1977,12,2431065,2299564,131501,5.4
VA,1978,1,2438938,2306573,132365,5.4
VA,1978,2,2449848,2314595,135253,5.5
VA,1978,3,2456277,2321672,134605,5.5
VA,1978,4,2463894,2334218,129676,5.3
VA,1978,5,2471336,2343226,128110,5.2
VA,1978,6,2479400,2353082,126318,5.1
VA,1978,7,2479264,2356735,122529,4.9
VA,1978,8,2489795,2361297,128498,5.2
VA,1978,9,2493485,2363293,130192,5.2
VA,1978,10,2493504,2369817,123687,5
VA,1978,11,2500700,2376056,124644,5
VA,1978,12,2506596,2382261,124335,5
VA,1979,1,2511583,2388090,123493,4.9
VA,1979,2,2511644,2386853,124791,5
VA,1979,3,2514906,2394959,119947,4.8
VA,1979,4,2518812,2399752,119060,4.7
VA,1979,5,2523317,2404453,118864,4.7
VA,1979,6,2526772,2407998,118774,4.7
VA,1979,7,2528670,2414457,114213,4.5
VA,1979,8,2534593,2417687,116906,4.6
VA,1979,9,2536665,2420434,116231,4.6
VA,1979,10,2542366,2423872,118494,4.7
VA,1979,11,2546672,2427060,119612,4.7
VA,1979,12,2547936,2427816,120120,4.7
VA,1980,1,2549388,2429896,119492,4.7
VA,1980,2,2549688,2431923,117765,4.6
VA,1980,3,2551443,2432164,119279,4.7
VA,1980,4,2564115,2435889,128226,5
VA,1980,5,2569256,2437148,132108,5.1
VA,1980,6,2579653,2436914,142739,5.5
VA,1980,7,2586070,2438593,147477,5.7
VA,1980,8,2587850,2445873,141977,5.5
VA,1980,9,2591283,2451589,139694,5.4
VA,1980,10,2592091,2456080,136011,5.2
VA,1980,11,2596100,2460312,135788,5.2
VA,1980,12,2603257,2467068,136189,5.2
VA,1981,1,2611399,2469567,141832,5.4
VA,1981,2,2621473,2476167,145306,5.5
VA,1981,3,2625639,2481433,144206,5.5
VA,1981,4,2629125,2480733,148392,5.6
VA,1981,5,2634741,2485484,149257,5.7
VA,1981,6,2642104,2490441,151663,5.7
VA,1981,7,2645463,2496875,148588,5.6
VA,1981,8,2655453,2501110,154343,5.8
VA,1981,9,2655538,2500244,155294,5.8
VA,1981,10,2663653,2502000,161653,6.1
VA,1981,11,2615795,2448335,167460,6.4
VA,1981,12,2628778,2451858,176920,6.7
VA,1982,1,2642149,2453274,188875,7.1
VA,1982,2,2652313,2458332,193981,7.3
VA,1982,3,2654141,2459798,194343,7.3
VA,1982,4,2654524,2466093,188431,7.1
VA,1982,5,2656818,2466949,189869,7.1
VA,1982,6,2662800,2467549,195251,7.3
VA,1982,7,2662540,2467023,195517,7.3
VA,1982,8,2667852,2470248,197604,7.4
VA,1982,9,2668289,2470827,197462,7.4
VA,1982,10,2675732,2472724,203008,7.6
VA,1982,11,2678938,2475010,203928,7.6
VA,1982,12,2686988,2476164,210824,7.8
VA,1983,1,2694142,2483886,210256,7.8
VA,1983,2,2689750,2485505,204245,7.6
VA,1983,3,2741760,2543559,198201,7.2
VA,1983,4,2736053,2549748,186305,6.8
VA,1983,5,2731611,2555906,175705,6.4
VA,1983,6,2734392,2565755,168637,6.2
VA,1983,7,2739624,2576474,163150,6
VA,1983,8,2741775,2578289,163486,6
VA,1983,9,2748771,2590565,158206,5.8
VA,1983,10,2747731,2594421,153310,5.6
VA,1983,11,2751117,2602326,148791,5.4
VA,1983,12,2756232,2612380,143852,5.2
VA,1984,1,2766278,2623340,142938,5.2
VA,1984,2,2778333,2635685,142648,5.1
VA,1984,3,2783613,2644470,139143,5
VA,1984,4,2791183,2649999,141184,5.1
VA,1984,5,2800262,2658679,141583,5.1
VA,1984,6,2805434,2667100,138334,4.9
VA,1984,7,2811236,2672605,138631,4.9
VA,1984,8,2820342,2683787,136555,4.8
VA,1984,9,2830575,2689929,140646,5
VA,1984,10,2839424,2694679,144745,5.1
VA,1984,11,2848548,2697618,150930,5.3
VA,1984,12,2850455,2700489,149966,5.3
VA,1985,1,2848277,2702270,146007,5.1
VA,1985,2,2854117,2702481,151636,5.3
VA,1985,3,2859282,2706096,153186,5.4
VA,1985,4,2862658,2709966,152692,5.3
VA,1985,5,2869015,2714826,154189,5.4
VA,1985,6,2871201,2718142,153059,5.3
VA,1985,7,2883583,2720043,163540,5.7
VA,1985,8,2877283,2722568,154715,5.4
VA,1985,9,2884204,2729488,154716,5.4
VA,1985,10,2892819,2738628,154191,5.3
VA,1985,11,2901851,2744240,157611,5.4
VA,1985,12,2903831,2751286,152545,5.3
VA,1986,1,2900464,2755393,145071,5
VA,1986,2,2902661,2761190,141471,4.9
VA,1986,3,2911110,2766641,144469,5
VA,1986,4,2920176,2774542,145634,5
VA,1986,5,2925262,2782064,143198,4.9
VA,1986,6,2930518,2786512,144006,4.9
VA,1986,7,2934551,2792397,142154,4.8
VA,1986,8,2941581,2799363,142218,4.8
VA,1986,9,2952514,2806668,145846,4.9
VA,1986,10,2963268,2817586,145682,4.9
VA,1986,11,2967554,2824003,143551,4.8
VA,1986,12,2970428,2829028,141400,4.8
VA,1987,1,2971970,2839457,132513,4.5
VA,1987,2,2975022,2843599,131423,4.4
VA,1987,3,2985682,2851782,133900,4.5
VA,1987,4,2993325,2859140,134185,4.5
VA,1987,5,2996007,2864359,131648,4.4
VA,1987,6,2995428,2870270,125158,4.2
VA,1987,7,2998025,2878949,119076,4
VA,1987,8,3007267,2884321,122946,4.1
VA,1987,9,3012006,2888757,123249,4.1
VA,1987,10,3014820,2893690,121130,4
VA,1987,11,3019114,2900841,118273,3.9
VA,1987,12,3026098,2908606,117492,3.9
VA,1988,1,3031237,2911686,119551,3.9
VA,1988,2,3037803,2920702,117101,3.9
VA,1988,3,3043317,2927676,115641,3.8
VA,1988,4,3049270,2931184,118086,3.9
VA,1988,5,3054890,2935766,119124,3.9
VA,1988,6,3064450,2942645,121805,4
VA,1988,7,3073325,2947662,125663,4.1
VA,1988,8,3080402,2954010,126392,4.1
VA,1988,9,3086224,2958659,127565,4.1
VA,1988,10,3088659,2962328,126331,4.1
VA,1988,11,3092093,2968188,123905,4
VA,1988,12,3095603,2975106,120497,3.9
VA,1989,1,3101227,2982497,118730,3.8
VA,1989,2,3105672,2989199,116473,3.8
VA,1989,3,3111116,2992380,118736,3.8
VA,1989,4,3119297,3000248,119049,3.8
VA,1989,5,3127004,3006549,120455,3.9
VA,1989,6,3135113,3013312,121801,3.9
VA,1989,7,3144353,3019617,124736,4
VA,1989,8,3146281,3022497,123784,3.9
VA,1989,9,3154511,3028694,125817,4
VA,1989,10,3163585,3035564,128021,4
VA,1989,11,3169418,3042031,127387,4
VA,1989,12,3172465,3045424,127041,4
VA,1990,1,3182593,3052155,130438,4.1
VA,1990,2,3184896,3061119,123777,3.9
VA,1990,3,3192505,3067363,125142,3.9
VA,1990,4,3197043,3068662,128381,4
VA,1990,5,3208385,3074643,133742,4.2
VA,1990,6,3214851,3078707,136144,4.2
VA,1990,7,3222950,3080234,142716,4.4
VA,1990,8,3230853,3086140,144713,4.5
VA,1990,9,3238341,3088548,149793,4.6
VA,1990,10,3248580,3086453,162127,5
VA,1990,11,3254056,3088184,165872,5.1
VA,1990,12,3266351,3090895,175456,5.4
VA,1991,1,3275710,3093128,182582,5.6
VA,1991,2,3290906,3091165,199741,6.1
VA,1991,3,3295051,3092962,202089,6.1
VA,1991,4,3291315,3093253,198062,6
VA,1991,5,3287121,3096475,190646,5.8
VA,1991,6,3291410,3100094,191316,5.8
VA,1991,7,3289906,3099799,190107,5.8
VA,1991,8,3293303,3105668,187635,5.7
VA,1991,9,3299810,3110735,189075,5.7
VA,1991,10,3304774,3114524,190250,5.8
VA,1991,11,3316549,3118258,198291,6
VA,1991,12,3327449,3123464,203985,6.1
VA,1992,1,3339963,3126793,213170,6.4
VA,1992,2,3348096,3130640,217456,6.5
VA,1992,3,3352697,3133756,218941,6.5
VA,1992,4,3349014,3138509,210505,6.3
VA,1992,5,3357310,3141913,215397,6.4
VA,1992,6,3353813,3143347,210466,6.3
VA,1992,7,3354203,3149057,205146,6.1
VA,1992,8,3354364,3151435,202929,6
VA,1992,9,3355075,3154956,200119,6
VA,1992,10,3358418,3161496,196922,5.9
VA,1992,11,3358032,3164949,193083,5.7
VA,1992,12,3359077,3167115,191962,5.7
VA,1993,1,3356791,3172105,184686,5.5
VA,1993,2,3354446,3177537,176909,5.3
VA,1993,3,3354235,3176086,178149,5.3
VA,1993,4,3362363,3182891,179472,5.3
VA,1993,5,3365935,3187757,178178,5.3
VA,1993,6,3365689,3190444,175245,5.2
VA,1993,7,3368474,3196420,172054,5.1
VA,1993,8,3371117,3199777,171340,5.1
VA,1993,9,3375760,3206136,169624,5
VA,1993,10,3382909,3214271,168638,5
VA,1993,11,3386446,3219036,167410,4.9
VA,1993,12,3391109,3225696,165413,4.9
VA,1994,1,3394393,3229543,164850,4.9
VA,1994,2,3399278,3234411,164867,4.9
VA,1994,3,3408383,3244443,163940,4.8
VA,1994,4,3417579,3253811,163768,4.8
VA,1994,5,3423640,3258239,165401,4.8
VA,1994,6,3428318,3264258,164060,4.8
VA,1994,7,3432938,3270246,162692,4.7
VA,1994,8,3437692,3276128,161564,4.7
VA,1994,9,3440052,3281490,158562,4.6
VA,1994,10,3442348,3285007,157341,4.6
VA,1994,11,3444709,3290120,154589,4.5
VA,1994,12,3450117,3293973,156144,4.5
VA,1995,1,3453147,3299368,153779,4.5
VA,1995,2,3455225,3302878,152347,4.4
VA,1995,3,3459568,3306894,152674,4.4
VA,1995,4,3461724,3307894,153830,4.4
VA,1995,5,3468790,3311093,157697,4.5
VA,1995,6,3471423,3315906,155517,4.5
VA,1995,7,3471181,3316100,155081,4.5
VA,1995,8,3479255,3320046,159209,4.6
VA,1995,9,3481895,3325021,156874,4.5
VA,1995,10,3485844,3328642,157202,4.5
VA,1995,11,3489414,3334436,154978,4.4
VA,1995,12,3490469,3340924,149545,4.3
VA,1996,1,3383437,3220528,162909,4.8
VA,1996,2,3371048,3225601,145447,4.3
VA,1996,3,3376030,3232365,143665,4.3
VA,1996,4,3386204,3236737,149467,4.4
VA,1996,5,3388249,3241194,147055,4.3
VA,1996,6,3397318,3246528,150790,4.4
VA,1996,7,3405795,3255525,150270,4.4
VA,1996,8,3407928,3262010,145918,4.3
VA,1996,9,3413501,3266037,147464,4.3
VA,1996,10,3421244,3274530,146714,4.3
VA,1996,11,3425167,3282021,143146,4.2
VA,1996,12,3429074,3286915,142159,4.1
VA,1997,1,3437204,3296297,140907,4.1
VA,1997,2,3440268,3301585,138683,4
VA,1997,3,3443219,3307200,136019,4
VA,1997,4,3447838,3309940,137898,4
VA,1997,5,3449544,3314506,135038,3.9
VA,1997,6,3451762,3318764,132998,3.9
VA,1997,7,3454603,3324549,130054,3.8
VA,1997,8,3455177,3328845,126332,3.7
VA,1997,9,3454262,3334693,119569,3.5
VA,1997,10,3454097,3342150,111947,3.2
VA,1997,11,3456296,3347423,108873,3.1
VA,1997,12,3457911,3353247,104664,3
VA,1998,1,3454969,3354654,100315,2.9
VA,1998,2,3458685,3359289,99396,2.9
VA,1998,3,3459993,3362501,97492,2.8
VA,1998,4,3465402,3369861,95541,2.8
VA,1998,5,3474543,3377303,97240,2.8
VA,1998,6,3481303,3381604,99699,2.9
VA,1998,7,3485731,3387205,98526,2.8
VA,1998,8,3496296,3393845,102451,2.9
VA,1998,9,3504632,3402411,102221,2.9
VA,1998,10,3503826,3402850,100976,2.9
VA,1998,11,3507194,3408640,98554,2.8
VA,1998,12,3514233,3415677,98556,2.8
VA,1999,1,3510181,3420008,90173,2.6
VA,1999,2,3515541,3426776,88765,2.5
VA,1999,3,3522881,3429709,93172,2.6
VA,1999,4,3527963,3434194,93769,2.7
VA,1999,5,3531022,3434577,96445,2.7
VA,1999,6,3534633,3438253,96380,2.7
VA,1999,7,3535504,3441104,94400,2.7
VA,1999,8,3544634,3445455,99179,2.8
VA,1999,9,3548764,3449298,99466,2.8
VA,1999,10,3553663,3456875,96788,2.7
VA,1999,11,3556143,3460170,95973,2.7
VA,1999,12,3555975,3462644,93331,2.6
VA,2000,1,3566859,3481367,85492,2.4
VA,2000,2,3570467,3485949,84518,2.4
VA,2000,3,3570774,3490313,80461,2.3
VA,2000,4,3576354,3494459,81895,2.3
VA,2000,5,3578640,3498383,80257,2.2
VA,2000,6,3582915,3502087,80828,2.3
VA,2000,7,3586994,3505567,81427,2.3
VA,2000,8,3590454,3508823,81631,2.3
VA,2000,9,3594657,3511855,82802,2.3
VA,2000,10,3595867,3514659,81208,2.3
VA,2000,11,3596157,3517236,78921,2.2
VA,2000,12,3598305,3519584,78721,2.2
VA,2001,1,3601581,3521701,79880,2.2
VA,2001,2,3610952,3524000,86952,2.4
VA,2001,3,3620889,3526480,94409,2.6
VA,2001,4,3631425,3529143,102282,2.8
VA,2001,5,3643729,3531990,111739,3.1
VA,2001,6,3650932,3535022,115910,3.2
VA,2001,7,3660397,3538240,122157,3.3
VA,2001,8,3668286,3541645,126641,3.5
VA,2001,9,3677347,3545238,132109,3.6
VA,2001,10,3693020,3549021,143999,3.9
VA,2001,11,3701013,3552994,148019,4
VA,2001,12,3704885,3557159,147726,4
VA,2002,1,3714859,3562527,152332,4.1
VA,2002,2,3720975,3566995,153980,4.1
VA,2002,3,3725341,3571516,153825,4.1
VA,2002,4,3736034,3576089,159945,4.3
VA,2002,5,3741975,3580716,161259,4.3
VA,2002,6,3743441,3585397,158044,4.2
VA,2002,7,3750799,3590131,160668,4.3
VA,2002,8,3755233,3594920,160313,4.3
VA,2002,9,3755175,3599763,155412,4.1
VA,2002,10,3759985,3604660,155325,4.1
VA,2002,11,3765296,3609613,155683,4.1
VA,2002,12,3766515,3614622,151893,4
VA,2003,1,3774624,3620414,154210,4.1
VA,2003,2,3779735,3625432,154303,4.1
VA,2003,3,3788238,3630400,157838,4.2
VA,2003,4,3794270,3635319,158951,4.2
VA,2003,5,3797044,3640188,156856,4.1
VA,2003,6,3803655,3645007,158648,4.2
VA,2003,7,3815240,3649775,165465,4.3
VA,2003,8,3810293,3654492,155801,4.1
VA,2003,9,3814894,3659158,155736,4.1
VA,2003,10,3815244,3663773,151471,4
VA,2003,11,3818751,3668337,150414,3.9
VA,2003,12,3821841,3672848,148993,3.9
VA,2004,1,3831672,3685200,146472,3.8
VA,2004,2,3833164,3690020,143144,3.7
VA,2004,3,3837382,3695033,142349,3.7
VA,2004,4,3842014,3700238,141776,3.7
VA,2004,5,3849406,3705637,143769,3.7
VA,2004,6,3855523,3711231,144292,3.7
VA,2004,7,3861691,3717021,144670,3.7
VA,2004,8,3867931,3723008,144923,3.7
VA,2004,9,3870420,3729193,141227,3.6
VA,2004,10,3877434,3735577,141857,3.7
VA,2004,11,3882383,3742162,140221,3.6
VA,2004,12,3886381,3748948,137433,3.5
VA,2005,1,3889359,3755936,133423,3.4
VA,2005,2,3894536,3763053,131483,3.4
VA,2005,3,3905907,3770300,135607,3.5
VA,2005,4,3917876,3777677,140199,3.6
VA,2005,5,3926803,3785186,141617,3.6
VA,2005,6,3936318,3792827,143491,3.6
VA,2005,7,3939871,3800600,139271,3.5
VA,2005,8,3951176,3808506,142670,3.6
VA,2005,9,3958843,3816546,142297,3.6
VA,2005,10,3962284,3824720,137564,3.5
VA,2005,11,3967629,3833030,134599,3.4
VA,2005,12,3972397,3841475,130922,3.3
VA,2006,1,3971590,3850057,121533,3.1
VA,2006,2,3975969,3858341,117628,3
VA,2006,3,3983765,3866325,117440,2.9
VA,2006,4,3993367,3874008,119359,3
VA,2006,5,3998630,3881389,117241,2.9
VA,2006,6,4009815,3888464,121351,3
VA,2006,7,4016022,3895234,120788,3
VA,2006,8,4026469,3901696,124773,3.1
VA,2006,9,4034341,3907849,126492,3.1
VA,2006,10,4036464,3913692,122772,3
VA,2006,11,4039593,3919221,120372,3
VA,2006,12,4040753,3924437,116316,2.9
VA,2007,1,4041116,3929337,111779,2.8
VA,2007,2,4047454,3933789,113665,2.8
VA,2007,3,4051532,3937791,113741,2.8
VA,2007,4,4057196,3941341,115855,2.9
VA,2007,5,4062679,3944436,118243,2.9
VA,2007,6,4067750,3947075,120675,3
VA,2007,7,4068691,3949254,119437,2.9
VA,2007,8,4076572,3950971,125601,3.1
VA,2007,9,4078033,3952225,125808,3.1
VA,2007,10,4084044,3953013,131031,3.2
VA,2007,11,4086949,3953332,133617,3.3
VA,2007,12,4088220,3953181,135039,3.3
VA,2008,1,4089782,3952556,137226,3.4
VA,2008,2,4093737,3952383,141354,3.5
VA,2008,3,4099518,3952662,146856,3.6
VA,2008,4,4103565,3953398,150167,3.7
VA,2008,5,4110823,3954592,156231,3.8
VA,2008,6,4118554,3956246,162308,3.9
VA,2008,7,4123932,3958363,165569,4
VA,2008,8,4129941,3960945,168996,4.1
VA,2008,9,4134469,3963994,170475,4.1
VA,2008,10,4145775,3967513,178262,4.3
VA,2008,11,4163788,3971505,192283,4.6
VA,2008,12,4183307,3975971,207336,5
VA,2009,1,4146162,3899246,246916,6
WA,1976,1,1582177,1445226,136951,8.7
WA,1976,2,1578698,1444749,133949,8.5
WA,1976,3,1588166,1446899,141267,8.9
WA,1976,4,1600022,1458706,141316,8.8
WA,1976,5,1600995,1462860,138135,8.6
WA,1976,6,1602604,1459918,142686,8.9
WA,1976,7,1626465,1478223,148242,9.1
WA,1976,8,1643564,1494558,149006,9.1
WA,1976,9,1654215,1502358,151857,9.2
WA,1976,10,1662674,1513995,148679,8.9
WA,1976,11,1673516,1526571,146945,8.8
WA,1976,12,1665146,1522210,142936,8.6
WA,1977,1,1667652,1520246,147406,8.8
WA,1977,2,1683379,1531554,151825,9
WA,1977,3,1679123,1525272,153851,9.2
WA,1977,4,1679890,1530791,149099,8.9
WA,1977,5,1679853,1533476,146377,8.7
WA,1977,6,1695412,1548794,146618,8.6
WA,1977,7,1697597,1551323,146274,8.6
WA,1977,8,1701129,1557823,143306,8.4
WA,1977,9,1714121,1575726,138395,8.1
WA,1977,10,1712223,1576726,135497,7.9
WA,1977,11,1720242,1591353,128889,7.5
WA,1977,12,1732566,1617370,115196,6.6
WA,1978,1,1754551,1632545,122006,7
WA,1978,2,1764761,1645656,119105,6.7
WA,1978,3,1775366,1655385,119981,6.8
WA,1978,4,1785625,1667208,118417,6.6
WA,1978,5,1811491,1689682,121809,6.7
WA,1978,6,1821426,1699283,122143,6.7
WA,1978,7,1823455,1701031,122424,6.7
WA,1978,8,1829830,1702174,127656,7
WA,1978,9,1822323,1693412,128911,7.1
WA,1978,10,1830327,1704904,125423,6.9
WA,1978,11,1830679,1712475,118204,6.5
WA,1978,12,1841004,1714230,126774,6.9
WA,1979,1,1841909,1719668,122241,6.6
WA,1979,2,1861592,1730666,130926,7
WA,1979,3,1888112,1763058,125054,6.6
WA,1979,4,1913280,1783431,129849,6.8
WA,1979,5,1922391,1794231,128160,6.7
WA,1979,6,1936470,1810724,125746,6.5
WA,1979,7,1942573,1817841,124732,6.4
WA,1979,8,1951957,1823508,128449,6.6
WA,1979,9,1954913,1820294,134619,6.9
WA,1979,10,1952293,1822288,130005,6.7
WA,1979,11,1949361,1823456,125905,6.5
WA,1979,12,1952922,1817952,134970,6.9
WA,1980,1,1952310,1815247,137063,7
WA,1980,2,1958115,1826585,131530,6.7
WA,1980,3,1966410,1831080,135330,6.9
WA,1980,4,1971699,1821896,149803,7.6
WA,1980,5,1965450,1809227,156223,7.9
WA,1980,6,1962562,1796619,165943,8.5
WA,1980,7,1970516,1803935,166581,8.5
WA,1980,8,1970724,1805885,164839,8.4
WA,1980,9,1979685,1813078,166607,8.4
WA,1980,10,1982054,1813710,168344,8.5
WA,1980,11,1989064,1824830,164234,8.3
WA,1980,12,1999882,1826511,173371,8.7
WA,1981,1,1994820,1833057,161763,8.1
WA,1981,2,1991120,1822847,168273,8.5
WA,1981,3,1990977,1819866,171111,8.6
WA,1981,4,1993009,1816440,176569,8.9
WA,1981,5,1991316,1812341,178975,9
WA,1981,6,2003953,1822679,181274,9
WA,1981,7,2005361,1819068,186293,9.3
WA,1981,8,2002354,1809620,192734,9.6
WA,1981,9,1998861,1804406,194455,9.7
WA,1981,10,1991388,1788710,202678,10.2
WA,1981,11,1985104,1776320,208784,10.5
WA,1981,12,1995114,1775623,219491,11
WA,1982,1,2002385,1777655,224730,11.2
WA,1982,2,2000130,1772163,227967,11.4
WA,1982,3,2009240,1778395,230845,11.5
WA,1982,4,2007161,1770434,236727,11.8
WA,1982,5,2014067,1772516,241551,12
WA,1982,6,2011939,1771598,240341,11.9
WA,1982,7,2021717,1780068,241649,12
WA,1982,8,2033016,1788622,244394,12
WA,1982,9,2037037,1794217,242820,11.9
WA,1982,10,2043752,1796461,247291,12.1
WA,1982,11,2054645,1804138,250507,12.2
WA,1982,12,2054318,1808918,245400,11.9
WA,1983,1,2045745,1805201,240544,11.8
WA,1983,2,2047661,1810708,236953,11.6
WA,1983,3,2050891,1809895,240996,11.8
WA,1983,4,2050155,1818039,232116,11.3
WA,1983,5,2050429,1818901,231528,11.3
WA,1983,6,2065639,1838722,226917,11
WA,1983,7,2057653,1832548,225105,10.9
WA,1983,8,2062723,1839532,223191,10.8
WA,1983,9,2071536,1852020,219516,10.6
WA,1983,10,2083420,1864725,218695,10.5
WA,1983,11,2083810,1869124,214686,10.3
WA,1983,12,2069286,1861095,208191,10.1
WA,1984,1,2055338,1847435,207903,10.1
WA,1984,2,2065334,1866955,198379,9.6
WA,1984,3,2063759,1872701,191058,9.3
WA,1984,4,2059660,1867435,192225,9.3
WA,1984,5,2057943,1867773,190170,9.2
WA,1984,6,2062635,1874167,188468,9.1
WA,1984,7,2070749,1884478,186271,9
WA,1984,8,2074927,1890364,184563,8.9
WA,1984,9,2075804,1890552,185252,8.9
WA,1984,10,2073541,1888496,185045,8.9
WA,1984,11,2069654,1884506,185148,8.9
WA,1984,12,2070748,1887311,183437,8.9
WA,1985,1,2089993,1903998,185995,8.9
WA,1985,2,2092604,1906806,185798,8.9
WA,1985,3,2084590,1907850,176740,8.5
WA,1985,4,2090146,1914491,175655,8.4
WA,1985,5,2091304,1914110,177194,8.5
WA,1985,6,2087734,1911637,176097,8.4
WA,1985,7,2099990,1926488,173502,8.3
WA,1985,8,2105911,1935779,170132,8.1
WA,1985,9,2114286,1942312,171974,8.1
WA,1985,10,2119972,1949426,170546,8
WA,1985,11,2125996,1953903,172093,8.1
WA,1985,12,2125319,1954985,170334,8
WA,1986,1,2145170,1973448,171722,8
WA,1986,2,2152773,1981130,171643,8
WA,1986,3,2169807,1997098,172709,8
WA,1986,4,2181812,2007436,174376,8
WA,1986,5,2191088,2015080,176008,8
WA,1986,6,2191515,2014315,177200,8.1
WA,1986,7,2212089,2031551,180538,8.2
WA,1986,8,2213048,2034525,178523,8.1
WA,1986,9,2213959,2035661,178298,8.1
WA,1986,10,2218077,2037546,180531,8.1
WA,1986,11,2212314,2035248,177066,8
WA,1986,12,2209162,2035382,173780,7.9
WA,1987,1,2221744,2049964,171780,7.7
WA,1987,2,2220104,2047586,172518,7.8
WA,1987,3,2226808,2056446,170362,7.7
WA,1987,4,2229324,2063822,165502,7.4
WA,1987,5,2243267,2080654,162613,7.2
WA,1987,6,2254392,2094681,159711,7.1
WA,1987,7,2266106,2105858,160248,7.1
WA,1987,8,2278207,2120070,158137,6.9
WA,1987,9,2288246,2122626,165620,7.2
WA,1987,10,2296870,2133838,163032,7.1
WA,1987,11,2293379,2136649,156730,6.8
WA,1987,12,2304367,2148306,156061,6.8
WA,1988,1,2299618,2148121,151497,6.6
WA,1988,2,2306572,2157539,149033,6.5
WA,1988,3,2304194,2154696,149498,6.5
WA,1988,4,2305567,2161434,144133,6.3
WA,1988,5,2309870,2165604,144266,6.2
WA,1988,6,2315619,2168067,147552,6.4
WA,1988,7,2323010,2176614,146396,6.3
WA,1988,8,2327224,2181256,145968,6.3
WA,1988,9,2351408,2199362,152046,6.5
WA,1988,10,2353953,2212262,141691,6
WA,1988,11,2356687,2218656,138031,5.9
WA,1988,12,2363871,2229677,134194,5.7
WA,1989,1,2371419,2230501,140918,5.9
WA,1989,2,2373991,2229928,144063,6.1
WA,1989,3,2387123,2243419,143704,6
WA,1989,4,2401992,2260938,141054,5.9
WA,1989,5,2420197,2281942,138255,5.7
WA,1989,6,2428648,2287018,141630,5.8
WA,1989,7,2428277,2285758,142519,5.9
WA,1989,8,2454215,2308082,146133,6
WA,1989,9,2464704,2320517,144187,5.9
WA,1989,10,2470534,2327540,142994,5.8
WA,1989,11,2482098,2341309,140789,5.7
WA,1989,12,2500005,2365019,134986,5.4
WA,1990,1,2508814,2381880,126934,5.1
WA,1990,2,2527849,2395414,132435,5.2
WA,1990,3,2536725,2403484,133241,5.3
WA,1990,4,2538629,2410845,127784,5
WA,1990,5,2539980,2410802,129178,5.1
WA,1990,6,2549676,2423908,125768,4.9
WA,1990,7,2543664,2417215,126449,5
WA,1990,8,2553340,2426889,126451,5
WA,1990,9,2536902,2409800,127102,5
WA,1990,10,2528070,2398441,129629,5.1
WA,1990,11,2538562,2398965,139597,5.5
WA,1990,12,2542238,2399680,142558,5.6
WA,1991,1,2536702,2384110,152592,6
WA,1991,2,2534141,2383723,150418,5.9
WA,1991,3,2532073,2376447,155626,6.1
WA,1991,4,2534677,2377561,157116,6.2
WA,1991,5,2533463,2379975,153488,6.1
WA,1991,6,2536975,2380729,156246,6.2
WA,1991,7,2538368,2380635,157733,6.2
WA,1991,8,2541569,2380651,160918,6.3
WA,1991,9,2547714,2386249,161465,6.3
WA,1991,10,2556250,2391655,164595,6.4
WA,1991,11,2562455,2387937,174518,6.8
WA,1991,12,2572348,2393381,178967,7
WA,1992,1,2588151,2408427,179724,6.9
WA,1992,2,2600695,2415701,184994,7.1
WA,1992,3,2603741,2420343,183398,7
WA,1992,4,2622847,2440745,182102,6.9
WA,1992,5,2632719,2448911,183808,7
WA,1992,6,2633512,2449084,184428,7
WA,1992,7,2647774,2458040,189734,7.2
WA,1992,8,2646626,2456759,189867,7.2
WA,1992,9,2651948,2460996,190952,7.2
WA,1992,10,2663600,2464626,198974,7.5
WA,1992,11,2663849,2465875,197974,7.4
WA,1992,12,2659532,2460890,198642,7.5
WA,1993,1,2662924,2458901,204023,7.7
WA,1993,2,2666372,2472460,193912,7.3
WA,1993,3,2672131,2477156,194975,7.3
WA,1993,4,2679455,2487111,192344,7.2
WA,1993,5,2679681,2489675,190006,7.1
WA,1993,6,2686305,2496039,190266,7.1
WA,1993,7,2684847,2492967,191880,7.1
WA,1993,8,2688462,2498131,190331,7.1
WA,1993,9,2703690,2517330,186360,6.9
WA,1993,10,2720842,2534361,186481,6.9
WA,1993,11,2719377,2535311,184066,6.8
WA,1993,12,2738398,2549946,188452,6.9
WA,1994,1,2744434,2558387,186047,6.8
WA,1994,2,2737603,2549065,188538,6.9
WA,1994,3,2727175,2540177,186998,6.9
WA,1994,4,2729689,2546090,183599,6.7
WA,1994,5,2728251,2546363,181888,6.7
WA,1994,6,2728659,2551826,176833,6.5
WA,1994,7,2732909,2558844,174065,6.4
WA,1994,8,2749090,2577262,171828,6.3
WA,1994,9,2754745,2587291,167454,6.1
WA,1994,10,2754285,2583750,170535,6.2
WA,1994,11,2772510,2597446,175064,6.3
WA,1994,12,2778708,2603460,175248,6.3
WA,1995,1,2786650,2612333,174317,6.3
WA,1995,2,2797499,2618579,178920,6.4
WA,1995,3,2802408,2628013,174395,6.2
WA,1995,4,2804693,2629917,174776,6.2
WA,1995,5,2811517,2635589,175928,6.3
WA,1995,6,2816884,2641665,175219,6.2
WA,1995,7,2803581,2628438,175143,6.2
WA,1995,8,2814050,2633981,180069,6.4
WA,1995,9,2813407,2640977,172430,6.1
WA,1995,10,2821398,2645802,175596,6.2
WA,1995,11,2833574,2650293,183281,6.5
WA,1995,12,2845671,2666545,179126,6.3
WA,1996,1,2860489,2682763,177726,6.2
WA,1996,2,2854419,2681670,172749,6.1
WA,1996,3,2865130,2690660,174470,6.1
WA,1996,4,2866323,2690862,175461,6.1
WA,1996,5,2882926,2701591,181335,6.3
WA,1996,6,2879880,2705964,173916,6
WA,1996,7,2891939,2721718,170221,5.9
WA,1996,8,2887577,2718736,168841,5.8
WA,1996,9,2887674,2721433,166241,5.8
WA,1996,10,2897513,2733774,163739,5.7
WA,1996,11,2907248,2746875,160373,5.5
WA,1996,12,2908060,2747507,160553,5.5
WA,1997,1,2914599,2765045,149554,5.1
WA,1997,2,2926006,2778500,147506,5
WA,1997,3,2937645,2790143,147502,5
WA,1997,4,2951559,2802432,149127,5.1
WA,1997,5,2960009,2815639,144370,4.9
WA,1997,6,2969887,2825321,144566,4.9
WA,1997,7,2980599,2836970,143629,4.8
WA,1997,8,2981377,2838093,143284,4.8
WA,1997,9,2982641,2840107,142534,4.8
WA,1997,10,2988866,2847645,141221,4.7
WA,1997,11,2998139,2858280,139859,4.7
WA,1997,12,3008485,2868501,139984,4.7
WA,1998,1,3011052,2865080,145972,4.8
WA,1998,2,3011366,2870038,141328,4.7
WA,1998,3,3011574,2869897,141677,4.7
WA,1998,4,3010158,2870078,140080,4.7
WA,1998,5,3027312,2885410,141902,4.7
WA,1998,6,3025331,2881588,143743,4.8
WA,1998,7,3030337,2885513,144824,4.8
WA,1998,8,3027777,2882636,145141,4.8
WA,1998,9,3046607,2897139,149468,4.9
WA,1998,10,3054769,2906238,148531,4.9
WA,1998,11,3061147,2912342,148805,4.9
WA,1998,12,3066794,2916489,150305,4.9
WA,1999,1,3065683,2918562,147121,4.8
WA,1999,2,3070922,2919776,151146,4.9
WA,1999,3,3067884,2920364,147520,4.8
WA,1999,4,3066201,2918644,147557,4.8
WA,1999,5,3066997,2912378,154619,5
WA,1999,6,3069195,2912611,156584,5.1
WA,1999,7,3080075,2929734,150341,4.9
WA,1999,8,3071826,2922641,149185,4.9
WA,1999,9,3062894,2914680,148214,4.8
WA,1999,10,3060901,2916262,144639,4.7
WA,1999,11,3056428,2914743,141685,4.6
WA,1999,12,3054971,2910530,144441,4.7
WA,2000,1,3056635,2908800,147835,4.8
WA,2000,2,3052004,2901527,150477,4.9
WA,2000,3,3062169,2914989,147180,4.8
WA,2000,4,3043624,2897679,145945,4.8
WA,2000,5,3049787,2902575,147212,4.8
WA,2000,6,3052065,2903888,148177,4.9
WA,2000,7,3038637,2885298,153339,5
WA,2000,8,3041943,2887329,154614,5.1
WA,2000,9,3043986,2893040,150946,5
WA,2000,10,3045150,2890899,154251,5.1
WA,2000,11,3054492,2896252,158240,5.2
WA,2000,12,3059763,2901851,157912,5.2
WA,2001,1,3051519,2890885,160634,5.3
WA,2001,2,3054299,2883615,170684,5.6
WA,2001,3,3055803,2881173,174630,5.7
WA,2001,4,3054498,2875697,178801,5.9
WA,2001,5,3053583,2869460,184123,6
WA,2001,6,3052022,2864439,187583,6.1
WA,2001,7,3050233,2862604,187629,6.2
WA,2001,8,3047220,2856264,190956,6.3
WA,2001,9,3044465,2850417,194048,6.4
WA,2001,10,3050093,2847395,202698,6.6
WA,2001,11,3058464,2842430,216034,7.1
WA,2001,12,3060370,2840080,220290,7.2
WA,2002,1,3069836,2841851,227985,7.4
WA,2002,2,3082730,2856042,226688,7.4
WA,2002,3,3089020,2855688,233332,7.6
WA,2002,4,3101470,2862241,239229,7.7
WA,2002,5,3100295,2869010,231285,7.5
WA,2002,6,3104837,2875878,228959,7.4
WA,2002,7,3109930,2882421,227509,7.3
WA,2002,8,3110634,2888938,221696,7.1
WA,2002,9,3119588,2896400,223188,7.2
WA,2002,10,3121096,2899184,221912,7.1
WA,2002,11,3125363,2899347,226016,7.2
WA,2002,12,3121582,2897269,224313,7.2
WA,2003,1,3132730,2905528,227202,7.3
WA,2003,2,3129498,2899697,229801,7.3
WA,2003,3,3125884,2891318,234566,7.5
WA,2003,4,3129073,2889905,239168,7.6
WA,2003,5,3129557,2893486,236071,7.5
WA,2003,6,3131949,2895367,236582,7.6
WA,2003,7,3145338,2908190,237148,7.5
WA,2003,8,3148697,2914317,234380,7.4
WA,2003,9,3156627,2922493,234134,7.4
WA,2003,10,3167781,2937586,230195,7.3
WA,2003,11,3174132,2944952,229180,7.2
WA,2003,12,3182585,2955921,226664,7.1
WA,2004,1,3171140,2952613,218527,6.9
WA,2004,2,3180755,2968004,212751,6.7
WA,2004,3,3188183,2980275,207908,6.5
WA,2004,4,3196799,2993894,202905,6.3
WA,2004,5,3193208,2994559,198649,6.2
WA,2004,6,3198074,2999410,198664,6.2
WA,2004,7,3196499,3001110,195389,6.1
WA,2004,8,3196853,3002234,194619,6.1
WA,2004,9,3201954,3009143,192811,6
WA,2004,10,3214077,3020864,193213,6
WA,2004,11,3221836,3031289,190547,5.9
WA,2004,12,3231433,3040919,190514,5.9
WA,2005,1,3226852,3040999,185853,5.8
WA,2005,2,3224441,3042415,182026,5.6
WA,2005,3,3230451,3051564,178887,5.5
WA,2005,4,3242667,3060833,181834,5.6
WA,2005,5,3248051,3065269,182782,5.6
WA,2005,6,3254359,3072412,181947,5.6
WA,2005,7,3261983,3081859,180124,5.5
WA,2005,8,3270388,3089762,180626,5.5
WA,2005,9,3271663,3090871,180792,5.5
WA,2005,10,3286981,3108360,178621,5.4
WA,2005,11,3293643,3120702,172941,5.3
WA,2005,12,3294652,3128738,165914,5
WA,2006,1,3298325,3137093,161232,4.9
WA,2006,2,3301133,3142974,158159,4.8
WA,2006,3,3307913,3149035,158878,4.8
WA,2006,4,3309954,3148905,161049,4.9
WA,2006,5,3314868,3148706,166162,5
WA,2006,6,3326120,3161202,164918,5
WA,2006,7,3315024,3151153,163871,4.9
WA,2006,8,3320416,3155339,165077,5
WA,2006,9,3330158,3163151,167007,5
WA,2006,10,3331365,3168365,163000,4.9
WA,2006,11,3338512,3175445,163067,4.9
WA,2006,12,3341320,3182570,158750,4.8
WA,2007,1,3340209,3186374,153835,4.6
WA,2007,2,3356210,3206887,149323,4.4
WA,2007,3,3365663,3217844,147819,4.4
WA,2007,4,3371150,3222482,148668,4.4
WA,2007,5,3382579,3230044,152535,4.5
WA,2007,6,3390027,3237721,152306,4.5
WA,2007,7,3396012,3241379,154633,4.6
WA,2007,8,3399238,3246102,153136,4.5
WA,2007,9,3410588,3251463,159125,4.7
WA,2007,10,3422906,3263539,159367,4.7
WA,2007,11,3429256,3270895,158361,4.6
WA,2007,12,3431132,3273560,157572,4.6
WA,2008,1,3437906,3281459,156447,4.6
WA,2008,2,3447185,3284537,162648,4.7
WA,2008,3,3449523,3284342,165181,4.8
WA,2008,4,3456708,3286447,170261,4.9
WA,2008,5,3457067,3280101,176966,5.1
WA,2008,6,3462989,3281503,181486,5.2
WA,2008,7,3476183,3292506,183677,5.3
WA,2008,8,3489196,3300376,188820,5.4
WA,2008,9,3501686,3307777,193909,5.5
WA,2008,10,3501893,3295863,206030,5.9
WA,2008,11,3515329,3301555,213774,6.1
WA,2008,12,3525523,3295451,230072,6.5
WA,2009,1,3526801,3251791,275010,7.8
WV,1976,1,696021,637559,58462,8.4
WV,1976,2,692437,639139,53298,7.7
WV,1976,3,695230,640734,54496,7.8
WV,1976,4,696883,642346,54537,7.8
WV,1976,5,697737,643972,53765,7.7
WV,1976,6,697579,645604,51975,7.5
WV,1976,7,697687,647261,50426,7.2
WV,1976,8,697710,648951,48759,7
WV,1976,9,699025,650707,48318,6.9
WV,1976,10,699709,652525,47184,6.7
WV,1976,11,702294,654403,47891,6.8
WV,1976,12,704243,656343,47900,6.8
WV,1977,1,705164,658351,46813,6.6
WV,1977,2,721582,660433,61149,8.5
WV,1977,3,711315,662588,48727,6.9
WV,1977,4,710940,664794,46146,6.5
WV,1977,5,711563,667024,44539,6.3
WV,1977,6,713985,669268,44717,6.3
WV,1977,7,716851,671520,45331,6.3
WV,1977,8,720200,673794,46406,6.4
WV,1977,9,722136,676102,46034,6.4
WV,1977,10,724484,678434,46050,6.4
WV,1977,11,726354,680796,45558,6.3
WV,1977,12,732392,683189,49203,6.7
WV,1978,1,735359,685612,49747,6.8
WV,1978,2,736573,687981,48592,6.6
WV,1978,3,741591,690300,51291,6.9
WV,1978,4,732522,692563,39959,5.5
WV,1978,5,734035,694764,39271,5.4
WV,1978,6,735884,696886,38998,5.3
WV,1978,7,739339,698899,40440,5.5
WV,1978,8,745335,700796,44539,6
WV,1978,9,750065,702573,47492,6.3
WV,1978,10,746854,704226,42628,5.7
WV,1978,11,749855,705720,44135,5.9
WV,1978,12,752395,707049,45346,6
WV,1979,1,755922,708221,47701,6.3
WV,1979,2,758024,709218,48806,6.4
WV,1979,3,758038,710051,47987,6.3
WV,1979,4,760685,710709,49976,6.6
WV,1979,5,761787,711188,50599,6.6
WV,1979,6,764259,711485,52774,6.9
WV,1979,7,765859,711594,54265,7.1
WV,1979,8,763785,711508,52277,6.8
WV,1979,9,765417,711203,54214,7.1
WV,1979,10,767021,710676,56345,7.3
WV,1979,11,768839,709945,58894,7.7
WV,1979,12,769216,709014,60202,7.8
WV,1980,1,770272,707889,62383,8.1
WV,1980,2,770777,706746,64031,8.3
WV,1980,3,773280,705586,67694,8.8
WV,1980,4,776469,704425,72044,9.3
WV,1980,5,773975,703275,70700,9.1
WV,1980,6,777193,702148,75045,9.7
WV,1980,7,780530,701050,79480,10.2
WV,1980,8,780409,700006,80403,10.3
WV,1980,9,778964,699023,79941,10.3
WV,1980,10,778602,698096,80506,10.3
WV,1980,11,778756,697215,81541,10.5
WV,1980,12,779756,696376,83380,10.7
WV,1981,1,782354,695570,86784,11.1
WV,1981,2,779312,694656,84656,10.9
WV,1981,3,780050,693626,86424,11.1
WV,1981,4,780384,692477,87907,11.3
WV,1981,5,781049,691207,89842,11.5
WV,1981,6,770284,689827,80457,10.4
WV,1981,7,764159,688337,75822,9.9
WV,1981,8,762991,686686,76305,10
WV,1981,9,762682,684858,77824,10.2
WV,1981,10,761413,682848,78565,10.3
WV,1981,11,761394,680663,80731,10.6
WV,1981,12,762133,678312,83821,11
WV,1982,1,766065,675807,90258,11.8
WV,1982,2,763073,673202,89871,11.8
WV,1982,3,763656,670511,93145,12.2
WV,1982,4,765546,667755,97791,12.8
WV,1982,5,766820,664963,101857,13.3
WV,1982,6,770657,662161,108496,14.1
WV,1982,7,772576,659369,113207,14.7
WV,1982,8,772483,656605,115878,15
WV,1982,9,774685,653876,120809,15.6
WV,1982,10,778273,651223,127050,16.3
WV,1982,11,779595,648675,130920,16.8
WV,1982,12,781572,646256,135316,17.3
WV,1983,1,784580,643984,140596,17.9
WV,1983,2,784609,642051,142558,18.2
WV,1983,3,782944,640472,142472,18.2
WV,1983,4,780454,639255,141199,18.1
WV,1983,5,778007,638403,139604,17.9
WV,1983,6,775758,637909,137849,17.8
WV,1983,7,774189,637755,136434,17.6
WV,1983,8,773763,637913,135850,17.6
WV,1983,9,768370,638352,130018,16.9
WV,1983,10,766774,639072,127702,16.7
WV,1983,11,765157,640067,125090,16.3
WV,1983,12,764416,641319,123097,16.1
WV,1984,1,762511,642810,119701,15.7
WV,1984,2,758797,644183,114614,15.1
WV,1984,3,759549,645424,114125,15
WV,1984,4,760007,646528,113479,14.9
WV,1984,5,759727,647485,112242,14.8
WV,1984,6,757529,648290,109239,14.4
WV,1984,7,756523,648921,107602,14.2
WV,1984,8,755934,649365,106569,14.1
WV,1984,9,755688,649603,106085,14
WV,1984,10,761450,649651,111799,14.7
WV,1984,11,761939,649531,112408,14.8
WV,1984,12,761265,649252,112013,14.7
WV,1985,1,757737,648812,108925,14.4
WV,1985,2,756008,648473,107535,14.2
WV,1985,3,753308,648242,105066,13.9
WV,1985,4,752700,648114,104586,13.9
WV,1985,5,749494,648085,101409,13.5
WV,1985,6,748722,648153,100569,13.4
WV,1985,7,748952,648308,100644,13.4
WV,1985,8,745745,648553,97192,13
WV,1985,9,746027,648892,97135,13
WV,1985,10,745529,649323,96206,12.9
WV,1985,11,746579,649854,96725,13
WV,1985,12,743412,650491,92921,12.5
WV,1986,1,742454,651224,91230,12.3
WV,1986,2,743748,651935,91813,12.3
WV,1986,3,744878,652632,92246,12.4
WV,1986,4,744923,653325,91598,12.3
WV,1986,5,745024,654007,91017,12.2
WV,1986,6,745435,654664,90771,12.2
WV,1986,7,744948,655314,89634,12
WV,1986,8,744695,655965,88730,11.9
WV,1986,9,744992,656618,88374,11.9
WV,1986,10,744046,657272,86774,11.7
WV,1986,11,743937,657934,86003,11.6
WV,1986,12,742625,658604,84021,11.3
WV,1987,1,741930,659277,82653,11.1
WV,1987,2,742402,659961,82441,11.1
WV,1987,3,743507,660661,82846,11.1
WV,1987,4,744076,661377,82699,11.1
WV,1987,5,743624,662114,81510,11
WV,1987,6,744399,662887,81512,11
WV,1987,7,744005,663689,80316,10.8
WV,1987,8,744487,664520,79967,10.7
WV,1987,9,745031,665384,79647,10.7
WV,1987,10,744823,666275,78548,10.5
WV,1987,11,744842,667179,77663,10.4
WV,1987,12,743942,668093,75849,10.2
WV,1988,1,743102,669014,74088,10
WV,1988,2,744591,669946,74645,10
WV,1988,3,745890,670883,75007,10.1
WV,1988,4,746396,671820,74576,10
WV,1988,5,747277,672753,74524,10
WV,1988,6,747240,673674,73566,9.8
WV,1988,7,746602,674592,72010,9.6
WV,1988,8,747707,675508,72199,9.7
WV,1988,9,747792,676415,71377,9.5
WV,1988,10,747987,677327,70660,9.4
WV,1988,11,747162,678245,68917,9.2
WV,1988,12,746310,679139,67171,9
WV,1989,1,745362,680012,65350,8.8
WV,1989,2,746238,680862,65376,8.8
WV,1989,3,746166,681688,64478,8.6
WV,1989,4,748309,682487,65822,8.8
WV,1989,5,750085,683270,66815,8.9
WV,1989,6,750104,684056,66048,8.8
WV,1989,7,751521,684851,66670,8.9
WV,1989,8,750790,685674,65116,8.7
WV,1989,9,751267,686505,64762,8.6
WV,1989,10,751724,687327,64397,8.6
WV,1989,11,750755,688138,62617,8.3
WV,1989,12,750939,688931,62008,8.3
WV,1990,1,751159,689700,61459,8.2
WV,1990,2,749870,690367,59503,7.9
WV,1990,3,749938,690919,59019,7.9
WV,1990,4,752617,691346,61271,8.1
WV,1990,5,754475,691649,62826,8.3
WV,1990,6,755584,691819,63765,8.4
WV,1990,7,756389,691862,64527,8.5
WV,1990,8,757983,691794,66189,8.7
WV,1990,9,760057,691634,68423,9
WV,1990,10,761111,691391,69720,9.2
WV,1990,11,762695,691064,71631,9.4
WV,1990,12,763791,690659,73132,9.6
WV,1991,1,762837,690178,72659,9.5
WV,1991,2,764472,689721,74751,9.8
WV,1991,3,766643,689288,77355,10.1
WV,1991,4,767624,688892,78732,10.3
WV,1991,5,768054,688548,79506,10.4
WV,1991,6,768379,688266,80113,10.4
WV,1991,7,769963,688043,81920,10.6
WV,1991,8,771136,687882,83254,10.8
WV,1991,9,771696,687792,83904,10.9
WV,1991,10,772200,687771,84429,10.9
WV,1991,11,772942,687818,85124,11
WV,1991,12,775541,687941,87600,11.3
WV,1992,1,775223,688141,87082,11.2
WV,1992,2,774856,688353,86503,11.2
WV,1992,3,777155,688578,88577,11.4
WV,1992,4,776877,688821,88056,11.3
WV,1992,5,777262,689082,88180,11.3
WV,1992,6,778583,689353,89230,11.5
WV,1992,7,777824,689647,88177,11.3
WV,1992,8,778467,689960,88507,11.4
WV,1992,9,779225,690303,88922,11.4
WV,1992,10,778542,690683,87859,11.3
WV,1992,11,777459,691091,86368,11.1
WV,1992,12,777571,691523,86048,11.1
WV,1993,1,774510,691974,82536,10.7
WV,1993,2,775113,692514,82599,10.7
WV,1993,3,777061,693144,83917,10.8
WV,1993,4,778666,693877,84789,10.9
WV,1993,5,779230,694710,84520,10.8
WV,1993,6,778444,695654,82790,10.6
WV,1993,7,777991,696710,81281,10.4
WV,1993,8,779199,697865,81334,10.4
WV,1993,9,779167,699120,80047,10.3
WV,1993,10,779158,700471,78687,10.1
WV,1993,11,778959,701915,77044,9.9
WV,1993,12,778674,703452,75222,9.7
WV,1994,1,780388,705074,75314,9.7
WV,1994,2,780847,706671,74176,9.5
WV,1994,3,781188,708231,72957,9.3
WV,1994,4,779967,709740,70227,9
WV,1994,5,780522,711180,69342,8.9
WV,1994,6,781400,712529,68871,8.8
WV,1994,7,781000,713792,67208,8.6
WV,1994,8,781375,714968,66407,8.5
WV,1994,9,780405,716055,64350,8.2
WV,1994,10,780837,717048,63789,8.2
WV,1994,11,779753,717947,61806,7.9
WV,1994,12,781490,718733,62757,8
WV,1995,1,779983,719431,60552,7.8
WV,1995,2,782474,720147,62327,8
WV,1995,3,780729,720889,59840,7.7
WV,1995,4,782211,721654,60557,7.7
WV,1995,5,784821,722448,62373,7.9
WV,1995,6,785962,723284,62678,8
WV,1995,7,787165,724153,63012,8
WV,1995,8,787763,725054,62709,8
WV,1995,9,787629,725983,61646,7.8
WV,1995,10,788009,726939,61070,7.7
WV,1995,11,790556,727923,62633,7.9
WV,1995,12,789685,728942,60743,7.7
WV,1996,1,795905,729996,65909,8.3
WV,1996,2,792695,731062,61633,7.8
WV,1996,3,792141,732134,60007,7.6
WV,1996,4,792730,733209,59521,7.5
WV,1996,5,792259,734277,57982,7.3
WV,1996,6,792892,735316,57576,7.3
WV,1996,7,793376,736331,57045,7.2
WV,1996,8,794983,737325,57658,7.3
WV,1996,9,795655,738298,57357,7.2
WV,1996,10,796922,739252,57670,7.2
WV,1996,11,797430,740193,57237,7.2
WV,1996,12,798077,741124,56953,7.1
WV,1997,1,798661,742050,56611,7.1
WV,1997,2,798882,742938,55944,7
WV,1997,3,797860,743794,54066,6.8
WV,1997,4,798864,744618,54246,6.8
WV,1997,5,798404,745417,52987,6.6
WV,1997,6,800197,746202,53995,6.7
WV,1997,7,801157,746963,54194,6.8
WV,1997,8,801769,747697,54072,6.7
WV,1997,9,802127,748408,53719,6.7
WV,1997,10,802810,749093,53717,6.7
WV,1997,11,803604,749749,53855,6.7
WV,1997,12,804242,750377,53865,6.7
WV,1998,1,802528,750982,51546,6.4
WV,1998,2,803711,751597,52114,6.5
WV,1998,3,806694,752228,54466,6.8
WV,1998,4,805342,752879,52463,6.5
WV,1998,5,805699,753549,52150,6.5
WV,1998,6,807281,754222,53059,6.6
WV,1998,7,807916,754904,53012,6.6
WV,1998,8,808719,755596,53123,6.6
WV,1998,9,808995,756306,52689,6.5
WV,1998,10,809194,757027,52167,6.4
WV,1998,11,809197,757758,51439,6.4
WV,1998,12,809828,758501,51327,6.3
WV,1999,1,811562,759255,52307,6.4
WV,1999,2,809998,759969,50029,6.2
WV,1999,3,814249,760639,53610,6.6
WV,1999,4,813182,761272,51910,6.4
WV,1999,5,813715,761865,51850,6.4
WV,1999,6,814172,762423,51749,6.4
WV,1999,7,813987,762931,51056,6.3
WV,1999,8,815018,763384,51634,6.3
WV,1999,9,814745,763788,50957,6.3
WV,1999,10,814479,764139,50340,6.2
WV,1999,11,813366,764425,48941,6
WV,1999,12,812084,764645,47439,5.8
WV,2000,1,809568,764205,45363,5.6
WV,2000,2,810676,764601,46075,5.7
WV,2000,3,807801,764916,42885,5.3
WV,2000,4,808517,765135,43382,5.4
WV,2000,5,809409,765253,44156,5.5
WV,2000,6,810233,765261,44972,5.6
WV,2000,7,809391,765168,44223,5.5
WV,2000,8,808644,764977,43667,5.4
WV,2000,9,809205,764703,44502,5.5
WV,2000,10,808432,764341,44091,5.5
WV,2000,11,808060,763887,44173,5.5
WV,2000,12,806397,763339,43058,5.3
WV,2001,1,804547,762692,41855,5.2
WV,2001,2,803196,762036,41160,5.1
WV,2001,3,802266,761362,40904,5.1
WV,2001,4,802177,760670,41507,5.2
WV,2001,5,802035,759965,42070,5.2
WV,2001,6,801436,759262,42174,5.3
WV,2001,7,800858,758556,42302,5.3
WV,2001,8,799549,757855,41694,5.2
WV,2001,9,798822,757154,41668,5.2
WV,2001,10,798150,756455,41695,5.2
WV,2001,11,797916,755763,42153,5.3
WV,2001,12,796522,755077,41445,5.2
WV,2002,1,797498,753106,44392,5.6
WV,2002,2,795951,752386,43565,5.5
WV,2002,3,796479,751654,44825,5.6
WV,2002,4,797484,750917,46567,5.8
WV,2002,5,798565,750181,48384,6.1
WV,2002,6,798108,749442,48666,6.1
WV,2002,7,797501,748717,48784,6.1
WV,2002,8,795715,748015,47700,6
WV,2002,9,795468,747334,48134,6.1
WV,2002,10,794665,746681,47984,6
WV,2002,11,794181,746061,48120,6.1
WV,2002,12,793157,745476,47681,6
WV,2003,1,791412,744221,47191,6
WV,2003,2,791804,743713,48091,6.1
WV,2003,3,790980,743249,47731,6
WV,2003,4,791630,742837,48793,6.2
WV,2003,5,790219,742479,47740,6
WV,2003,6,790543,742185,48358,6.1
WV,2003,7,790935,741955,48980,6.2
WV,2003,8,789563,741790,47773,6.1
WV,2003,9,788328,741682,46646,5.9
WV,2003,10,787588,741633,45955,5.8
WV,2003,11,786088,741639,44449,5.7
WV,2003,12,785844,741701,44143,5.6
WV,2004,1,786767,744164,42603,5.4
WV,2004,2,787084,744414,42670,5.4
WV,2004,3,786740,744742,41998,5.3
WV,2004,4,787443,745141,42302,5.4
WV,2004,5,787375,745608,41767,5.3
WV,2004,6,788134,746144,41990,5.3
WV,2004,7,788756,746752,42004,5.3
WV,2004,8,789399,747427,41972,5.3
WV,2004,9,789070,748171,40899,5.2
WV,2004,10,789926,748987,40939,5.2
WV,2004,11,789423,749870,39553,5
WV,2004,12,789869,750823,39046,4.9
WV,2005,1,789913,751847,38066,4.8
WV,2005,2,790454,752920,37534,4.7
WV,2005,3,793564,754043,39521,5
WV,2005,4,793253,755213,38040,4.8
WV,2005,5,794913,756423,38490,4.8
WV,2005,6,797516,757674,39842,5
WV,2005,7,800162,758963,41199,5.1
WV,2005,8,801565,760285,41280,5.1
WV,2005,9,802791,761637,41154,5.1
WV,2005,10,803143,763016,40127,5
WV,2005,11,803413,764426,38987,4.9
WV,2005,12,803443,765856,37587,4.7
WV,2006,1,803172,767294,35878,4.5
WV,2006,2,804102,768643,35459,4.4
WV,2006,3,805543,769897,35646,4.4
WV,2006,4,807561,771051,36510,4.5
WV,2006,5,809943,772119,37824,4.7
WV,2006,6,811330,773109,38221,4.7
WV,2006,7,812899,774020,38879,4.8
WV,2006,8,814765,774863,39902,4.9
WV,2006,9,814953,775637,39316,4.8
WV,2006,10,814709,776334,38375,4.7
WV,2006,11,813897,776954,36943,4.5
WV,2006,12,812360,777489,34871,4.3
WV,2007,1,811116,777942,33174,4.1
WV,2007,2,813647,778291,35356,4.3
WV,2007,3,812544,778537,34007,4.2
WV,2007,4,813347,778678,34669,4.3
WV,2007,5,813792,778716,35076,4.3
WV,2007,6,813438,778653,34785,4.3
WV,2007,7,814343,778486,35857,4.4
WV,2007,8,814670,778220,36450,4.5
WV,2007,9,814314,777848,36466,4.5
WV,2007,10,813843,777364,36479,4.5
WV,2007,11,812238,776762,35476,4.4
WV,2007,12,811054,776036,35018,4.3
WV,2008,1,808250,775182,33068,4.1
WV,2008,2,808069,774375,33694,4.2
WV,2008,3,807812,773613,34199,4.2
WV,2008,4,808002,772906,35096,4.3
WV,2008,5,807314,772260,35054,4.3
WV,2008,6,806415,771679,34736,4.3
WV,2008,7,804769,771171,33598,4.2
WV,2008,8,804180,770731,33449,4.2
WV,2008,9,804803,770352,34451,4.3
WV,2008,10,804426,770030,34396,4.3
WV,2008,11,804331,769770,34561,4.3
WV,2008,12,805454,769587,35867,4.5
WV,2009,1,799051,756843,42208,5.3
WI,1976,1,2124243,2001456,122787,5.8
WI,1976,2,2135219,2004399,130820,6.1
WI,1976,3,2121435,2007538,113897,5.4
WI,1976,4,2123164,2010810,112354,5.3
WI,1976,5,2127395,2014232,113163,5.3
WI,1976,6,2132023,2017993,114030,5.3
WI,1976,7,2145218,2022185,123033,5.7
WI,1976,8,2142602,2026731,115871,5.4
WI,1976,9,2147742,2031553,116189,5.4
WI,1976,10,2151925,2036543,115382,5.4
WI,1976,11,2168434,2041681,126753,5.8
WI,1976,12,2168023,2047076,120947,5.6
WI,1977,1,2167186,2052675,114511,5.3
WI,1977,2,2172414,2058193,114221,5.3
WI,1977,3,2185439,2063773,121666,5.6
WI,1977,4,2175649,2069499,106150,4.9
WI,1977,5,2182766,2075312,107454,4.9
WI,1977,6,2189448,2081048,108400,5
WI,1977,7,2195165,2086610,108555,4.9
WI,1977,8,2200666,2092124,108542,4.9
WI,1977,9,2210029,2097591,112438,5.1
WI,1977,10,2212326,2103115,109211,4.9
WI,1977,11,2214820,2108777,106043,4.8
WI,1977,12,2225379,2114535,110844,5
WI,1978,1,2231366,2120402,110964,5
WI,1978,2,2234297,2126382,107915,4.8
WI,1978,3,2235110,2132447,102663,4.6
WI,1978,4,2243939,2138519,105420,4.7
WI,1978,5,2250823,2144644,106179,4.7
WI,1978,6,2258502,2150866,107636,4.8
WI,1978,7,2267579,2157113,110466,4.9
WI,1978,8,2276777,2163266,113511,5
WI,1978,9,2278817,2169328,109489,4.8
WI,1978,10,2285986,2175356,110630,4.8
WI,1978,11,2290774,2181323,109451,4.8
WI,1978,12,2306587,2187186,119401,5.2
WI,1979,1,2298037,2192983,105054,4.6
WI,1979,2,2291312,2198274,93038,4.1
WI,1979,3,2296690,2202875,93815,4.1
WI,1979,4,2314073,2206684,107389,4.6
WI,1979,5,2310998,2209636,101362,4.4
WI,1979,6,2311619,2211734,99885,4.3
WI,1979,7,2319382,2212956,106426,4.6
WI,1979,8,2314996,2213421,101575,4.4
WI,1979,9,2317867,2213205,104662,4.5
WI,1979,10,2316323,2212207,104116,4.5
WI,1979,11,2322379,2210188,112191,4.8
WI,1979,12,2316404,2207073,109331,4.7
WI,1980,1,2323776,2202879,120897,5.2
WI,1980,2,2323066,2198815,124251,5.3
WI,1980,3,2327932,2194912,133020,5.7
WI,1980,4,2346046,2191353,154693,6.6
WI,1980,5,2363083,2188453,174630,7.4
WI,1980,6,2358553,2186240,172313,7.3
WI,1980,7,2358492,2184860,173632,7.4
WI,1980,8,2401604,2184387,217217,9
WI,1980,9,2394161,2184743,209418,8.7
WI,1980,10,2389444,2185936,203508,8.5
WI,1980,11,2380269,2187901,192368,8.1
WI,1980,12,2383751,2190463,193288,8.1
WI,1981,1,2380984,2193519,187465,7.9
WI,1981,2,2383851,2195897,187954,7.9
WI,1981,3,2395090,2197663,197427,8.2
WI,1981,4,2377049,2198892,178157,7.5
WI,1981,5,2380894,2199436,181458,7.6
WI,1981,6,2382878,2199427,183451,7.7
WI,1981,7,2378428,2198950,179478,7.5
WI,1981,8,2381202,2197836,183366,7.7
WI,1981,9,2377284,2195971,181313,7.6
WI,1981,10,2391691,2193341,198350,8.3
WI,1981,11,2392681,2190034,202647,8.5
WI,1981,12,2394764,2186156,208608,8.7
WI,1982,1,2400140,2181713,218427,9.1
WI,1982,2,2396099,2177396,218703,9.1
WI,1982,3,2403912,2173205,230707,9.6
WI,1982,4,2421627,2169206,252421,10.4
WI,1982,5,2413902,2165583,248319,10.3
WI,1982,6,2407830,2162307,245523,10.2
WI,1982,7,2404071,2159360,244711,10.2
WI,1982,8,2409730,2156710,253020,10.5
WI,1982,9,2410802,2154344,256458,10.6
WI,1982,10,2412746,2152344,260402,10.8
WI,1982,11,2413796,2150880,262916,10.9
WI,1982,12,2430138,2150148,279990,11.5
WI,1983,1,2437145,2150189,286956,11.8
WI,1983,2,2427451,2150985,276466,11.4
WI,1983,3,2424594,2152489,272105,11.2
WI,1983,4,2405664,2154696,250968,10.4
WI,1983,5,2394230,2157515,236715,9.9
WI,1983,6,2387816,2160828,226988,9.5
WI,1983,7,2390173,2164557,225616,9.4
WI,1983,8,2393481,2168621,224860,9.4
WI,1983,9,2386592,2173170,213422,8.9
WI,1983,10,2388905,2178130,210775,8.8
WI,1983,11,2391018,2183545,207473,8.7
WI,1983,12,2393996,2189338,204658,8.5
WI,1984,1,2388957,2195413,193544,8.1
WI,1984,2,2385800,2200949,184851,7.7
WI,1984,3,2384342,2205933,178409,7.5
WI,1984,4,2388573,2210337,178236,7.5
WI,1984,5,2393514,2214099,179415,7.5
WI,1984,6,2393393,2217284,176109,7.4
WI,1984,7,2388947,2219841,169106,7.1
WI,1984,8,2385608,2221802,163806,6.9
WI,1984,9,2390861,2223107,167754,7
WI,1984,10,2392123,2223746,168377,7
WI,1984,11,2389644,2223871,165773,6.9
WI,1984,12,2390324,2223479,166845,7
WI,1985,1,2392418,2222628,169790,7.1
WI,1985,2,2401337,2222127,179210,7.5
WI,1985,3,2401585,2222121,179464,7.5
WI,1985,4,2398998,2222610,176388,7.4
WI,1985,5,2392493,2223536,168957,7.1
WI,1985,6,2392727,2224779,167948,7
WI,1985,7,2392661,2226414,166247,6.9
WI,1985,8,2396606,2228521,168085,7
WI,1985,9,2404148,2231109,173039,7.2
WI,1985,10,2407209,2234223,172986,7.2
WI,1985,11,2415304,2237834,177470,7.3
WI,1985,12,2417602,2241977,175625,7.3
WI,1986,1,2420181,2246629,173552,7.2
WI,1986,2,2425493,2251371,174122,7.2
WI,1986,3,2428226,2256181,172045,7.1
WI,1986,4,2431802,2261062,170740,7
WI,1986,5,2436036,2266045,169991,7
WI,1986,6,2437432,2271135,166297,6.8
WI,1986,7,2438906,2276390,162516,6.7
WI,1986,8,2446526,2281855,164671,6.7
WI,1986,9,2454909,2287498,167411,6.8
WI,1986,10,2461252,2293297,167955,6.8
WI,1986,11,2462703,2299165,163538,6.6
WI,1986,12,2468382,2305060,163322,6.6
WI,1987,1,2470655,2311002,159653,6.5
WI,1987,2,2480494,2317030,163464,6.6
WI,1987,3,2481595,2323099,158496,6.4
WI,1987,4,2480198,2329175,151023,6.1
WI,1987,5,2488195,2335231,152964,6.1
WI,1987,6,2495398,2341319,154079,6.2
WI,1987,7,2496014,2347498,148516,6
WI,1987,8,2507137,2353784,153353,6.1
WI,1987,9,2515939,2360221,155718,6.2
WI,1987,10,2522791,2366801,155990,6.2
WI,1987,11,2530942,2373452,157490,6.2
WI,1987,12,2492079,2380202,111877,4.5
WI,1988,1,2494790,2387021,107769,4.3
WI,1988,2,2501262,2393904,107358,4.3
WI,1988,3,2507035,2400808,106227,4.2
WI,1988,4,2510093,2407670,102423,4.1
WI,1988,5,2521214,2414378,106836,4.2
WI,1988,6,2527247,2420974,106273,4.2
WI,1988,7,2532152,2427411,104741,4.1
WI,1988,8,2540024,2433658,106366,4.2
WI,1988,9,2548233,2439764,108469,4.3
WI,1988,10,2551818,2445673,106145,4.2
WI,1988,11,2557059,2451368,105691,4.1
WI,1988,12,2561882,2456835,105047,4.1
WI,1989,1,2565575,2462095,103480,4
WI,1989,2,2571916,2466768,105148,4.1
WI,1989,3,2575668,2470831,104837,4.1
WI,1989,4,2584673,2474314,110359,4.3
WI,1989,5,2591617,2477306,114311,4.4
WI,1989,6,2593507,2479866,113641,4.4
WI,1989,7,2595667,2481945,113722,4.4
WI,1989,8,2595879,2483582,112297,4.3
WI,1989,9,2599502,2484779,114723,4.4
WI,1989,10,2597207,2485601,111606,4.3
WI,1989,11,2596548,2486080,110468,4.3
WI,1989,12,2589373,2486187,103186,4
WI,1990,1,2598803,2485889,112914,4.3
WI,1990,2,2587196,2485739,101457,3.9
WI,1990,3,2589212,2485692,103520,4
WI,1990,4,2590758,2485725,105033,4.1
WI,1990,5,2590703,2485827,104876,4
WI,1990,6,2593241,2485971,107270,4.1
WI,1990,7,2596909,2486105,110804,4.3
WI,1990,8,2599413,2486238,113175,4.4
WI,1990,9,2605322,2486368,118954,4.6
WI,1990,10,2607275,2486481,120794,4.6
WI,1990,11,2615006,2486642,128364,4.9
WI,1990,12,2612935,2486873,126062,4.8
WI,1991,1,2621231,2487280,133951,5.1
WI,1991,2,2632543,2488013,144530,5.5
WI,1991,3,2639085,2489163,149922,5.7
WI,1991,4,2637558,2490735,146823,5.6
WI,1991,5,2635877,2492799,143078,5.4
WI,1991,6,2636403,2495350,141053,5.4
WI,1991,7,2632598,2498352,134246,5.1
WI,1991,8,2639286,2501763,137523,5.2
WI,1991,9,2645407,2505532,139875,5.3
WI,1991,10,2650801,2509722,141079,5.3
WI,1991,11,2655293,2514282,141011,5.3
WI,1991,12,2655603,2519240,136363,5.1
WI,1992,1,2654335,2524604,129731,4.9
WI,1992,2,2656697,2530132,126565,4.8
WI,1992,3,2664841,2535837,129004,4.8
WI,1992,4,2673415,2541738,131677,4.9
WI,1992,5,2687810,2547602,140208,5.2
WI,1992,6,2696838,2553399,143439,5.3
WI,1992,7,2701535,2559202,142333,5.3
WI,1992,8,2710630,2565003,145627,5.4
WI,1992,9,2721208,2570814,150394,5.5
WI,1992,10,2726180,2576625,149555,5.5
WI,1992,11,2725648,2582409,143239,5.3
WI,1992,12,2722255,2588164,134091,4.9
WI,1993,1,2715937,2593914,122023,4.5
WI,1993,2,2720406,2599775,120631,4.4
WI,1993,3,2722677,2605670,117007,4.3
WI,1993,4,2737975,2611655,126320,4.6
WI,1993,5,2743828,2617863,125965,4.6
WI,1993,6,2750054,2624256,125798,4.6
WI,1993,7,2754523,2630898,123625,4.5
WI,1993,8,2764130,2637782,126348,4.6
WI,1993,9,2770051,2644893,125158,4.5
WI,1993,10,2777252,2652202,125050,4.5
WI,1993,11,2784901,2659631,125270,4.5
WI,1993,12,2791539,2667231,124308,4.5
WI,1994,1,2797911,2674973,122938,4.4
WI,1994,2,2811944,2682610,129334,4.6
WI,1994,3,2815569,2690107,125462,4.5
WI,1994,4,2820750,2697415,123335,4.4
WI,1994,5,2829000,2704505,124495,4.4
WI,1994,6,2836949,2711428,125521,4.4
WI,1994,7,2842080,2718162,123918,4.4
WI,1994,8,2848107,2724600,123507,4.3
WI,1994,9,2852818,2730805,122013,4.3
WI,1994,10,2855659,2736638,119021,4.2
WI,1994,11,2854393,2742170,112223,3.9
WI,1994,12,2856905,2747294,109611,3.8
WI,1995,1,2857723,2752008,105715,3.7
WI,1995,2,2862010,2756526,105484,3.7
WI,1995,3,2865718,2760800,104918,3.7
WI,1995,4,2873205,2764796,108409,3.8
WI,1995,5,2879086,2768634,110452,3.8
WI,1995,6,2881687,2772428,109259,3.8
WI,1995,7,2882615,2776095,106520,3.7
WI,1995,8,2887441,2779684,107757,3.7
WI,1995,9,2891725,2783160,108565,3.8
WI,1995,10,2895346,2786514,108832,3.8
WI,1995,11,2899438,2789837,109601,3.8
WI,1995,12,2899001,2793191,105810,3.6
WI,1996,1,2902442,2796505,105937,3.6
WI,1996,2,2907720,2799766,107954,3.7
WI,1996,3,2907389,2803086,104303,3.6
WI,1996,4,2916826,2806428,110398,3.8
WI,1996,5,2916940,2809923,107017,3.7
WI,1996,6,2919855,2813500,106355,3.6
WI,1996,7,2923924,2817134,106790,3.7
WI,1996,8,2925472,2820833,104639,3.6
WI,1996,9,2929204,2824492,104712,3.6
WI,1996,10,2931120,2828164,102956,3.5
WI,1996,11,2934476,2831839,102637,3.5
WI,1996,12,2936975,2835515,101460,3.5
WI,1997,1,2945619,2839263,106356,3.6
WI,1997,2,2944706,2842836,101870,3.5
WI,1997,3,2949356,2846274,103082,3.5
WI,1997,4,2957131,2849642,107489,3.6
WI,1997,5,2955590,2852913,102677,3.5
WI,1997,6,2959858,2855965,103893,3.5
WI,1997,7,2962963,2858747,104216,3.5
WI,1997,8,2965613,2861250,104363,3.5
WI,1997,9,2967139,2863460,103679,3.5
WI,1997,10,2966564,2865296,101268,3.4
WI,1997,11,2965504,2866689,98815,3.3
WI,1997,12,2966244,2867622,98622,3.3
WI,1998,1,2962902,2868080,94822,3.2
WI,1998,2,2960352,2868453,91899,3.1
WI,1998,3,2964927,2868755,96172,3.2
WI,1998,4,2959392,2869072,90320,3.1
WI,1998,5,2962520,2869337,93183,3.1
WI,1998,6,2966571,2869537,97034,3.3
WI,1998,7,2978129,2869735,108394,3.6
WI,1998,8,2969768,2870029,99739,3.4
WI,1998,9,2972060,2870498,101562,3.4
WI,1998,10,2971657,2871188,100469,3.4
WI,1998,11,2969742,2872057,97685,3.3
WI,1998,12,2966767,2873042,93725,3.2
WI,1999,1,2973028,2874066,98962,3.3
WI,1999,2,2965837,2875071,90766,3.1
WI,1999,3,2965027,2876073,88954,3
WI,1999,4,2961857,2877073,84784,2.9
WI,1999,5,2968291,2878009,90282,3
WI,1999,6,2967835,2878930,88905,3
WI,1999,7,2971142,2879786,91356,3.1
WI,1999,8,2972847,2880493,92354,3.1
WI,1999,9,2972494,2881143,91351,3.1
WI,1999,10,2974099,2881819,92280,3.1
WI,1999,11,2975090,2882533,92557,3.1
WI,1999,12,2972767,2883293,89474,3
WI,2000,1,2978412,2888060,90352,3
WI,2000,2,2979886,2889211,90675,3
WI,2000,3,2981718,2890486,91232,3.1
WI,2000,4,2984437,2891771,92666,3.1
WI,2000,5,2990992,2893036,97956,3.3
WI,2000,6,2999408,2894312,105096,3.5
WI,2000,7,3000846,2895527,105319,3.5
WI,2000,8,3005711,2896743,108968,3.6
WI,2000,9,3005014,2897953,107061,3.6
WI,2000,10,3004625,2899203,105422,3.5
WI,2000,11,3009627,2900511,109116,3.6
WI,2000,12,3012417,2901798,110619,3.7
WI,2001,1,3015218,2903136,112082,3.7
WI,2001,2,3024564,2903935,120629,4
WI,2001,3,3027974,2904145,123829,4.1
WI,2001,4,3033113,2903767,129346,4.3
WI,2001,5,3032095,2902869,129226,4.3
WI,2001,6,3037268,2901457,135811,4.5
WI,2001,7,3035481,2899598,135883,4.5
WI,2001,8,3032632,2897292,135340,4.5
WI,2001,9,3029115,2894549,134566,4.4
WI,2001,10,3033814,2891450,142364,4.7
WI,2001,11,3037000,2888183,148817,4.9
WI,2001,12,3033709,2884868,148841,4.9
WI,2002,1,3024278,2867530,156748,5.2
WI,2002,2,3028034,2864661,163373,5.4
WI,2002,3,3027267,2862398,164869,5.4
WI,2002,4,3026058,2860663,165395,5.5
WI,2002,5,3016649,2859440,157209,5.2
WI,2002,6,3017798,2858647,159151,5.3
WI,2002,7,3016583,2858301,158282,5.2
WI,2002,8,3017293,2858368,158925,5.3
WI,2002,9,3016203,2858811,157392,5.2
WI,2002,10,3016854,2859626,157228,5.2
WI,2002,11,3019911,2860667,159244,5.3
WI,2002,12,3025878,2861863,164015,5.4
WI,2003,1,3030680,2859246,171434,5.7
WI,2003,2,3036334,2860329,176005,5.8
WI,2003,3,3038711,2861193,177518,5.8
WI,2003,4,3041074,2861904,179170,5.9
WI,2003,5,3033152,2862458,170694,5.6
WI,2003,6,3034336,2862813,171523,5.7
WI,2003,7,3038148,2863063,175085,5.8
WI,2003,8,3034988,2863373,171615,5.7
WI,2003,9,3031021,2863773,167248,5.5
WI,2003,10,3028626,2864140,164486,5.4
WI,2003,11,3027825,2864335,163490,5.4
WI,2003,12,3029193,2864418,164775,5.4
WI,2004,1,3029450,2865488,163962,5.4
WI,2004,2,3031311,2865638,165673,5.5
WI,2004,3,3027465,2865949,161516,5.3
WI,2004,4,3019551,2866408,153143,5.1
WI,2004,5,3020184,2866999,153185,5.1
WI,2004,6,3018998,2867719,151279,5
WI,2004,7,3019738,2868531,151207,5
WI,2004,8,3018669,2869263,149406,4.9
WI,2004,9,3016080,2869922,146158,4.8
WI,2004,10,3015428,2870651,144777,4.8
WI,2004,11,3012835,2871486,141349,4.7
WI,2004,12,3015118,2872461,142657,4.7
WI,2005,1,3025368,2873628,151740,5
WI,2005,2,3021643,2875128,146515,4.8
WI,2005,3,3023561,2876892,146669,4.9
WI,2005,4,3019392,2878914,140478,4.7
WI,2005,5,3026496,2881091,145405,4.8
WI,2005,6,3028052,2883550,144502,4.8
WI,2005,7,3033900,2886374,147526,4.9
WI,2005,8,3034722,2889477,145245,4.8
WI,2005,9,3036947,2892836,144111,4.7
WI,2005,10,3038488,2896360,142128,4.7
WI,2005,11,3042185,2900180,142005,4.7
WI,2005,12,3051141,2904292,146849,4.8
WI,2006,1,3052665,2908619,144046,4.7
WI,2006,2,3057031,2912763,144268,4.7
WI,2006,3,3062882,2916731,146151,4.8
WI,2006,4,3058607,2920488,138119,4.5
WI,2006,5,3065542,2923983,141559,4.6
WI,2006,6,3069733,2927258,142475,4.6
WI,2006,7,3070861,2930235,140626,4.6
WI,2006,8,3075901,2932956,142945,4.6
WI,2006,9,3079471,2935443,144028,4.7
WI,2006,10,3080542,2937682,142860,4.6
WI,2006,11,3082699,2939780,142919,4.6
WI,2006,12,3089636,2941739,147897,4.8
WI,2007,1,3091725,2943478,148247,4.8
WI,2007,2,3099688,2945021,154667,5
WI,2007,3,3097177,2946450,150727,4.9
WI,2007,4,3101171,2947738,153433,4.9
WI,2007,5,3095547,2948877,146670,4.7
WI,2007,6,3094737,2949725,145012,4.7
WI,2007,7,3093838,2950139,143699,4.6
WI,2007,8,3094879,2950183,144696,4.7
WI,2007,9,3093445,2949915,143530,4.6
WI,2007,10,3091195,2949413,141782,4.6
WI,2007,11,3086338,2948759,137579,4.5
WI,2007,12,3085418,2947877,137541,4.5
WI,2008,1,3083174,2946607,136567,4.4
WI,2008,2,3084478,2945253,139225,4.5
WI,2008,3,3080290,2943820,136470,4.4
WI,2008,4,3082122,2942331,139791,4.5
WI,2008,5,3075254,2940808,134446,4.4
WI,2008,6,3074062,2939150,134912,4.4
WI,2008,7,3077959,2937419,140540,4.6
WI,2008,8,3080252,2935650,144602,4.7
WI,2008,9,3080032,2933833,146199,4.7
WI,2008,10,3084475,2931964,152511,4.9
WI,2008,11,3096819,2929890,166929,5.4
WI,2008,12,3110639,2927727,182912,5.9
WI,2009,1,3099535,2884132,215403,6.9
WY,1976,1,174326,167170,7156,4.1
WY,1976,2,174366,168049,6317,3.6
WY,1976,3,175439,168972,6467,3.7
WY,1976,4,176504,169945,6559,3.7
WY,1976,5,177880,170963,6917,3.9
WY,1976,6,179549,172023,7526,4.2
WY,1976,7,180790,173122,7668,4.2
WY,1976,8,182116,174236,7880,4.3
WY,1976,9,183417,175382,8035,4.4
WY,1976,10,184132,176597,7535,4.1
WY,1976,11,185155,177882,7273,3.9
WY,1976,12,186359,179239,7120,3.8
WY,1977,1,187707,180674,7033,3.7
WY,1977,2,188821,182117,6704,3.6
WY,1977,3,189149,183566,5583,3
WY,1977,4,191468,185020,6448,3.4
WY,1977,5,193275,186480,6795,3.5
WY,1977,6,194700,187934,6766,3.5
WY,1977,7,195932,189364,6568,3.4
WY,1977,8,197381,190760,6621,3.4
WY,1977,9,199169,192110,7059,3.5
WY,1977,10,200649,193417,7232,3.6
WY,1977,11,201174,194686,6488,3.2
WY,1977,12,202328,195926,6402,3.2
WY,1978,1,202198,197131,5067,2.5
WY,1978,2,203834,198331,5503,2.7
WY,1978,3,204466,199524,4942,2.4
WY,1978,4,205425,200704,4721,2.3
WY,1978,5,208070,201875,6195,3
WY,1978,6,210054,203056,6998,3.3
WY,1978,7,211178,204250,6928,3.3
WY,1978,8,212790,205457,7333,3.4
WY,1978,9,214610,206670,7940,3.7
WY,1978,10,215356,207901,7455,3.5
WY,1978,11,215763,209154,6609,3.1
WY,1978,12,216885,210420,6465,3
WY,1979,1,216221,211703,4518,2.1
WY,1979,2,217068,212948,4120,1.9
WY,1979,3,218834,214140,4694,2.1
WY,1979,4,220125,215273,4852,2.2
WY,1979,5,221194,216356,4838,2.2
WY,1979,6,223263,217389,5874,2.6
WY,1979,7,224584,218366,6218,2.8
WY,1979,8,225853,219290,6563,2.9
WY,1979,9,227371,220174,7197,3.2
WY,1979,10,227651,220998,6653,2.9
WY,1979,11,228097,221756,6341,2.8
WY,1979,12,229768,222453,7315,3.2
WY,1980,1,230196,223079,7117,3.1
WY,1980,2,231385,223717,7668,3.3
WY,1980,3,232365,224375,7990,3.4
WY,1980,4,232725,225052,7673,3.3
WY,1980,5,234836,225759,9077,3.9
WY,1980,6,236181,226504,9677,4.1
WY,1980,7,237560,227308,10252,4.3
WY,1980,8,238515,228183,10332,4.3
WY,1980,9,239357,229117,10240,4.3
WY,1980,10,240976,230082,10894,4.5
WY,1980,11,241987,231067,10920,4.5
WY,1980,12,242628,232078,10550,4.3
WY,1981,1,243458,233115,10343,4.2
WY,1981,2,244290,234096,10194,4.2
WY,1981,3,246248,235028,11220,4.6
WY,1981,4,246559,235906,10653,4.3
WY,1981,5,246884,236716,10168,4.1
WY,1981,6,248029,237450,10579,4.3
WY,1981,7,248039,238084,9955,4
WY,1981,8,248748,238612,10136,4.1
WY,1981,9,248581,239016,9565,3.8
WY,1981,10,248991,239292,9699,3.9
WY,1981,11,249445,239446,9999,4
WY,1981,12,248773,239480,9293,3.7
WY,1982,1,249341,239389,9952,4
WY,1982,2,249531,239247,10284,4.1
WY,1982,3,249754,239054,10700,4.3
WY,1982,4,252866,238814,14052,5.6
WY,1982,5,253289,238532,14757,5.8
WY,1982,6,252765,238215,14550,5.8
WY,1982,7,255349,237884,17465,6.8
WY,1982,8,255651,237560,18091,7.1
WY,1982,9,254052,237246,16806,6.6
WY,1982,10,256297,236941,19356,7.6
WY,1982,11,256094,236656,19438,7.6
WY,1982,12,257379,236391,20988,8.2
WY,1983,1,258891,236172,22719,8.8
WY,1983,2,258901,236010,22891,8.8
WY,1983,3,260799,235919,24880,9.5
WY,1983,4,262376,235901,26475,10.1
WY,1983,5,262333,235956,26377,10.1
WY,1983,6,260374,236095,24279,9.3
WY,1983,7,257759,236310,21449,8.3
WY,1983,8,255861,236595,19266,7.5
WY,1983,9,254965,236935,18030,7.1
WY,1983,10,253856,237287,16569,6.5
WY,1983,11,254149,237647,16502,6.5
WY,1983,12,255456,238016,17440,6.8
WY,1984,1,255582,238397,17185,6.7
WY,1984,2,254528,238708,15820,6.2
WY,1984,3,256096,238945,17151,6.7
WY,1984,4,256253,239126,17127,6.7
WY,1984,5,256556,239260,17296,6.7
WY,1984,6,254474,239357,15117,5.9
WY,1984,7,254396,239386,15010,5.9
WY,1984,8,254422,239310,15112,5.9
WY,1984,9,254547,239130,15417,6.1
WY,1984,10,255062,238869,16193,6.3
WY,1984,11,254584,238515,16069,6.3
WY,1984,12,254570,238078,16492,6.5
WY,1985,1,253470,237554,15916,6.3
WY,1985,2,255066,237051,18015,7.1
WY,1985,3,254414,236571,17843,7
WY,1985,4,254379,236109,18270,7.2
WY,1985,5,253850,235662,18188,7.2
WY,1985,6,253397,235197,18200,7.2
WY,1985,7,252916,234739,18177,7.2
WY,1985,8,252547,234287,18260,7.2
WY,1985,9,251789,233832,17957,7.1
WY,1985,10,251239,233387,17852,7.1
WY,1985,11,251874,232944,18930,7.5
WY,1985,12,251467,232503,18964,7.5
WY,1986,1,253249,232067,21182,8.4
WY,1986,2,253282,231568,21714,8.6
WY,1986,3,253535,231014,22521,8.9
WY,1986,4,254861,230400,24461,9.6
WY,1986,5,251899,229737,22162,8.8
WY,1986,6,251404,229038,22366,8.9
WY,1986,7,251167,228310,22857,9.1
WY,1986,8,248050,227552,20498,8.3
WY,1986,9,248592,226783,21809,8.8
WY,1986,10,248144,226040,22104,8.9
WY,1986,11,248012,225340,22672,9.1
WY,1986,12,247385,224679,22706,9.2
WY,1987,1,248198,224046,24152,9.7
WY,1987,2,248088,223473,24615,9.9
WY,1987,3,246819,222961,23858,9.7
WY,1987,4,243909,222519,21390,8.8
WY,1987,5,242049,222145,19904,8.2
WY,1987,6,241350,221828,19522,8.1
WY,1987,7,240308,221588,18720,7.8
WY,1987,8,239559,221425,18134,7.6
WY,1987,9,238959,221330,17629,7.4
WY,1987,10,238673,221275,17398,7.3
WY,1987,11,237810,221257,16553,7
WY,1987,12,238396,221273,17123,7.2
WY,1988,1,238652,221318,17334,7.3
WY,1988,2,238716,221362,17354,7.3
WY,1988,3,237617,221399,16218,6.8
WY,1988,4,236781,221436,15345,6.5
WY,1988,5,236010,221459,14551,6.2
WY,1988,6,235746,221476,14270,6.1
WY,1988,7,236160,221473,14687,6.2
WY,1988,8,236631,221461,15170,6.4
WY,1988,9,236425,221433,14992,6.3
WY,1988,10,236844,221414,15430,6.5
WY,1988,11,236814,221413,15401,6.5
WY,1988,12,237408,221416,15992,6.7
WY,1989,1,237568,221429,16139,6.8
WY,1989,2,237932,221458,16474,6.9
WY,1989,3,236822,221510,15312,6.5
WY,1989,4,235752,221574,14178,6
WY,1989,5,236453,221642,14811,6.3
WY,1989,6,236572,221727,14845,6.3
WY,1989,7,236722,221832,14890,6.3
WY,1989,8,237070,221966,15104,6.4
WY,1989,9,236704,222144,14560,6.2
WY,1989,10,236626,222342,14284,6
WY,1989,11,237229,222551,14678,6.2
WY,1989,12,237333,222780,14553,6.1
WY,1990,1,236542,223014,13528,5.7
WY,1990,2,236810,223221,13589,5.7
WY,1990,3,236623,223398,13225,5.6
WY,1990,4,235925,223536,12389,5.3
WY,1990,5,235646,223625,12021,5.1
WY,1990,6,235142,223682,11460,4.9
WY,1990,7,235174,223701,11473,4.9
WY,1990,8,235877,223702,12175,5.2
WY,1990,9,236270,223688,12582,5.3
WY,1990,10,236080,223659,12421,5.3
WY,1990,11,236379,223611,12768,5.4
WY,1990,12,236046,223531,12515,5.3
WY,1991,1,236182,223420,12762,5.4
WY,1991,2,235343,223330,12013,5.1
WY,1991,3,234879,223253,11626,4.9
WY,1991,4,234501,223186,11315,4.8
WY,1991,5,234606,223136,11470,4.9
WY,1991,6,234070,223095,10975,4.7
WY,1991,7,234096,223069,11027,4.7
WY,1991,8,234432,223064,11368,4.8
WY,1991,9,235174,223087,12087,5.1
WY,1991,10,235167,223137,12030,5.1
WY,1991,11,236334,223209,13125,5.6
WY,1991,12,236696,223313,13383,5.7
WY,1992,1,237627,223445,14182,6
WY,1992,2,237649,223593,14056,5.9
WY,1992,3,237554,223753,13801,5.8
WY,1992,4,237047,223926,13121,5.5
WY,1992,5,237577,224117,13460,5.7
WY,1992,6,238365,224317,14048,5.9
WY,1992,7,237989,224544,13445,5.6
WY,1992,8,238044,224803,13241,5.6
WY,1992,9,238645,225088,13557,5.7
WY,1992,10,238340,225396,12944,5.4
WY,1992,11,238913,225717,13196,5.5
WY,1992,12,239163,226041,13122,5.5
WY,1993,1,239092,226382,12710,5.3
WY,1993,2,240467,226758,13709,5.7
WY,1993,3,241124,227174,13950,5.8
WY,1993,4,240810,227636,13174,5.5
WY,1993,5,241083,228137,12946,5.4
WY,1993,6,241635,228681,12954,5.4
WY,1993,7,242888,229258,13630,5.6
WY,1993,8,243557,229866,13691,5.6
WY,1993,9,243757,230514,13243,5.4
WY,1993,10,244862,231190,13672,5.6
WY,1993,11,245611,231895,13716,5.6
WY,1993,12,246307,232635,13672,5.6
WY,1994,1,247445,233402,14043,5.7
WY,1994,2,248690,234142,14548,5.8
WY,1994,3,249138,234856,14282,5.7
WY,1994,4,248644,235543,13101,5.3
WY,1994,5,248921,236201,12720,5.1
WY,1994,6,249189,236825,12364,5
WY,1994,7,249730,237412,12318,4.9
WY,1994,8,250062,237956,12106,4.8
WY,1994,9,249843,238446,11397,4.6
WY,1994,10,250486,238891,11595,4.6
WY,1994,11,250631,239297,11334,4.5
WY,1994,12,250915,239645,11270,4.5
WY,1995,1,252065,239940,12125,4.8
WY,1995,2,252687,240199,12488,4.9
WY,1995,3,252225,240423,11802,4.7
WY,1995,4,252483,240612,11871,4.7
WY,1995,5,253416,240775,12641,5
WY,1995,6,252908,240926,11982,4.7
WY,1995,7,253199,241039,12160,4.8
WY,1995,8,253619,241138,12481,4.9
WY,1995,9,254115,241227,12888,5.1
WY,1995,10,253923,241280,12643,5
WY,1995,11,254180,241298,12882,5.1
WY,1995,12,253533,241300,12233,4.8
WY,1996,1,254050,241279,12771,5
WY,1996,2,253729,241271,12458,4.9
WY,1996,3,254762,241278,13484,5.3
WY,1996,4,254968,241304,13664,5.4
WY,1996,5,253789,241348,12441,4.9
WY,1996,6,254115,241404,12711,5
WY,1996,7,254868,241477,13391,5.3
WY,1996,8,255160,241585,13575,5.3
WY,1996,9,255100,241714,13386,5.2
WY,1996,10,255289,241857,13432,5.3
WY,1996,11,255344,242016,13328,5.2
WY,1996,12,255437,242190,13247,5.2
WY,1997,1,256267,242404,13863,5.4
WY,1997,2,255713,242635,13078,5.1
WY,1997,3,255554,242887,12667,5
WY,1997,4,256233,243156,13077,5.1
WY,1997,5,255427,243447,11980,4.7
WY,1997,6,256015,243746,12269,4.8
WY,1997,7,256246,244061,12185,4.8
WY,1997,8,256194,244371,11823,4.6
WY,1997,9,256132,244678,11454,4.5
WY,1997,10,256595,244991,11604,4.5
WY,1997,11,256970,245311,11659,4.5
WY,1997,12,257814,245643,12171,4.7
WY,1998,1,257761,245979,11782,4.6
WY,1998,2,258050,246314,11736,4.5
WY,1998,3,258916,246644,12272,4.7
WY,1998,4,259149,246980,12169,4.7
WY,1998,5,259663,247310,12353,4.8
WY,1998,6,260960,247619,13341,5.1
WY,1998,7,261151,247924,13227,5.1
WY,1998,8,261648,248228,13420,5.1
WY,1998,9,261933,248533,13400,5.1
WY,1998,10,262433,248839,13594,5.2
WY,1998,11,262754,249148,13606,5.2
WY,1998,12,262423,249458,12965,4.9
WY,1999,1,263109,249771,13338,5.1
WY,1999,2,263127,250102,13025,5
WY,1999,3,263335,250452,12883,4.9
WY,1999,4,263545,250812,12733,4.8
WY,1999,5,264502,251183,13319,5
WY,1999,6,265073,251568,13505,5.1
WY,1999,7,264895,251966,12929,4.9
WY,1999,8,265414,252367,13047,4.9
WY,1999,9,265633,252783,12850,4.8
WY,1999,10,266008,253207,12801,4.8
WY,1999,11,265764,253640,12124,4.6
WY,1999,12,265710,254089,11621,4.4
WY,2000,1,265384,254773,10611,4
WY,2000,2,265349,255177,10172,3.8
WY,2000,3,264976,255565,9411,3.6
WY,2000,4,265239,255927,9312,3.5
WY,2000,5,265923,256270,9653,3.6
WY,2000,6,266593,256596,9997,3.7
WY,2000,7,267125,256914,10211,3.8
WY,2000,8,267981,257218,10763,4
WY,2000,9,268329,257510,10819,4
WY,2000,10,268269,257804,10465,3.9
WY,2000,11,269034,258092,10942,4.1
WY,2000,12,268392,258379,10013,3.7
WY,2001,1,268242,258658,9584,3.6
WY,2001,2,268304,258911,9393,3.5
WY,2001,3,268805,259139,9666,3.6
WY,2001,4,269041,259337,9704,3.6
WY,2001,5,269828,259506,10322,3.8
WY,2001,6,270491,259644,10847,4
WY,2001,7,270705,259742,10963,4
WY,2001,8,270893,259809,11084,4.1
WY,2001,9,271139,259838,11301,4.2
WY,2001,10,270914,259849,11065,4.1
WY,2001,11,270788,259844,10944,4
WY,2001,12,270669,259814,10855,4
WY,2002,1,268956,258683,10273,3.8
WY,2002,2,268739,258583,10156,3.8
WY,2002,3,269181,258500,10681,4
WY,2002,4,269699,258435,11264,4.2
WY,2002,5,269348,258391,10957,4.1
WY,2002,6,269483,258362,11121,4.1
WY,2002,7,269105,258353,10752,4
WY,2002,8,269304,258358,10946,4.1
WY,2002,9,270021,258383,11638,4.3
WY,2002,10,270183,258425,11758,4.4
WY,2002,11,270868,258492,12376,4.6
WY,2002,12,270958,258578,12380,4.6
WY,2003,1,270348,258400,11948,4.4
WY,2003,2,270891,258543,12348,4.6
WY,2003,3,270915,258706,12209,4.5
WY,2003,4,270925,258896,12029,4.4
WY,2003,5,271735,259106,12629,4.6
WY,2003,6,272208,259330,12878,4.7
WY,2003,7,272012,259562,12450,4.6
WY,2003,8,272069,259799,12270,4.5
WY,2003,9,271870,260033,11837,4.4
WY,2003,10,271783,260266,11517,4.2
WY,2003,11,272208,260495,11713,4.3
WY,2003,12,272314,260731,11583,4.3
WY,2004,1,272204,260907,11297,4.2
WY,2004,2,271880,261159,10721,3.9
WY,2004,3,271801,261416,10385,3.8
WY,2004,4,272268,261677,10591,3.9
WY,2004,5,272641,261929,10712,3.9
WY,2004,6,272787,262187,10600,3.9
WY,2004,7,273212,262449,10763,3.9
WY,2004,8,273684,262712,10972,4
WY,2004,9,274171,262987,11184,4.1
WY,2004,10,274258,263289,10969,4
WY,2004,11,274031,263618,10413,3.8
WY,2004,12,274151,263966,10185,3.7
WY,2005,1,274222,264334,9888,3.6
WY,2005,2,274131,264731,9400,3.4
WY,2005,3,274984,265155,9829,3.6
WY,2005,4,275875,265602,10273,3.7
WY,2005,5,276815,266072,10743,3.9
WY,2005,6,277199,266570,10629,3.8
WY,2005,7,278007,267098,10909,3.9
WY,2005,8,278302,267648,10654,3.8
WY,2005,9,278784,268224,10560,3.8
WY,2005,10,279380,268826,10554,3.8
WY,2005,11,279578,269455,10123,3.6
WY,2005,12,279580,270115,9465,3.4
WY,2006,1,280685,270800,9885,3.5
WY,2006,2,281279,271473,9806,3.5
WY,2006,3,281384,272131,9253,3.3
WY,2006,4,282269,272771,9498,3.4
WY,2006,5,282983,273391,9592,3.4
WY,2006,6,282872,273993,8879,3.1
WY,2006,7,283054,274570,8484,3
WY,2006,8,284365,275137,9228,3.2
WY,2006,9,285266,275698,9568,3.4
WY,2006,10,285324,276254,9070,3.2
WY,2006,11,285467,276807,8660,3
WY,2006,12,285965,277349,8616,3
WY,2007,1,285984,277866,8118,2.8
WY,2007,2,286334,278356,7978,2.8
WY,2007,3,287216,278817,8399,2.9
WY,2007,4,287773,279243,8530,3
WY,2007,5,288490,279648,8842,3.1
WY,2007,6,288707,280029,8678,3
WY,2007,7,289167,280389,8778,3
WY,2007,8,289108,280732,8376,2.9
WY,2007,9,289030,281057,7973,2.8
WY,2007,10,289284,281364,7920,2.7
WY,2007,11,289897,281649,8248,2.8
WY,2007,12,290217,281900,8317,2.9
WY,2008,1,290058,282119,7939,2.7
WY,2008,2,290524,282342,8182,2.8
WY,2008,3,291140,282564,8576,2.9
WY,2008,4,291137,282799,8338,2.9
WY,2008,5,291844,283055,8789,3
WY,2008,6,292643,283331,9312,3.2
WY,2008,7,293377,283630,9747,3.3
WY,2008,8,293841,283951,9890,3.4
WY,2008,9,293579,284297,9282,3.2
WY,2008,10,293959,284655,9304,3.2
WY,2008,11,294289,285023,9266,3.1
WY,2008,12,294877,285408,9469,3.2
WY,2009,1,293129,282313,10816,3.7




























































































































































































































































































































































































































































,d : Reflects revised population controls and model reestimation.
,p : Preliminary.
